Datetime,100035541 (Neutor),101035541 (Neutor stadteinwÃ¤rts),102035541 (Neutor stadtauswÃ¤rts),100035541-status,101035541-status,102035541-status
2019-05-01 00:00,163,71,92,0,0,0
2019-05-01 00:15,93,33,60,0,0,0
2019-05-01 00:30,108,49,59,0,0,0
2019-05-01 00:45,126,59,67,0,0,0
2019-05-01 01:00,113,41,72,0,0,0
2019-05-01 01:15,120,37,83,0,0,0
2019-05-01 01:30,104,28,76,0,0,0
2019-05-01 01:45,110,20,90,0,0,0
2019-05-01 02:00,74,10,64,0,0,0
2019-05-01 02:15,78,15,63,0,0,0
2019-05-01 02:30,113,17,96,0,0,0
2019-05-01 02:45,85,11,74,0,0,0
2019-05-01 03:00,102,15,87,0,0,0
2019-05-01 03:15,76,7,69,0,0,0
2019-05-01 03:30,66,8,58,0,0,0
2019-05-01 03:45,55,3,52,0,0,0
2019-05-01 04:00,37,0,37,0,0,0
2019-05-01 04:15,58,6,52,0,0,0
2019-05-01 04:30,31,4,27,0,0,0
2019-05-01 04:45,30,8,22,0,0,0
2019-05-01 05:00,18,3,15,0,0,0
2019-05-01 05:15,28,5,23,0,0,0
2019-05-01 05:30,19,3,16,0,0,0
2019-05-01 05:45,16,4,12,0,0,0
2019-05-01 06:00,7,3,4,0,0,0
2019-05-01 06:15,10,3,7,0,0,0
2019-05-01 06:30,11,5,6,0,0,0
2019-05-01 06:45,15,9,6,0,0,0
2019-05-01 07:00,11,5,6,0,0,0
2019-05-01 07:15,9,7,2,0,0,0
2019-05-01 07:30,16,14,2,0,0,0
2019-05-01 07:45,24,20,4,0,0,0
2019-05-01 08:00,16,11,5,0,0,0
2019-05-01 08:15,26,19,7,0,0,0
2019-05-01 08:30,37,25,12,0,0,0
2019-05-01 08:45,48,29,19,0,0,0
2019-05-01 09:00,42,33,9,0,0,0
2019-05-01 09:15,56,26,30,0,0,0
2019-05-01 09:30,61,45,16,0,0,0
2019-05-01 09:45,88,58,30,0,0,0
2019-05-01 10:00,88,45,43,0,0,0
2019-05-01 10:15,69,49,20,0,0,0
2019-05-01 10:30,114,62,52,0,0,0
2019-05-01 10:45,141,101,40,0,0,0
2019-05-01 11:00,134,75,59,0,0,0
2019-05-01 11:15,108,72,36,0,0,0
2019-05-01 11:30,145,93,52,0,0,0
2019-05-01 11:45,182,108,74,0,0,0
2019-05-01 12:00,165,82,83,0,0,0
2019-05-01 12:15,167,78,89,0,0,0
2019-05-01 12:30,144,80,64,0,0,0
2019-05-01 12:45,174,105,69,0,0,0
2019-05-01 13:00,159,92,67,0,0,0
2019-05-01 13:15,149,85,64,0,0,0
2019-05-01 13:30,174,89,85,0,0,0
2019-05-01 13:45,242,143,99,0,0,0
2019-05-01 14:00,194,113,81,0,0,0
2019-05-01 14:15,235,140,95,0,0,0
2019-05-01 14:30,182,108,74,0,0,0
2019-05-01 14:45,237,163,74,0,0,0
2019-05-01 15:00,202,120,82,0,0,0
2019-05-01 15:15,170,101,69,0,0,0
2019-05-01 15:30,196,131,65,0,0,0
2019-05-01 15:45,178,115,63,0,0,0
2019-05-01 16:00,215,113,102,0,0,0
2019-05-01 16:15,188,120,68,0,0,0
2019-05-01 16:30,202,109,93,0,0,0
2019-05-01 16:45,189,104,85,0,0,0
2019-05-01 17:00,184,87,97,0,0,0
2019-05-01 17:15,192,110,82,0,0,0
2019-05-01 17:30,164,91,73,0,0,0
2019-05-01 17:45,207,109,98,0,0,0
2019-05-01 18:00,171,57,114,0,0,0
2019-05-01 18:15,155,68,87,0,0,0
2019-05-01 18:30,162,83,79,0,0,0
2019-05-01 18:45,238,108,130,0,0,0
2019-05-01 19:00,205,85,120,0,0,0
2019-05-01 19:15,172,73,99,0,0,0
2019-05-01 19:30,178,63,115,0,0,0
2019-05-01 19:45,186,68,118,0,0,0
2019-05-01 20:00,208,71,137,0,0,0
2019-05-01 20:15,172,55,117,0,0,0
2019-05-01 20:30,201,52,149,0,0,0
2019-05-01 20:45,189,57,132,0,0,0
2019-05-01 21:00,166,44,122,0,0,0
2019-05-01 21:15,116,29,87,0,0,0
2019-05-01 21:30,127,35,92,0,0,0
2019-05-01 21:45,123,27,96,0,0,0
2019-05-01 22:00,80,10,70,0,0,0
2019-05-01 22:15,113,26,87,0,0,0
2019-05-01 22:30,85,17,68,0,0,0
2019-05-01 22:45,75,22,53,0,0,0
2019-05-01 23:00,118,34,84,0,0,0
2019-05-01 23:15,74,29,45,0,0,0
2019-05-01 23:30,62,19,43,0,0,0
2019-05-01 23:45,47,8,39,0,0,0
2019-05-02 00:00,24,5,19,0,0,0
2019-05-02 00:15,41,13,28,0,0,0
2019-05-02 00:30,33,6,27,0,0,0
2019-05-02 00:45,16,2,14,0,0,0
2019-05-02 01:00,10,4,6,0,0,0
2019-05-02 01:15,16,0,16,0,0,0
2019-05-02 01:30,16,3,13,0,0,0
2019-05-02 01:45,18,2,16,0,0,0
2019-05-02 02:00,14,1,13,0,0,0
2019-05-02 02:15,11,3,8,0,0,0
2019-05-02 02:30,13,2,11,0,0,0
2019-05-02 02:45,6,1,5,0,0,0
2019-05-02 03:00,2,0,2,0,0,0
2019-05-02 03:15,3,0,3,0,0,0
2019-05-02 03:30,6,0,6,0,0,0
2019-05-02 03:45,0,0,0,0,0,0
2019-05-02 04:00,1,1,0,0,0,0
2019-05-02 04:15,2,0,2,0,0,0
2019-05-02 04:30,6,4,2,0,0,0
2019-05-02 04:45,13,8,5,0,0,0
2019-05-02 05:00,12,10,2,0,0,0
2019-05-02 05:15,6,3,3,0,0,0
2019-05-02 05:30,23,13,10,0,0,0
2019-05-02 05:45,18,13,5,0,0,0
2019-05-02 06:00,31,19,12,0,0,0
2019-05-02 06:15,45,32,13,0,0,0
2019-05-02 06:30,67,41,26,0,0,0
2019-05-02 06:45,87,54,33,0,0,0
2019-05-02 07:00,93,48,45,0,0,0
2019-05-02 07:15,138,93,45,0,0,0
2019-05-02 07:30,258,161,97,0,0,0
2019-05-02 07:45,405,203,202,0,0,0
2019-05-02 08:00,412,205,207,0,0,0
2019-05-02 08:15,221,137,84,0,0,0
2019-05-02 08:30,211,128,83,0,0,0
2019-05-02 08:45,240,138,102,0,0,0
2019-05-02 09:00,205,136,69,0,0,0
2019-05-02 09:15,151,98,53,0,0,0
2019-05-02 09:30,255,139,116,0,0,0
2019-05-02 09:45,476,262,214,0,0,0
2019-05-02 10:00,490,324,166,0,0,0
2019-05-02 10:15,167,103,64,0,0,0
2019-05-02 10:30,147,75,72,0,0,0
2019-05-02 10:45,164,92,72,0,0,0
2019-05-02 11:00,148,86,62,0,0,0
2019-05-02 11:15,171,85,86,0,0,0
2019-05-02 11:30,219,115,104,0,0,0
2019-05-02 11:45,471,219,252,0,0,0
2019-05-02 12:00,333,173,160,0,0,0
2019-05-02 12:15,199,90,109,0,0,0
2019-05-02 12:30,205,100,105,0,0,0
2019-05-02 12:45,210,107,103,0,0,0
2019-05-02 13:00,207,66,141,0,0,0
2019-05-02 13:15,221,102,119,0,0,0
2019-05-02 13:30,255,108,147,0,0,0
2019-05-02 13:45,475,207,268,0,0,0
2019-05-02 14:00,341,176,165,0,0,0
2019-05-02 14:15,238,121,117,0,0,0
2019-05-02 14:30,228,108,120,0,0,0
2019-05-02 14:45,204,107,97,0,0,0
2019-05-02 15:00,218,87,131,0,0,0
2019-05-02 15:15,185,79,106,0,0,0
2019-05-02 15:30,292,146,146,0,0,0
2019-05-02 15:45,463,226,237,0,0,0
2019-05-02 16:00,364,197,167,0,0,0
2019-05-02 16:15,255,150,105,0,0,0
2019-05-02 16:30,259,121,138,0,0,0
2019-05-02 16:45,195,88,107,0,0,0
2019-05-02 17:00,227,103,124,0,0,0
2019-05-02 17:15,260,122,138,0,0,0
2019-05-02 17:30,321,134,187,0,0,0
2019-05-02 17:45,404,167,237,0,0,0
2019-05-02 18:00,344,154,190,0,0,0
2019-05-02 18:15,268,126,142,0,0,0
2019-05-02 18:30,203,91,112,0,0,0
2019-05-02 18:45,256,136,120,0,0,0
2019-05-02 19:00,237,121,116,0,0,0
2019-05-02 19:15,180,83,97,0,0,0
2019-05-02 19:30,230,108,122,0,0,0
2019-05-02 19:45,244,105,139,0,0,0
2019-05-02 20:00,221,106,115,0,0,0
2019-05-02 20:15,135,49,86,0,0,0
2019-05-02 20:30,105,37,68,0,0,0
2019-05-02 20:45,109,43,66,0,0,0
2019-05-02 21:00,113,63,50,0,0,0
2019-05-02 21:15,107,44,63,0,0,0
2019-05-02 21:30,109,45,64,0,0,0
2019-05-02 21:45,84,25,59,0,0,0
2019-05-02 22:00,92,39,53,0,0,0
2019-05-02 22:15,115,48,67,0,0,0
2019-05-02 22:30,90,35,55,0,0,0
2019-05-02 22:45,78,30,48,0,0,0
2019-05-02 23:00,81,31,50,0,0,0
2019-05-02 23:15,67,14,53,0,0,0
2019-05-02 23:30,39,14,25,0,0,0
2019-05-02 23:45,39,15,24,0,0,0
2019-05-03 00:00,35,8,27,0,0,0
2019-05-03 00:15,20,6,14,0,0,0
2019-05-03 00:30,21,7,14,0,0,0
2019-05-03 00:45,12,1,11,0,0,0
2019-05-03 01:00,13,3,10,0,0,0
2019-05-03 01:15,10,7,3,0,0,0
2019-05-03 01:30,14,4,10,0,0,0
2019-05-03 01:45,4,1,3,0,0,0
2019-05-03 02:00,6,2,4,0,0,0
2019-05-03 02:15,3,3,0,0,0,0
2019-05-03 02:30,6,4,2,0,0,0
2019-05-03 02:45,2,0,2,0,0,0
2019-05-03 03:00,1,1,0,0,0,0
2019-05-03 03:15,2,1,1,0,0,0
2019-05-03 03:30,3,1,2,0,0,0
2019-05-03 03:45,2,2,0,0,0,0
2019-05-03 04:00,2,0,2,0,0,0
2019-05-03 04:15,1,0,1,0,0,0
2019-05-03 04:30,2,2,0,0,0,0
2019-05-03 04:45,4,3,1,0,0,0
2019-05-03 05:00,15,11,4,0,0,0
2019-05-03 05:15,9,6,3,0,0,0
2019-05-03 05:30,27,15,12,0,0,0
2019-05-03 05:45,15,12,3,0,0,0
2019-05-03 06:00,22,17,5,0,0,0
2019-05-03 06:15,44,24,20,0,0,0
2019-05-03 06:30,57,40,17,0,0,0
2019-05-03 06:45,81,46,35,0,0,0
2019-05-03 07:00,89,60,29,0,0,0
2019-05-03 07:15,166,114,52,0,0,0
2019-05-03 07:30,259,179,80,0,0,0
2019-05-03 07:45,334,185,149,0,0,0
2019-05-03 08:00,391,211,180,0,0,0
2019-05-03 08:15,252,139,113,0,0,0
2019-05-03 08:30,198,107,91,0,0,0
2019-05-03 08:45,271,171,100,0,0,0
2019-05-03 09:00,216,133,83,0,0,0
2019-05-03 09:15,182,116,66,0,0,0
2019-05-03 09:30,188,82,106,0,0,0
2019-05-03 09:45,401,173,228,0,0,0
2019-05-03 10:00,299,190,109,0,0,0
2019-05-03 10:15,164,105,59,0,0,0
2019-05-03 10:30,138,84,54,0,0,0
2019-05-03 10:45,155,89,66,0,0,0
2019-05-03 11:00,166,95,71,0,0,0
2019-05-03 11:15,163,100,63,0,0,0
2019-05-03 11:30,233,131,102,0,0,0
2019-05-03 11:45,339,193,146,0,0,0
2019-05-03 12:00,264,149,115,0,0,0
2019-05-03 12:15,234,123,111,0,0,0
2019-05-03 12:30,224,121,103,0,0,0
2019-05-03 12:45,206,109,97,0,0,0
2019-05-03 13:00,302,134,168,0,0,0
2019-05-03 13:15,211,90,121,0,0,0
2019-05-03 13:30,271,130,141,0,0,0
2019-05-03 13:45,345,185,160,0,0,0
2019-05-03 14:00,292,163,129,0,0,0
2019-05-03 14:15,207,104,103,0,0,0
2019-05-03 14:30,205,82,123,0,0,0
2019-05-03 14:45,207,113,94,0,0,0
2019-05-03 15:00,197,100,97,0,0,0
2019-05-03 15:15,201,98,103,0,0,0
2019-05-03 15:30,234,121,113,0,0,0
2019-05-03 15:45,275,125,150,0,0,0
2019-05-03 16:00,231,122,109,0,0,0
2019-05-03 16:15,179,102,77,0,0,0
2019-05-03 16:30,243,121,122,0,0,0
2019-05-03 16:45,189,97,92,0,0,0
2019-05-03 17:00,220,98,122,0,0,0
2019-05-03 17:15,210,112,98,0,0,0
2019-05-03 17:30,220,111,109,0,0,0
2019-05-03 17:45,252,111,141,0,0,0
2019-05-03 18:00,225,98,127,0,0,0
2019-05-03 18:15,211,112,99,0,0,0
2019-05-03 18:30,215,96,119,0,0,0
2019-05-03 18:45,240,118,122,0,0,0
2019-05-03 19:00,180,83,97,0,0,0
2019-05-03 19:15,181,93,88,0,0,0
2019-05-03 19:30,192,112,80,0,0,0
2019-05-03 19:45,193,88,105,0,0,0
2019-05-03 20:00,154,69,85,0,0,0
2019-05-03 20:15,145,69,76,0,0,0
2019-05-03 20:30,131,75,56,0,0,0
2019-05-03 20:45,122,69,53,0,0,0
2019-05-03 21:00,121,61,60,0,0,0
2019-05-03 21:15,113,41,72,0,0,0
2019-05-03 21:30,95,39,56,0,0,0
2019-05-03 21:45,77,38,39,0,0,0
2019-05-03 22:00,97,39,58,0,0,0
2019-05-03 22:15,114,28,86,0,0,0
2019-05-03 22:30,87,34,53,0,0,0
2019-05-03 22:45,77,17,60,0,0,0
2019-05-03 23:00,55,14,41,0,0,0
2019-05-03 23:15,60,26,34,0,0,0
2019-05-03 23:30,69,27,42,0,0,0
2019-05-03 23:45,64,23,41,0,0,0
2019-05-04 00:00,69,29,40,0,0,0
2019-05-04 00:15,51,17,34,0,0,0
2019-05-04 00:30,56,12,44,0,0,0
2019-05-04 00:45,65,36,29,0,0,0
2019-05-04 01:00,72,24,48,0,0,0
2019-05-04 01:15,53,24,29,0,0,0
2019-05-04 01:30,43,11,32,0,0,0
2019-05-04 01:45,51,24,27,0,0,0
2019-05-04 02:00,39,8,31,0,0,0
2019-05-04 02:15,23,9,14,0,0,0
2019-05-04 02:30,39,9,30,0,0,0
2019-05-04 02:45,32,5,27,0,0,0
2019-05-04 03:00,41,6,35,0,0,0
2019-05-04 03:15,18,6,12,0,0,0
2019-05-04 03:30,18,5,13,0,0,0
2019-05-04 03:45,24,9,15,0,0,0
2019-05-04 04:00,21,3,18,0,0,0
2019-05-04 04:15,9,4,5,0,0,0
2019-05-04 04:30,23,4,19,0,0,0
2019-05-04 04:45,9,4,5,0,0,0
2019-05-04 05:00,9,4,5,0,0,0
2019-05-04 05:15,6,1,5,0,0,0
2019-05-04 05:30,19,9,10,0,0,0
2019-05-04 05:45,11,8,3,0,0,0
2019-05-04 06:00,9,6,3,0,0,0
2019-05-04 06:15,10,4,6,0,0,0
2019-05-04 06:30,14,11,3,0,0,0
2019-05-04 06:45,14,9,5,0,0,0
2019-05-04 07:00,13,10,3,0,0,0
2019-05-04 07:15,12,8,4,0,0,0
2019-05-04 07:30,28,20,8,0,0,0
2019-05-04 07:45,50,38,12,0,0,0
2019-05-04 08:00,34,25,9,0,0,0
2019-05-04 08:15,45,31,14,0,0,0
2019-05-04 08:30,76,48,28,0,0,0
2019-05-04 08:45,125,93,32,0,0,0
2019-05-04 09:00,76,61,15,0,0,0
2019-05-04 09:15,94,55,39,0,0,0
2019-05-04 09:30,126,84,42,0,0,0
2019-05-04 09:45,163,123,40,0,0,0
2019-05-04 10:00,149,118,31,0,0,0
2019-05-04 10:15,164,115,49,0,0,0
2019-05-04 10:30,130,91,39,0,0,0
2019-05-04 10:45,151,110,41,0,0,0
2019-05-04 11:00,130,82,48,0,0,0
2019-05-04 11:15,160,111,49,0,0,0
2019-05-04 11:30,124,67,57,0,0,0
2019-05-04 11:45,171,93,78,0,0,0
2019-05-04 12:00,163,107,56,0,0,0
2019-05-04 12:15,155,94,61,0,0,0
2019-05-04 12:30,148,80,68,0,0,0
2019-05-04 12:45,170,99,71,0,0,0
2019-05-04 13:00,133,77,56,0,0,0
2019-05-04 13:15,147,78,69,0,0,0
2019-05-04 13:30,143,69,74,0,0,0
2019-05-04 13:45,197,119,78,0,0,0
2019-05-04 14:00,183,89,94,0,0,0
2019-05-04 14:15,127,52,75,0,0,0
2019-05-04 14:30,141,56,85,0,0,0
2019-05-04 14:45,144,75,69,0,0,0
2019-05-04 15:00,130,51,79,0,0,0
2019-05-04 15:15,112,40,72,0,0,0
2019-05-04 15:30,116,50,66,0,0,0
2019-05-04 15:45,155,69,86,0,0,0
2019-05-04 16:00,131,64,67,0,0,0
2019-05-04 16:15,112,48,64,0,0,0
2019-05-04 16:30,125,67,58,0,0,0
2019-05-04 16:45,110,54,56,0,0,0
2019-05-04 17:00,123,57,66,0,0,0
2019-05-04 17:15,126,39,87,0,0,0
2019-05-04 17:30,113,57,56,0,0,0
2019-05-04 17:45,144,62,82,0,0,0
2019-05-04 18:00,112,46,66,0,0,0
2019-05-04 18:15,124,59,65,0,0,0
2019-05-04 18:30,93,39,54,0,0,0
2019-05-04 18:45,123,59,64,0,0,0
2019-05-04 19:00,134,69,65,0,0,0
2019-05-04 19:15,119,52,67,0,0,0
2019-05-04 19:30,98,39,59,0,0,0
2019-05-04 19:45,121,67,54,0,0,0
2019-05-04 20:00,116,57,59,0,0,0
2019-05-04 20:15,112,54,58,0,0,0
2019-05-04 20:30,107,50,57,0,0,0
2019-05-04 20:45,81,39,42,0,0,0
2019-05-04 21:00,80,46,34,0,0,0
2019-05-04 21:15,69,38,31,0,0,0
2019-05-04 21:30,93,35,58,0,0,0
2019-05-04 21:45,56,21,35,0,0,0
2019-05-04 22:00,61,22,39,0,0,0
2019-05-04 22:15,28,14,14,0,0,0
2019-05-04 22:30,51,20,31,0,0,0
2019-05-04 22:45,63,21,42,0,0,0
2019-05-04 23:00,58,26,32,0,0,0
2019-05-04 23:15,62,21,41,0,0,0
2019-05-04 23:30,45,16,29,0,0,0
2019-05-04 23:45,68,23,45,0,0,0
2019-05-05 00:00,50,14,36,0,0,0
2019-05-05 00:15,70,30,40,0,0,0
2019-05-05 00:30,65,23,42,0,0,0
2019-05-05 00:45,57,27,30,0,0,0
2019-05-05 01:00,67,30,37,0,0,0
2019-05-05 01:15,50,16,34,0,0,0
2019-05-05 01:30,33,12,21,0,0,0
2019-05-05 01:45,29,9,20,0,0,0
2019-05-05 02:00,36,9,27,0,0,0
2019-05-05 02:15,42,17,25,0,0,0
2019-05-05 02:30,60,10,50,0,0,0
2019-05-05 02:45,45,19,26,0,0,0
2019-05-05 03:00,36,9,27,0,0,0
2019-05-05 03:15,20,3,17,0,0,0
2019-05-05 03:30,21,2,19,0,0,0
2019-05-05 03:45,26,9,17,0,0,0
2019-05-05 04:00,19,5,14,0,0,0
2019-05-05 04:15,14,1,13,0,0,0
2019-05-05 04:30,11,2,9,0,0,0
2019-05-05 04:45,17,0,17,0,0,0
2019-05-05 05:00,11,1,10,0,0,0
2019-05-05 05:15,4,1,3,0,0,0
2019-05-05 05:30,11,4,7,0,0,0
2019-05-05 05:45,12,5,7,0,0,0
2019-05-05 06:00,12,7,5,0,0,0
2019-05-05 06:15,9,5,4,0,0,0
2019-05-05 06:30,9,4,5,0,0,0
2019-05-05 06:45,3,2,1,0,0,0
2019-05-05 07:00,5,3,2,0,0,0
2019-05-05 07:15,5,3,2,0,0,0
2019-05-05 07:30,17,11,6,0,0,0
2019-05-05 07:45,13,9,4,0,0,0
2019-05-05 08:00,12,4,8,0,0,0
2019-05-05 08:15,19,15,4,0,0,0
2019-05-05 08:30,27,13,14,0,0,0
2019-05-05 08:45,42,29,13,0,0,0
2019-05-05 09:00,42,30,12,0,0,0
2019-05-05 09:15,40,35,5,0,0,0
2019-05-05 09:30,44,35,9,0,0,0
2019-05-05 09:45,102,73,29,0,0,0
2019-05-05 10:00,54,36,18,0,0,0
2019-05-05 10:15,72,35,37,0,0,0
2019-05-05 10:30,71,45,26,0,0,0
2019-05-05 10:45,89,60,29,0,0,0
2019-05-05 11:00,68,55,13,0,0,0
2019-05-05 11:15,61,42,19,0,0,0
2019-05-05 11:30,85,36,49,0,0,0
2019-05-05 11:45,73,37,36,0,0,0
2019-05-05 12:00,35,21,14,0,0,0
2019-05-05 12:15,87,51,36,0,0,0
2019-05-05 12:30,62,24,38,0,0,0
2019-05-05 12:45,66,39,27,0,0,0
2019-05-05 13:00,89,51,38,0,0,0
2019-05-05 13:15,86,57,29,0,0,0
2019-05-05 13:30,63,40,23,0,0,0
2019-05-05 13:45,105,68,37,0,0,0
2019-05-05 14:00,100,57,43,0,0,0
2019-05-05 14:15,89,49,40,0,0,0
2019-05-05 14:30,94,51,43,0,0,0
2019-05-05 14:45,94,44,50,0,0,0
2019-05-05 15:00,97,46,51,0,0,0
2019-05-05 15:15,95,42,53,0,0,0
2019-05-05 15:30,90,39,51,0,0,0
2019-05-05 15:45,88,47,41,0,0,0
2019-05-05 16:00,88,35,53,0,0,0
2019-05-05 16:15,95,45,50,0,0,0
2019-05-05 16:30,93,31,62,0,0,0
2019-05-05 16:45,121,53,68,0,0,0
2019-05-05 17:00,86,38,48,0,0,0
2019-05-05 17:15,100,54,46,0,0,0
2019-05-05 17:30,126,51,75,0,0,0
2019-05-05 17:45,164,81,83,0,0,0
2019-05-05 18:00,104,36,68,0,0,0
2019-05-05 18:15,90,42,48,0,0,0
2019-05-05 18:30,92,38,54,0,0,0
2019-05-05 18:45,116,48,68,0,0,0
2019-05-05 19:00,81,32,49,0,0,0
2019-05-05 19:15,87,42,45,0,0,0
2019-05-05 19:30,88,30,58,0,0,0
2019-05-05 19:45,103,42,61,0,0,0
2019-05-05 20:00,85,27,58,0,0,0
2019-05-05 20:15,76,27,49,0,0,0
2019-05-05 20:30,92,26,66,0,0,0
2019-05-05 20:45,66,35,31,0,0,0
2019-05-05 21:00,75,18,57,0,0,0
2019-05-05 21:15,63,20,43,0,0,0
2019-05-05 21:30,64,22,42,0,0,0
2019-05-05 21:45,36,14,22,0,0,0
2019-05-05 22:00,56,20,36,0,0,0
2019-05-05 22:15,40,11,29,0,0,0
2019-05-05 22:30,55,37,18,0,0,0
2019-05-05 22:45,41,15,26,0,0,0
2019-05-05 23:00,33,6,27,0,0,0
2019-05-05 23:15,19,6,13,0,0,0
2019-05-05 23:30,17,6,11,0,0,0
2019-05-05 23:45,17,4,13,0,0,0
2019-05-06 00:00,15,8,7,0,0,0
2019-05-06 00:15,17,7,10,0,0,0
2019-05-06 00:30,19,3,16,0,0,0
2019-05-06 00:45,13,2,11,0,0,0
2019-05-06 01:00,13,6,7,0,0,0
2019-05-06 01:15,8,5,3,0,0,0
2019-05-06 01:30,3,1,2,0,0,0
2019-05-06 01:45,3,1,2,0,0,0
2019-05-06 02:00,3,3,0,0,0,0
2019-05-06 02:15,5,1,4,0,0,0
2019-05-06 02:30,2,0,2,0,0,0
2019-05-06 02:45,0,0,0,0,0,0
2019-05-06 03:00,2,0,2,0,0,0
2019-05-06 03:15,1,1,0,0,0,0
2019-05-06 03:30,2,1,1,0,0,0
2019-05-06 03:45,2,1,1,0,0,0
2019-05-06 04:00,1,1,0,0,0,0
2019-05-06 04:15,3,2,1,0,0,0
2019-05-06 04:30,4,2,2,0,0,0
2019-05-06 04:45,11,9,2,0,0,0
2019-05-06 05:00,11,9,2,0,0,0
2019-05-06 05:15,16,7,9,0,0,0
2019-05-06 05:30,23,15,8,0,0,0
2019-05-06 05:45,20,11,9,0,0,0
2019-05-06 06:00,33,26,7,0,0,0
2019-05-06 06:15,50,39,11,0,0,0
2019-05-06 06:30,61,42,19,0,0,0
2019-05-06 06:45,96,62,34,0,0,0
2019-05-06 07:00,99,65,34,0,0,0
2019-05-06 07:15,157,109,48,0,0,0
2019-05-06 07:30,271,172,99,0,0,0
2019-05-06 07:45,416,225,191,0,0,0
2019-05-06 08:00,410,187,223,0,0,0
2019-05-06 08:15,260,160,100,0,0,0
2019-05-06 08:30,213,138,75,0,0,0
2019-05-06 08:45,307,202,105,0,0,0
2019-05-06 09:00,230,161,69,0,0,0
2019-05-06 09:15,211,148,63,0,0,0
2019-05-06 09:30,218,117,101,0,0,0
2019-05-06 09:45,443,227,216,0,0,0
2019-05-06 10:00,459,254,205,0,0,0
2019-05-06 10:15,174,98,76,0,0,0
2019-05-06 10:30,143,73,70,0,0,0
2019-05-06 10:45,135,69,66,0,0,0
2019-05-06 11:00,140,92,48,0,0,0
2019-05-06 11:15,152,93,59,0,0,0
2019-05-06 11:30,202,100,102,0,0,0
2019-05-06 11:45,457,227,230,0,0,0
2019-05-06 12:00,357,231,126,0,0,0
2019-05-06 12:15,235,114,121,0,0,0
2019-05-06 12:30,236,122,114,0,0,0
2019-05-06 12:45,213,99,114,0,0,0
2019-05-06 13:00,282,133,149,0,0,0
2019-05-06 13:15,171,84,87,0,0,0
2019-05-06 13:30,220,116,104,0,0,0
2019-05-06 13:45,431,198,233,0,0,0
2019-05-06 14:00,402,201,201,0,0,0
2019-05-06 14:15,180,73,107,0,0,0
2019-05-06 14:30,171,73,98,0,0,0
2019-05-06 14:45,215,94,121,0,0,0
2019-05-06 15:00,198,94,104,0,0,0
2019-05-06 15:15,237,115,122,0,0,0
2019-05-06 15:30,297,127,170,0,0,0
2019-05-06 15:45,539,262,277,0,0,0
2019-05-06 16:00,436,255,181,0,0,0
2019-05-06 16:15,287,150,137,0,0,0
2019-05-06 16:30,267,139,128,0,0,0
2019-05-06 16:45,277,134,143,0,0,0
2019-05-06 17:00,308,142,166,0,0,0
2019-05-06 17:15,322,158,164,0,0,0
2019-05-06 17:30,381,163,218,0,0,0
2019-05-06 17:45,641,246,395,0,0,0
2019-05-06 18:00,423,226,197,0,0,0
2019-05-06 18:15,355,174,181,0,0,0
2019-05-06 18:30,298,153,145,0,0,0
2019-05-06 18:45,294,149,145,0,0,0
2019-05-06 19:00,261,142,119,0,0,0
2019-05-06 19:15,243,143,100,0,0,0
2019-05-06 19:30,270,123,147,0,0,0
2019-05-06 19:45,322,173,149,0,0,0
2019-05-06 20:00,223,115,108,0,0,0
2019-05-06 20:15,213,98,115,0,0,0
2019-05-06 20:30,141,74,67,0,0,0
2019-05-06 20:45,135,78,57,0,0,0
2019-05-06 21:00,119,56,63,0,0,0
2019-05-06 21:15,80,31,49,0,0,0
2019-05-06 21:30,90,40,50,0,0,0
2019-05-06 21:45,132,57,75,0,0,0
2019-05-06 22:00,123,50,73,0,0,0
2019-05-06 22:15,119,56,63,0,0,0
2019-05-06 22:30,98,38,60,0,0,0
2019-05-06 22:45,69,20,49,0,0,0
2019-05-06 23:00,50,13,37,0,0,0
2019-05-06 23:15,70,21,49,0,0,0
2019-05-06 23:30,55,6,49,0,0,0
2019-05-06 23:45,58,17,41,0,0,0
2019-05-07 00:00,66,13,53,0,0,0
2019-05-07 00:15,52,6,46,0,0,0
2019-05-07 00:30,28,1,27,0,0,0
2019-05-07 00:45,51,5,46,0,0,0
2019-05-07 01:00,36,4,32,0,0,0
2019-05-07 01:15,65,5,60,0,0,0
2019-05-07 01:30,56,5,51,0,0,0
2019-05-07 01:45,23,5,18,0,0,0
2019-05-07 02:00,37,6,31,0,0,0
2019-05-07 02:15,35,7,28,0,0,0
2019-05-07 02:30,25,3,22,0,0,0
2019-05-07 02:45,17,1,16,0,0,0
2019-05-07 03:00,23,1,22,0,0,0
2019-05-07 03:15,20,6,14,0,0,0
2019-05-07 03:30,14,0,14,0,0,0
2019-05-07 03:45,3,0,3,0,0,0
2019-05-07 04:00,4,2,2,0,0,0
2019-05-07 04:15,8,1,7,0,0,0
2019-05-07 04:30,4,3,1,0,0,0
2019-05-07 04:45,8,2,6,0,0,0
2019-05-07 05:00,14,12,2,0,0,0
2019-05-07 05:15,13,8,5,0,0,0
2019-05-07 05:30,25,12,13,0,0,0
2019-05-07 05:45,30,23,7,0,0,0
2019-05-07 06:00,27,21,6,0,0,0
2019-05-07 06:15,45,34,11,0,0,0
2019-05-07 06:30,63,37,26,0,0,0
2019-05-07 06:45,120,80,40,0,0,0
2019-05-07 07:00,114,74,40,0,0,0
2019-05-07 07:15,171,111,60,0,0,0
2019-05-07 07:30,264,168,96,0,0,0
2019-05-07 07:45,458,263,195,0,0,0
2019-05-07 08:00,540,315,225,0,0,0
2019-05-07 08:15,302,196,106,0,0,0
2019-05-07 08:30,222,130,92,0,0,0
2019-05-07 08:45,323,182,141,0,0,0
2019-05-07 09:00,275,185,90,0,0,0
2019-05-07 09:15,171,100,71,0,0,0
2019-05-07 09:30,212,107,105,0,0,0
2019-05-07 09:45,528,228,300,0,0,0
2019-05-07 10:00,481,292,189,0,0,0
2019-05-07 10:15,154,85,69,0,0,0
2019-05-07 10:30,159,82,77,0,0,0
2019-05-07 10:45,134,83,51,0,0,0
2019-05-07 11:00,142,76,66,0,0,0
2019-05-07 11:15,152,73,79,0,0,0
2019-05-07 11:30,269,114,155,0,0,0
2019-05-07 11:45,507,282,225,0,0,0
2019-05-07 12:00,374,222,152,0,0,0
2019-05-07 12:15,191,93,98,0,0,0
2019-05-07 12:30,162,62,100,0,0,0
2019-05-07 12:45,208,100,108,0,0,0
2019-05-07 13:00,228,89,139,0,0,0
2019-05-07 13:15,218,108,110,0,0,0
2019-05-07 13:30,284,117,167,0,0,0
2019-05-07 13:45,454,169,285,0,0,0
2019-05-07 14:00,407,236,171,0,0,0
2019-05-07 14:15,217,109,108,0,0,0
2019-05-07 14:30,215,108,107,0,0,0
2019-05-07 14:45,238,114,124,0,0,0
2019-05-07 15:00,221,95,126,0,0,0
2019-05-07 15:15,169,78,91,0,0,0
2019-05-07 15:30,296,112,184,0,0,0
2019-05-07 15:45,520,276,244,0,0,0
2019-05-07 16:00,450,253,197,0,0,0
2019-05-07 16:15,279,177,102,0,0,0
2019-05-07 16:30,312,157,155,0,0,0
2019-05-07 16:45,232,120,112,0,0,0
2019-05-07 17:00,270,111,159,0,0,0
2019-05-07 17:15,311,154,157,0,0,0
2019-05-07 17:30,429,182,247,0,0,0
2019-05-07 17:45,524,221,303,0,0,0
2019-05-07 18:00,422,226,196,0,0,0
2019-05-07 18:15,261,128,133,0,0,0
2019-05-07 18:30,249,107,142,0,0,0
2019-05-07 18:45,267,120,147,0,0,0
2019-05-07 19:00,235,98,137,0,0,0
2019-05-07 19:15,272,147,125,0,0,0
2019-05-07 19:30,282,116,166,0,0,0
2019-05-07 19:45,333,147,186,0,0,0
2019-05-07 20:00,259,126,133,0,0,0
2019-05-07 20:15,213,100,113,0,0,0
2019-05-07 20:30,178,59,119,0,0,0
2019-05-07 20:45,146,62,84,0,0,0
2019-05-07 21:00,131,66,65,0,0,0
2019-05-07 21:15,109,45,64,0,0,0
2019-05-07 21:30,113,36,77,0,0,0
2019-05-07 21:45,130,38,92,0,0,0
2019-05-07 22:00,140,41,99,0,0,0
2019-05-07 22:15,129,69,60,0,0,0
2019-05-07 22:30,111,36,75,0,0,0
2019-05-07 22:45,93,31,62,0,0,0
2019-05-07 23:00,111,37,74,0,0,0
2019-05-07 23:15,96,34,62,0,0,0
2019-05-07 23:30,62,18,44,0,0,0
2019-05-07 23:45,52,13,39,0,0,0
2019-05-08 00:00,28,8,20,0,0,0
2019-05-08 00:15,19,7,12,0,0,0
2019-05-08 00:30,26,3,23,0,0,0
2019-05-08 00:45,24,9,15,0,0,0
2019-05-08 01:00,26,8,18,0,0,0
2019-05-08 01:15,15,5,10,0,0,0
2019-05-08 01:30,18,5,13,0,0,0
2019-05-08 01:45,10,7,3,0,0,0
2019-05-08 02:00,10,5,5,0,0,0
2019-05-08 02:15,7,4,3,0,0,0
2019-05-08 02:30,17,13,4,0,0,0
2019-05-08 02:45,11,11,0,0,0,0
2019-05-08 03:00,14,11,3,0,0,0
2019-05-08 03:15,21,19,2,0,0,0
2019-05-08 03:30,9,8,1,0,0,0
2019-05-08 03:45,9,5,4,0,0,0
2019-05-08 04:00,5,3,2,0,0,0
2019-05-08 04:15,3,3,0,0,0,0
2019-05-08 04:30,6,4,2,0,0,0
2019-05-08 04:45,11,7,4,0,0,0
2019-05-08 05:00,15,10,5,0,0,0
2019-05-08 05:15,7,6,1,0,0,0
2019-05-08 05:30,22,10,12,0,0,0
2019-05-08 05:45,25,19,6,0,0,0
2019-05-08 06:00,25,22,3,0,0,0
2019-05-08 06:15,56,40,16,0,0,0
2019-05-08 06:30,72,49,23,0,0,0
2019-05-08 06:45,99,74,25,0,0,0
2019-05-08 07:00,102,70,32,0,0,0
2019-05-08 07:15,267,210,57,0,0,0
2019-05-08 07:30,298,191,107,0,0,0
2019-05-08 07:45,481,247,234,0,0,0
2019-05-08 08:00,519,286,233,0,0,0
2019-05-08 08:15,298,190,108,0,0,0
2019-05-08 08:30,224,138,86,0,0,0
2019-05-08 08:45,279,179,100,0,0,0
2019-05-08 09:00,225,135,90,0,0,0
2019-05-08 09:15,196,116,80,0,0,0
2019-05-08 09:30,248,154,94,0,0,0
2019-05-08 09:45,485,241,244,0,0,0
2019-05-08 10:00,574,332,242,0,0,0
2019-05-08 10:15,203,120,83,0,0,0
2019-05-08 10:30,177,97,80,0,0,0
2019-05-08 10:45,183,119,64,0,0,0
2019-05-08 11:00,175,100,75,0,0,0
2019-05-08 11:15,152,84,68,0,0,0
2019-05-08 11:30,190,98,92,0,0,0
2019-05-08 11:45,533,264,269,0,0,0
2019-05-08 12:00,362,198,164,0,0,0
2019-05-08 12:15,217,99,118,0,0,0
2019-05-08 12:30,187,93,94,0,0,0
2019-05-08 12:45,236,132,104,0,0,0
2019-05-08 13:00,253,119,134,0,0,0
2019-05-08 13:15,203,77,126,0,0,0
2019-05-08 13:30,209,103,106,0,0,0
2019-05-08 13:45,450,230,220,0,0,0
2019-05-08 14:00,381,227,154,0,0,0
2019-05-08 14:15,200,112,88,0,0,0
2019-05-08 14:30,194,84,110,0,0,0
2019-05-08 14:45,229,114,115,0,0,0
2019-05-08 15:00,185,81,104,0,0,0
2019-05-08 15:15,182,75,107,0,0,0
2019-05-08 15:30,330,98,232,0,0,0
2019-05-08 15:45,506,200,306,0,0,0
2019-05-08 16:00,413,226,187,0,0,0
2019-05-08 16:15,296,135,161,0,0,0
2019-05-08 16:30,243,109,134,0,0,0
2019-05-08 16:45,264,134,130,0,0,0
2019-05-08 17:00,220,92,128,0,0,0
2019-05-08 17:15,266,131,135,0,0,0
2019-05-08 17:30,317,133,184,0,0,0
2019-05-08 17:45,475,229,246,0,0,0
2019-05-08 18:00,333,172,161,0,0,0
2019-05-08 18:15,292,162,130,0,0,0
2019-05-08 18:30,233,89,144,0,0,0
2019-05-08 18:45,257,128,129,0,0,0
2019-05-08 19:00,210,98,112,0,0,0
2019-05-08 19:15,194,81,113,0,0,0
2019-05-08 19:30,204,86,118,0,0,0
2019-05-08 19:45,294,118,176,0,0,0
2019-05-08 20:00,193,76,117,0,0,0
2019-05-08 20:15,130,52,78,0,0,0
2019-05-08 20:30,134,50,84,0,0,0
2019-05-08 20:45,101,35,66,0,0,0
2019-05-08 21:00,124,54,70,0,0,0
2019-05-08 21:15,116,62,54,0,0,0
2019-05-08 21:30,83,25,58,0,0,0
2019-05-08 21:45,113,44,69,0,0,0
2019-05-08 22:00,103,42,61,0,0,0
2019-05-08 22:15,116,52,64,0,0,0
2019-05-08 22:30,74,24,50,0,0,0
2019-05-08 22:45,58,28,30,0,0,0
2019-05-08 23:00,73,26,47,0,0,0
2019-05-08 23:15,76,37,39,0,0,0
2019-05-08 23:30,58,20,38,0,0,0
2019-05-08 23:45,65,23,42,0,0,0
2019-05-09 00:00,45,15,30,0,0,0
2019-05-09 00:15,37,11,26,0,0,0
2019-05-09 00:30,28,9,19,0,0,0
2019-05-09 00:45,34,10,24,0,0,0
2019-05-09 01:00,23,11,12,0,0,0
2019-05-09 01:15,35,8,27,0,0,0
2019-05-09 01:30,27,14,13,0,0,0
2019-05-09 01:45,25,13,12,0,0,0
2019-05-09 02:00,14,4,10,0,0,0
2019-05-09 02:15,26,4,22,0,0,0
2019-05-09 02:30,19,3,16,0,0,0
2019-05-09 02:45,8,2,6,0,0,0
2019-05-09 03:00,9,6,3,0,0,0
2019-05-09 03:15,10,4,6,0,0,0
2019-05-09 03:30,11,5,6,0,0,0
2019-05-09 03:45,10,5,5,0,0,0
2019-05-09 04:00,10,8,2,0,0,0
2019-05-09 04:15,2,1,1,0,0,0
2019-05-09 04:30,4,0,4,0,0,0
2019-05-09 04:45,13,5,8,0,0,0
2019-05-09 05:00,14,10,4,0,0,0
2019-05-09 05:15,10,8,2,0,0,0
2019-05-09 05:30,24,13,11,0,0,0
2019-05-09 05:45,22,15,7,0,0,0
2019-05-09 06:00,21,15,6,0,0,0
2019-05-09 06:15,44,28,16,0,0,0
2019-05-09 06:30,72,54,18,0,0,0
2019-05-09 06:45,109,69,40,0,0,0
2019-05-09 07:00,102,62,40,0,0,0
2019-05-09 07:15,147,100,47,0,0,0
2019-05-09 07:30,300,193,107,0,0,0
2019-05-09 07:45,439,214,225,0,0,0
2019-05-09 08:00,492,266,226,0,0,0
2019-05-09 08:15,286,156,130,0,0,0
2019-05-09 08:30,233,148,85,0,0,0
2019-05-09 08:45,240,145,95,0,0,0
2019-05-09 09:00,195,130,65,0,0,0
2019-05-09 09:15,181,100,81,0,0,0
2019-05-09 09:30,223,108,115,0,0,0
2019-05-09 09:45,540,268,272,0,0,0
2019-05-09 10:00,519,334,185,0,0,0
2019-05-09 10:15,175,100,75,0,0,0
2019-05-09 10:30,122,61,61,0,0,0
2019-05-09 10:45,158,97,61,0,0,0
2019-05-09 11:00,137,69,68,0,0,0
2019-05-09 11:15,154,80,74,0,0,0
2019-05-09 11:30,251,122,129,0,0,0
2019-05-09 11:45,510,242,268,0,0,0
2019-05-09 12:00,412,254,158,0,0,0
2019-05-09 12:15,243,110,133,0,0,0
2019-05-09 12:30,232,98,134,0,0,0
2019-05-09 12:45,220,123,97,0,0,0
2019-05-09 13:00,231,104,127,0,0,0
2019-05-09 13:15,234,124,110,0,0,0
2019-05-09 13:30,294,159,135,0,0,0
2019-05-09 13:45,499,185,314,0,0,0
2019-05-09 14:00,416,228,188,0,0,0
2019-05-09 14:15,237,128,109,0,0,0
2019-05-09 14:30,211,101,110,0,0,0
2019-05-09 14:45,219,111,108,0,0,0
2019-05-09 15:00,239,112,127,0,0,0
2019-05-09 15:15,209,100,109,0,0,0
2019-05-09 15:30,322,100,222,0,0,0
2019-05-09 15:45,550,280,270,0,0,0
2019-05-09 16:00,427,243,184,0,0,0
2019-05-09 16:15,262,123,139,0,0,0
2019-05-09 16:30,300,147,153,0,0,0
2019-05-09 16:45,263,121,142,0,0,0
2019-05-09 17:00,326,164,162,0,0,0
2019-05-09 17:15,276,130,146,0,0,0
2019-05-09 17:30,375,205,170,0,0,0
2019-05-09 17:45,544,256,288,0,0,0
2019-05-09 18:00,394,201,193,0,0,0
2019-05-09 18:15,323,149,174,0,0,0
2019-05-09 18:30,250,118,132,0,0,0
2019-05-09 18:45,285,132,153,0,0,0
2019-05-09 19:00,240,124,116,0,0,0
2019-05-09 19:15,248,140,108,0,0,0
2019-05-09 19:30,294,107,187,0,0,0
2019-05-09 19:45,303,138,165,0,0,0
2019-05-09 20:00,219,100,119,0,0,0
2019-05-09 20:15,199,104,95,0,0,0
2019-05-09 20:30,167,73,94,0,0,0
2019-05-09 20:45,132,59,73,0,0,0
2019-05-09 21:00,136,79,57,0,0,0
2019-05-09 21:15,105,63,42,0,0,0
2019-05-09 21:30,116,44,72,0,0,0
2019-05-09 21:45,118,45,73,0,0,0
2019-05-09 22:00,120,44,76,0,0,0
2019-05-09 22:15,104,48,56,0,0,0
2019-05-09 22:30,117,49,68,0,0,0
2019-05-09 22:45,102,34,68,0,0,0
2019-05-09 23:00,105,40,65,0,0,0
2019-05-09 23:15,61,15,46,0,0,0
2019-05-09 23:30,48,15,33,0,0,0
2019-05-09 23:45,83,26,57,0,0,0
2019-05-10 00:00,65,32,33,0,0,0
2019-05-10 00:15,32,13,19,0,0,0
2019-05-10 00:30,36,9,27,0,0,0
2019-05-10 00:45,41,16,25,0,0,0
2019-05-10 01:00,32,5,27,0,0,0
2019-05-10 01:15,16,2,14,0,0,0
2019-05-10 01:30,33,9,24,0,0,0
2019-05-10 01:45,24,10,14,0,0,0
2019-05-10 02:00,7,3,4,0,0,0
2019-05-10 02:15,10,2,8,0,0,0
2019-05-10 02:30,13,1,12,0,0,0
2019-05-10 02:45,6,1,5,0,0,0
2019-05-10 03:00,8,3,5,0,0,0
2019-05-10 03:15,13,3,10,0,0,0
2019-05-10 03:30,11,1,10,0,0,0
2019-05-10 03:45,13,2,11,0,0,0
2019-05-10 04:00,5,2,3,0,0,0
2019-05-10 04:15,7,5,2,0,0,0
2019-05-10 04:30,6,3,3,0,0,0
2019-05-10 04:45,15,3,12,0,0,0
2019-05-10 05:00,16,11,5,0,0,0
2019-05-10 05:15,9,5,4,0,0,0
2019-05-10 05:30,23,10,13,0,0,0
2019-05-10 05:45,21,15,6,0,0,0
2019-05-10 06:00,23,19,4,0,0,0
2019-05-10 06:15,39,27,12,0,0,0
2019-05-10 06:30,45,29,16,0,0,0
2019-05-10 06:45,87,56,31,0,0,0
2019-05-10 07:00,93,65,28,0,0,0
2019-05-10 07:15,142,92,50,0,0,0
2019-05-10 07:30,256,178,78,0,0,0
2019-05-10 07:45,315,180,135,0,0,0
2019-05-10 08:00,369,205,164,0,0,0
2019-05-10 08:15,235,134,101,0,0,0
2019-05-10 08:30,219,134,85,0,0,0
2019-05-10 08:45,256,163,93,0,0,0
2019-05-10 09:00,221,154,67,0,0,0
2019-05-10 09:15,157,91,66,0,0,0
2019-05-10 09:30,216,108,108,0,0,0
2019-05-10 09:45,348,159,189,0,0,0
2019-05-10 10:00,359,188,171,0,0,0
2019-05-10 10:15,137,86,51,0,0,0
2019-05-10 10:30,139,68,71,0,0,0
2019-05-10 10:45,146,82,64,0,0,0
2019-05-10 11:00,164,92,72,0,0,0
2019-05-10 11:15,145,85,60,0,0,0
2019-05-10 11:30,186,95,91,0,0,0
2019-05-10 11:45,307,168,139,0,0,0
2019-05-10 12:00,235,140,95,0,0,0
2019-05-10 12:15,182,76,106,0,0,0
2019-05-10 12:30,203,99,104,0,0,0
2019-05-10 12:45,251,136,115,0,0,0
2019-05-10 13:00,258,124,134,0,0,0
2019-05-10 13:15,213,105,108,0,0,0
2019-05-10 13:30,269,142,127,0,0,0
2019-05-10 13:45,316,177,139,0,0,0
2019-05-10 14:00,277,159,118,0,0,0
2019-05-10 14:15,222,128,94,0,0,0
2019-05-10 14:30,205,106,99,0,0,0
2019-05-10 14:45,235,130,105,0,0,0
2019-05-10 15:00,196,93,103,0,0,0
2019-05-10 15:15,194,99,95,0,0,0
2019-05-10 15:30,233,126,107,0,0,0
2019-05-10 15:45,283,165,118,0,0,0
2019-05-10 16:00,246,135,111,0,0,0
2019-05-10 16:15,241,120,121,0,0,0
2019-05-10 16:30,255,132,123,0,0,0
2019-05-10 16:45,237,115,122,0,0,0
2019-05-10 17:00,217,106,111,0,0,0
2019-05-10 17:15,207,96,111,0,0,0
2019-05-10 17:30,234,111,123,0,0,0
2019-05-10 17:45,262,112,150,0,0,0
2019-05-10 18:00,248,110,138,0,0,0
2019-05-10 18:15,234,113,121,0,0,0
2019-05-10 18:30,177,92,85,0,0,0
2019-05-10 18:45,218,109,109,0,0,0
2019-05-10 19:00,180,92,88,0,0,0
2019-05-10 19:15,196,94,102,0,0,0
2019-05-10 19:30,172,83,89,0,0,0
2019-05-10 19:45,196,94,102,0,0,0
2019-05-10 20:00,158,77,81,0,0,0
2019-05-10 20:15,147,83,64,0,0,0
2019-05-10 20:30,134,86,48,0,0,0
2019-05-10 20:45,126,79,47,0,0,0
2019-05-10 21:00,113,59,54,0,0,0
2019-05-10 21:15,107,53,54,0,0,0
2019-05-10 21:30,102,53,49,0,0,0
2019-05-10 21:45,101,39,62,0,0,0
2019-05-10 22:00,82,24,58,0,0,0
2019-05-10 22:15,100,47,53,0,0,0
2019-05-10 22:30,90,35,55,0,0,0
2019-05-10 22:45,91,22,69,0,0,0
2019-05-10 23:00,118,54,64,0,0,0
2019-05-10 23:15,89,39,50,0,0,0
2019-05-10 23:30,87,29,58,0,0,0
2019-05-10 23:45,78,39,39,0,0,0
2019-05-11 00:00,83,34,49,0,0,0
2019-05-11 00:15,67,26,41,0,0,0
2019-05-11 00:30,77,25,52,0,0,0
2019-05-11 00:45,47,13,34,0,0,0
2019-05-11 01:00,58,21,37,0,0,0
2019-05-11 01:15,71,26,45,0,0,0
2019-05-11 01:30,46,4,42,0,0,0
2019-05-11 01:45,77,23,54,0,0,0
2019-05-11 02:00,60,10,50,0,0,0
2019-05-11 02:15,45,8,37,0,0,0
2019-05-11 02:30,44,13,31,0,0,0
2019-05-11 02:45,71,18,53,0,0,0
2019-05-11 03:00,46,2,44,0,0,0
2019-05-11 03:15,23,7,16,0,0,0
2019-05-11 03:30,32,10,22,0,0,0
2019-05-11 03:45,43,7,36,0,0,0
2019-05-11 04:00,23,8,15,0,0,0
2019-05-11 04:15,21,6,15,0,0,0
2019-05-11 04:30,16,1,15,0,0,0
2019-05-11 04:45,12,5,7,0,0,0
2019-05-11 05:00,8,5,3,0,0,0
2019-05-11 05:15,16,8,8,0,0,0
2019-05-11 05:30,13,6,7,0,0,0
2019-05-11 05:45,18,8,10,0,0,0
2019-05-11 06:00,15,7,8,0,0,0
2019-05-11 06:15,16,7,9,0,0,0
2019-05-11 06:30,12,9,3,0,0,0
2019-05-11 06:45,18,12,6,0,0,0
2019-05-11 07:00,15,11,4,0,0,0
2019-05-11 07:15,14,10,4,0,0,0
2019-05-11 07:30,30,22,8,0,0,0
2019-05-11 07:45,70,59,11,0,0,0
2019-05-11 08:00,43,32,11,0,0,0
2019-05-11 08:15,58,33,25,0,0,0
2019-05-11 08:30,64,33,31,0,0,0
2019-05-11 08:45,107,69,38,0,0,0
2019-05-11 09:00,86,61,25,0,0,0
2019-05-11 09:15,82,55,27,0,0,0
2019-05-11 09:30,140,99,41,0,0,0
2019-05-11 09:45,196,154,42,0,0,0
2019-05-11 10:00,127,92,35,0,0,0
2019-05-11 10:15,139,101,38,0,0,0
2019-05-11 10:30,126,87,39,0,0,0
2019-05-11 10:45,157,109,48,0,0,0
2019-05-11 11:00,107,82,25,0,0,0
2019-05-11 11:15,124,91,33,0,0,0
2019-05-11 11:30,150,107,43,0,0,0
2019-05-11 11:45,171,107,64,0,0,0
2019-05-11 12:00,149,84,65,0,0,0
2019-05-11 12:15,178,94,84,0,0,0
2019-05-11 12:30,187,108,79,0,0,0
2019-05-11 12:45,182,106,76,0,0,0
2019-05-11 13:00,184,89,95,0,0,0
2019-05-11 13:15,139,90,49,0,0,0
2019-05-11 13:30,168,85,83,0,0,0
2019-05-11 13:45,144,66,78,0,0,0
2019-05-11 14:00,153,73,80,0,0,0
2019-05-11 14:15,145,65,80,0,0,0
2019-05-11 14:30,159,82,77,0,0,0
2019-05-11 14:45,154,79,75,0,0,0
2019-05-11 15:00,157,70,87,0,0,0
2019-05-11 15:15,136,55,81,0,0,0
2019-05-11 15:30,173,92,81,0,0,0
2019-05-11 15:45,152,68,84,0,0,0
2019-05-11 16:00,141,60,81,0,0,0
2019-05-11 16:15,152,52,100,0,0,0
2019-05-11 16:30,136,64,72,0,0,0
2019-05-11 16:45,159,70,89,0,0,0
2019-05-11 17:00,153,63,90,0,0,0
2019-05-11 17:15,156,70,86,0,0,0
2019-05-11 17:30,171,72,99,0,0,0
2019-05-11 17:45,202,85,117,0,0,0
2019-05-11 18:00,173,63,110,0,0,0
2019-05-11 18:15,133,68,65,0,0,0
2019-05-11 18:30,113,43,70,0,0,0
2019-05-11 18:45,132,68,64,0,0,0
2019-05-11 19:00,130,66,64,0,0,0
2019-05-11 19:15,167,59,108,0,0,0
2019-05-11 19:30,146,49,97,0,0,0
2019-05-11 19:45,176,66,110,0,0,0
2019-05-11 20:00,139,52,87,0,0,0
2019-05-11 20:15,116,60,56,0,0,0
2019-05-11 20:30,97,43,54,0,0,0
2019-05-11 20:45,109,62,47,0,0,0
2019-05-11 21:00,110,57,53,0,0,0
2019-05-11 21:15,79,32,47,0,0,0
2019-05-11 21:30,78,30,48,0,0,0
2019-05-11 21:45,81,29,52,0,0,0
2019-05-11 22:00,55,30,25,0,0,0
2019-05-11 22:15,77,29,48,0,0,0
2019-05-11 22:30,64,29,35,0,0,0
2019-05-11 22:45,74,25,49,0,0,0
2019-05-11 23:00,54,16,38,0,0,0
2019-05-11 23:15,48,22,26,0,0,0
2019-05-11 23:30,62,26,36,0,0,0
2019-05-11 23:45,63,20,43,0,0,0
2019-05-12 00:00,68,18,50,0,0,0
2019-05-12 00:15,48,11,37,0,0,0
2019-05-12 00:30,62,24,38,0,0,0
2019-05-12 00:45,56,22,34,0,0,0
2019-05-12 01:00,56,21,35,0,0,0
2019-05-12 01:15,91,36,55,0,0,0
2019-05-12 01:30,48,12,36,0,0,0
2019-05-12 01:45,38,6,32,0,0,0
2019-05-12 02:00,36,13,23,0,0,0
2019-05-12 02:15,45,14,31,0,0,0
2019-05-12 02:30,34,7,27,0,0,0
2019-05-12 02:45,31,10,21,0,0,0
2019-05-12 03:00,41,16,25,0,0,0
2019-05-12 03:15,38,6,32,0,0,0
2019-05-12 03:30,24,13,11,0,0,0
2019-05-12 03:45,19,2,17,0,0,0
2019-05-12 04:00,20,5,15,0,0,0
2019-05-12 04:15,21,7,14,0,0,0
2019-05-12 04:30,13,6,7,0,0,0
2019-05-12 04:45,15,2,13,0,0,0
2019-05-12 05:00,12,4,8,0,0,0
2019-05-12 05:15,12,3,9,0,0,0
2019-05-12 05:30,11,5,6,0,0,0
2019-05-12 05:45,11,7,4,0,0,0
2019-05-12 06:00,17,7,10,0,0,0
2019-05-12 06:15,5,2,3,0,0,0
2019-05-12 06:30,5,2,3,0,0,0
2019-05-12 06:45,9,6,3,0,0,0
2019-05-12 07:00,15,7,8,0,0,0
2019-05-12 07:15,8,8,0,0,0,0
2019-05-12 07:30,12,7,5,0,0,0
2019-05-12 07:45,20,10,10,0,0,0
2019-05-12 08:00,14,9,5,0,0,0
2019-05-12 08:15,16,10,6,0,0,0
2019-05-12 08:30,38,23,15,0,0,0
2019-05-12 08:45,44,23,21,0,0,0
2019-05-12 09:00,37,25,12,0,0,0
2019-05-12 09:15,38,30,8,0,0,0
2019-05-12 09:30,76,40,36,0,0,0
2019-05-12 09:45,107,85,22,0,0,0
2019-05-12 10:00,70,42,28,0,0,0
2019-05-12 10:15,66,45,21,0,0,0
2019-05-12 10:30,86,57,29,0,0,0
2019-05-12 10:45,127,87,40,0,0,0
2019-05-12 11:00,79,47,32,0,0,0
2019-05-12 11:15,73,49,24,0,0,0
2019-05-12 11:30,83,46,37,0,0,0
2019-05-12 11:45,123,70,53,0,0,0
2019-05-12 12:00,102,66,36,0,0,0
2019-05-12 12:15,108,68,40,0,0,0
2019-05-12 12:30,94,58,36,0,0,0
2019-05-12 12:45,134,66,68,0,0,0
2019-05-12 13:00,103,64,39,0,0,0
2019-05-12 13:15,130,79,51,0,0,0
2019-05-12 13:30,115,66,49,0,0,0
2019-05-12 13:45,151,89,62,0,0,0
2019-05-12 14:00,106,76,30,0,0,0
2019-05-12 14:15,116,64,52,0,0,0
2019-05-12 14:30,120,68,52,0,0,0
2019-05-12 14:45,124,62,62,0,0,0
2019-05-12 15:00,168,84,84,0,0,0
2019-05-12 15:15,157,81,76,0,0,0
2019-05-12 15:30,106,55,51,0,0,0
2019-05-12 15:45,137,62,75,0,0,0
2019-05-12 16:00,137,47,90,0,0,0
2019-05-12 16:15,124,54,70,0,0,0
2019-05-12 16:30,146,48,98,0,0,0
2019-05-12 16:45,119,50,69,0,0,0
2019-05-12 17:00,135,63,72,0,0,0
2019-05-12 17:15,142,48,94,0,0,0
2019-05-12 17:30,162,80,82,0,0,0
2019-05-12 17:45,117,62,55,0,0,0
2019-05-12 18:00,110,47,63,0,0,0
2019-05-12 18:15,110,52,58,0,0,0
2019-05-12 18:30,114,61,53,0,0,0
2019-05-12 18:45,133,57,76,0,0,0
2019-05-12 19:00,99,39,60,0,0,0
2019-05-12 19:15,82,42,40,0,0,0
2019-05-12 19:30,107,50,57,0,0,0
2019-05-12 19:45,116,42,74,0,0,0
2019-05-12 20:00,96,29,67,0,0,0
2019-05-12 20:15,91,37,54,0,0,0
2019-05-12 20:30,79,21,58,0,0,0
2019-05-12 20:45,48,20,28,0,0,0
2019-05-12 21:00,73,25,48,0,0,0
2019-05-12 21:15,50,14,36,0,0,0
2019-05-12 21:30,61,14,47,0,0,0
2019-05-12 21:45,57,15,42,0,0,0
2019-05-12 22:00,53,17,36,0,0,0
2019-05-12 22:15,48,17,31,0,0,0
2019-05-12 22:30,56,13,43,0,0,0
2019-05-12 22:45,37,12,25,0,0,0
2019-05-12 23:00,32,12,20,0,0,0
2019-05-12 23:15,22,6,16,0,0,0
2019-05-12 23:30,21,7,14,0,0,0
2019-05-12 23:45,16,7,9,0,0,0
2019-05-13 00:00,17,5,12,0,0,0
2019-05-13 00:15,11,2,9,0,0,0
2019-05-13 00:30,11,2,9,0,0,0
2019-05-13 00:45,6,2,4,0,0,0
2019-05-13 01:00,11,3,8,0,0,0
2019-05-13 01:15,3,2,1,0,0,0
2019-05-13 01:30,5,1,4,0,0,0
2019-05-13 01:45,8,4,4,0,0,0
2019-05-13 02:00,1,0,1,0,0,0
2019-05-13 02:15,4,1,3,0,0,0
2019-05-13 02:30,3,1,2,0,0,0
2019-05-13 02:45,4,2,2,0,0,0
2019-05-13 03:00,0,0,0,0,0,0
2019-05-13 03:15,1,0,1,0,0,0
2019-05-13 03:30,1,1,0,0,0,0
2019-05-13 03:45,0,0,0,0,0,0
2019-05-13 04:00,2,0,2,0,0,0
2019-05-13 04:15,3,3,0,0,0,0
2019-05-13 04:30,5,3,2,0,0,0
2019-05-13 04:45,8,6,2,0,0,0
2019-05-13 05:00,9,7,2,0,0,0
2019-05-13 05:15,15,7,8,0,0,0
2019-05-13 05:30,24,14,10,0,0,0
2019-05-13 05:45,20,11,9,0,0,0
2019-05-13 06:00,32,26,6,0,0,0
2019-05-13 06:15,44,34,10,0,0,0
2019-05-13 06:30,74,54,20,0,0,0
2019-05-13 06:45,94,62,32,0,0,0
2019-05-13 07:00,102,65,37,0,0,0
2019-05-13 07:15,174,120,54,0,0,0
2019-05-13 07:30,280,185,95,0,0,0
2019-05-13 07:45,401,221,180,0,0,0
2019-05-13 08:00,431,197,234,0,0,0
2019-05-13 08:15,293,184,109,0,0,0
2019-05-13 08:30,233,145,88,0,0,0
2019-05-13 08:45,265,172,93,0,0,0
2019-05-13 09:00,233,148,85,0,0,0
2019-05-13 09:15,176,122,54,0,0,0
2019-05-13 09:30,189,85,104,0,0,0
2019-05-13 09:45,217,1,216,0,0,0
2019-05-13 10:00,339,126,213,0,0,0
2019-05-13 10:15,187,103,84,0,0,0
2019-05-13 10:30,148,76,72,0,0,0
2019-05-13 10:45,142,84,58,0,0,0
2019-05-13 11:00,126,78,48,0,0,0
2019-05-13 11:15,142,73,69,0,0,0
2019-05-13 11:30,220,120,100,0,0,0
2019-05-13 11:45,464,206,258,0,0,0
2019-05-13 12:00,351,219,132,0,0,0
2019-05-13 12:15,221,101,120,0,0,0
2019-05-13 12:30,213,105,108,0,0,0
2019-05-13 12:45,237,107,130,0,0,0
2019-05-13 13:00,264,116,148,0,0,0
2019-05-13 13:15,216,98,118,0,0,0
2019-05-13 13:30,271,115,156,0,0,0
2019-05-13 13:45,434,209,225,0,0,0
2019-05-13 14:00,434,245,189,0,0,0
2019-05-13 14:15,228,105,123,0,0,0
2019-05-13 14:30,222,96,126,0,0,0
2019-05-13 14:45,233,100,133,0,0,0
2019-05-13 15:00,249,103,146,0,0,0
2019-05-13 15:15,232,120,112,0,0,0
2019-05-13 15:30,341,142,199,0,0,0
2019-05-13 15:45,574,289,285,0,0,0
2019-05-13 16:00,432,244,188,0,0,0
2019-05-13 16:15,335,201,134,0,0,0
2019-05-13 16:30,322,183,139,0,0,0
2019-05-13 16:45,331,158,173,0,0,0
2019-05-13 17:00,313,144,169,0,0,0
2019-05-13 17:15,344,177,167,0,0,0
2019-05-13 17:30,425,195,230,0,0,0
2019-05-13 17:45,677,271,406,0,0,0
2019-05-13 18:00,492,243,249,0,0,0
2019-05-13 18:15,368,163,205,0,0,0
2019-05-13 18:30,335,130,205,0,0,0
2019-05-13 18:45,331,147,184,0,0,0
2019-05-13 19:00,301,151,150,0,0,0
2019-05-13 19:15,278,147,131,0,0,0
2019-05-13 19:30,312,120,192,0,0,0
2019-05-13 19:45,322,143,179,0,0,0
2019-05-13 20:00,250,122,128,0,0,0
2019-05-13 20:15,239,111,128,0,0,0
2019-05-13 20:30,181,105,76,0,0,0
2019-05-13 20:45,137,74,63,0,0,0
2019-05-13 21:00,142,73,69,0,0,0
2019-05-13 21:15,124,60,64,0,0,0
2019-05-13 21:30,117,50,67,0,0,0
2019-05-13 21:45,135,58,77,0,0,0
2019-05-13 22:00,149,70,79,0,0,0
2019-05-13 22:15,140,58,82,0,0,0
2019-05-13 22:30,110,48,62,0,0,0
2019-05-13 22:45,143,37,106,0,0,0
2019-05-13 23:00,95,43,52,0,0,0
2019-05-13 23:15,64,26,38,0,0,0
2019-05-13 23:30,67,31,36,0,0,0
2019-05-13 23:45,53,19,34,0,0,0
2019-05-14 00:00,31,8,23,0,0,0
2019-05-14 00:15,30,15,15,0,0,0
2019-05-14 00:30,34,13,21,0,0,0
2019-05-14 00:45,20,5,15,0,0,0
2019-05-14 01:00,18,6,12,0,0,0
2019-05-14 01:15,19,8,11,0,0,0
2019-05-14 01:30,18,5,13,0,0,0
2019-05-14 01:45,4,1,3,0,0,0
2019-05-14 02:00,13,3,10,0,0,0
2019-05-14 02:15,11,2,9,0,0,0
2019-05-14 02:30,2,1,1,0,0,0
2019-05-14 02:45,3,2,1,0,0,0
2019-05-14 03:00,2,2,0,0,0,0
2019-05-14 03:15,3,1,2,0,0,0
2019-05-14 03:30,1,0,1,0,0,0
2019-05-14 03:45,2,2,0,0,0,0
2019-05-14 04:00,2,1,1,0,0,0
2019-05-14 04:15,6,4,2,0,0,0
2019-05-14 04:30,4,4,0,0,0,0
2019-05-14 04:45,4,2,2,0,0,0
2019-05-14 05:00,15,12,3,0,0,0
2019-05-14 05:15,12,6,6,0,0,0
2019-05-14 05:30,22,11,11,0,0,0
2019-05-14 05:45,31,22,9,0,0,0
2019-05-14 06:00,30,20,10,0,0,0
2019-05-14 06:15,45,32,13,0,0,0
2019-05-14 06:30,85,56,29,0,0,0
2019-05-14 06:45,106,66,40,0,0,0
2019-05-14 07:00,106,71,35,0,0,0
2019-05-14 07:15,173,128,45,0,0,0
2019-05-14 07:30,358,209,149,0,0,0
2019-05-14 07:45,417,243,174,0,0,0
2019-05-14 08:00,585,327,258,0,0,0
2019-05-14 08:15,329,191,138,0,0,0
2019-05-14 08:30,273,178,95,0,0,0
2019-05-14 08:45,294,175,119,0,0,0
2019-05-14 09:00,276,203,73,0,0,0
2019-05-14 09:15,202,127,75,0,0,0
2019-05-14 09:30,269,117,152,0,0,0
2019-05-14 09:45,574,250,324,0,0,0
2019-05-14 10:00,526,328,198,0,0,0
2019-05-14 10:15,201,116,85,0,0,0
2019-05-14 10:30,178,96,82,0,0,0
2019-05-14 10:45,176,97,79,0,0,0
2019-05-14 11:00,137,74,63,0,0,0
2019-05-14 11:15,147,96,51,0,0,0
2019-05-14 11:30,272,133,139,0,0,0
2019-05-14 11:45,505,260,245,0,0,0
2019-05-14 12:00,395,240,155,0,0,0
2019-05-14 12:15,217,118,99,0,0,0
2019-05-14 12:30,202,88,114,0,0,0
2019-05-14 12:45,235,131,104,0,0,0
2019-05-14 13:00,299,124,175,0,0,0
2019-05-14 13:15,231,106,125,0,0,0
2019-05-14 13:30,282,125,157,0,0,0
2019-05-14 13:45,587,236,351,0,0,0
2019-05-14 14:00,426,217,209,0,0,0
2019-05-14 14:15,245,122,123,0,0,0
2019-05-14 14:30,248,129,119,0,0,0
2019-05-14 14:45,232,115,117,0,0,0
2019-05-14 15:00,211,111,100,0,0,0
2019-05-14 15:15,249,124,125,0,0,0
2019-05-14 15:30,288,133,155,0,0,0
2019-05-14 15:45,594,337,257,0,0,0
2019-05-14 16:00,494,289,205,0,0,0
2019-05-14 16:15,287,155,132,0,0,0
2019-05-14 16:30,301,151,150,0,0,0
2019-05-14 16:45,304,155,149,0,0,0
2019-05-14 17:00,355,190,165,0,0,0
2019-05-14 17:15,348,169,179,0,0,0
2019-05-14 17:30,435,223,212,0,0,0
2019-05-14 17:45,659,300,359,0,0,0
2019-05-14 18:00,449,225,224,0,0,0
2019-05-14 18:15,430,222,208,0,0,0
2019-05-14 18:30,361,167,194,0,0,0
2019-05-14 18:45,332,156,176,0,0,0
2019-05-14 19:00,280,140,140,0,0,0
2019-05-14 19:15,246,131,115,0,0,0
2019-05-14 19:30,265,157,108,0,0,0
2019-05-14 19:45,337,154,183,0,0,0
2019-05-14 20:00,312,130,182,0,0,0
2019-05-14 20:15,220,103,117,0,0,0
2019-05-14 20:30,160,78,82,0,0,0
2019-05-14 20:45,155,69,86,0,0,0
2019-05-14 21:00,150,66,84,0,0,0
2019-05-14 21:15,148,58,90,0,0,0
2019-05-14 21:30,213,52,161,0,0,0
2019-05-14 21:45,127,38,89,0,0,0
2019-05-14 22:00,151,47,104,0,0,0
2019-05-14 22:15,146,67,79,0,0,0
2019-05-14 22:30,137,77,60,0,0,0
2019-05-14 22:45,130,42,88,0,0,0
2019-05-14 23:00,109,29,80,0,0,0
2019-05-14 23:15,69,29,40,0,0,0
2019-05-14 23:30,50,16,34,0,0,0
2019-05-14 23:45,47,17,30,0,0,0
2019-05-15 00:00,49,19,30,0,0,0
2019-05-15 00:15,37,8,29,0,0,0
2019-05-15 00:30,24,14,10,0,0,0
2019-05-15 00:45,31,9,22,0,0,0
2019-05-15 01:00,20,5,15,0,0,0
2019-05-15 01:15,19,5,14,0,0,0
2019-05-15 01:30,13,4,9,0,0,0
2019-05-15 01:45,7,2,5,0,0,0
2019-05-15 02:00,5,3,2,0,0,0
2019-05-15 02:15,10,2,8,0,0,0
2019-05-15 02:30,10,4,6,0,0,0
2019-05-15 02:45,6,2,4,0,0,0
2019-05-15 03:00,5,1,4,0,0,0
2019-05-15 03:15,3,2,1,0,0,0
2019-05-15 03:30,4,4,0,0,0,0
2019-05-15 03:45,4,4,0,0,0,0
2019-05-15 04:00,0,0,0,0,0,0
2019-05-15 04:15,4,4,0,0,0,0
2019-05-15 04:30,2,2,0,0,0,0
2019-05-15 04:45,11,6,5,0,0,0
2019-05-15 05:00,9,7,2,0,0,0
2019-05-15 05:15,17,10,7,0,0,0
2019-05-15 05:30,22,11,11,0,0,0
2019-05-15 05:45,25,16,9,0,0,0
2019-05-15 06:00,34,24,10,0,0,0
2019-05-15 06:15,48,33,15,0,0,0
2019-05-15 06:30,75,55,20,0,0,0
2019-05-15 06:45,135,106,29,0,0,0
2019-05-15 07:00,123,85,38,0,0,0
2019-05-15 07:15,261,203,58,0,0,0
2019-05-15 07:30,351,235,116,0,0,0
2019-05-15 07:45,511,280,231,0,0,0
2019-05-15 08:00,556,286,270,0,0,0
2019-05-15 08:15,326,187,139,0,0,0
2019-05-15 08:30,285,175,110,0,0,0
2019-05-15 08:45,297,178,119,0,0,0
2019-05-15 09:00,239,143,96,0,0,0
2019-05-15 09:15,194,102,92,0,0,0
2019-05-15 09:30,249,142,107,0,0,0
2019-05-15 09:45,529,261,268,0,0,0
2019-05-15 10:00,582,328,254,0,0,0
2019-05-15 10:15,199,115,84,0,0,0
2019-05-15 10:30,191,113,78,0,0,0
2019-05-15 10:45,174,97,77,0,0,0
2019-05-15 11:00,168,94,74,0,0,0
2019-05-15 11:15,194,105,89,0,0,0
2019-05-15 11:30,208,98,110,0,0,0
2019-05-15 11:45,541,290,251,0,0,0
2019-05-15 12:00,372,221,151,0,0,0
2019-05-15 12:15,258,130,128,0,0,0
2019-05-15 12:30,210,107,103,0,0,0
2019-05-15 12:45,234,131,103,0,0,0
2019-05-15 13:00,258,127,131,0,0,0
2019-05-15 13:15,229,120,109,0,0,0
2019-05-15 13:30,271,138,133,0,0,0
2019-05-15 13:45,473,203,270,0,0,0
2019-05-15 14:00,417,253,164,0,0,0
2019-05-15 14:15,253,129,124,0,0,0
2019-05-15 14:30,263,143,120,0,0,0
2019-05-15 14:45,263,136,127,0,0,0
2019-05-15 15:00,259,117,142,0,0,0
2019-05-15 15:15,239,117,122,0,0,0
2019-05-15 15:30,371,143,228,0,0,0
2019-05-15 15:45,581,272,309,0,0,0
2019-05-15 16:00,512,278,234,0,0,0
2019-05-15 16:15,340,175,165,0,0,0
2019-05-15 16:30,283,129,154,0,0,0
2019-05-15 16:45,314,153,161,0,0,0
2019-05-15 17:00,321,149,172,0,0,0
2019-05-15 17:15,350,186,164,0,0,0
2019-05-15 17:30,432,188,244,0,0,0
2019-05-15 17:45,547,257,290,0,0,0
2019-05-15 18:00,424,194,230,0,0,0
2019-05-15 18:15,361,161,200,0,0,0
2019-05-15 18:30,335,167,168,0,0,0
2019-05-15 18:45,384,191,193,0,0,0
2019-05-15 19:00,307,159,148,0,0,0
2019-05-15 19:15,267,130,137,0,0,0
2019-05-15 19:30,265,123,142,0,0,0
2019-05-15 19:45,348,146,202,0,0,0
2019-05-15 20:00,222,113,109,0,0,0
2019-05-15 20:15,232,111,121,0,0,0
2019-05-15 20:30,199,85,114,0,0,0
2019-05-15 20:45,203,111,92,0,0,0
2019-05-15 21:00,176,87,89,0,0,0
2019-05-15 21:15,161,73,88,0,0,0
2019-05-15 21:30,166,78,88,0,0,0
2019-05-15 21:45,124,61,63,0,0,0
2019-05-15 22:00,137,63,74,0,0,0
2019-05-15 22:15,160,74,86,0,0,0
2019-05-15 22:30,144,49,95,0,0,0
2019-05-15 22:45,142,85,57,0,0,0
2019-05-15 23:00,95,41,54,0,0,0
2019-05-15 23:15,90,53,37,0,0,0
2019-05-15 23:30,121,69,52,0,0,0
2019-05-15 23:45,100,60,40,0,0,0
2019-05-16 00:00,80,41,39,0,0,0
2019-05-16 00:15,115,55,60,0,0,0
2019-05-16 00:30,59,22,37,0,0,0
2019-05-16 00:45,67,19,48,0,0,0
2019-05-16 01:00,50,13,37,0,0,0
2019-05-16 01:15,54,27,27,0,0,0
2019-05-16 01:30,40,6,34,0,0,0
2019-05-16 01:45,27,6,21,0,0,0
2019-05-16 02:00,44,5,39,0,0,0
2019-05-16 02:15,37,4,33,0,0,0
2019-05-16 02:30,49,7,42,0,0,0
2019-05-16 02:45,25,2,23,0,0,0
2019-05-16 03:00,33,6,27,0,0,0
2019-05-16 03:15,18,3,15,0,0,0
2019-05-16 03:30,29,3,26,0,0,0
2019-05-16 03:45,34,2,32,0,0,0
2019-05-16 04:00,11,1,10,0,0,0
2019-05-16 04:15,15,2,13,0,0,0
2019-05-16 04:30,4,3,1,0,0,0
2019-05-16 04:45,15,6,9,0,0,0
2019-05-16 05:00,15,7,8,0,0,0
2019-05-16 05:15,15,7,8,0,0,0
2019-05-16 05:30,25,13,12,0,0,0
2019-05-16 05:45,29,20,9,0,0,0
2019-05-16 06:00,30,20,10,0,0,0
2019-05-16 06:15,38,29,9,0,0,0
2019-05-16 06:30,68,39,29,0,0,0
2019-05-16 06:45,106,75,31,0,0,0
2019-05-16 07:00,100,64,36,0,0,0
2019-05-16 07:15,171,108,63,0,0,0
2019-05-16 07:30,265,171,94,0,0,0
2019-05-16 07:45,438,218,220,0,0,0
2019-05-16 08:00,480,242,238,0,0,0
2019-05-16 08:15,285,174,111,0,0,0
2019-05-16 08:30,229,145,84,0,0,0
2019-05-16 08:45,281,189,92,0,0,0
2019-05-16 09:00,233,131,102,0,0,0
2019-05-16 09:15,193,119,74,0,0,0
2019-05-16 09:30,286,163,123,0,0,0
2019-05-16 09:45,418,222,196,0,0,0
2019-05-16 10:00,450,285,165,0,0,0
2019-05-16 10:15,184,99,85,0,0,0
2019-05-16 10:30,149,79,70,0,0,0
2019-05-16 10:45,127,70,57,0,0,0
2019-05-16 11:00,154,91,63,0,0,0
2019-05-16 11:15,148,80,68,0,0,0
2019-05-16 11:30,203,71,132,0,0,0
2019-05-16 11:45,471,224,247,0,0,0
2019-05-16 12:00,394,233,161,0,0,0
2019-05-16 12:15,217,110,107,0,0,0
2019-05-16 12:30,237,116,121,0,0,0
2019-05-16 12:45,215,98,117,0,0,0
2019-05-16 13:00,213,112,101,0,0,0
2019-05-16 13:15,213,102,111,0,0,0
2019-05-16 13:30,254,117,137,0,0,0
2019-05-16 13:45,494,225,269,0,0,0
2019-05-16 14:00,354,181,173,0,0,0
2019-05-16 14:15,225,105,120,0,0,0
2019-05-16 14:30,200,98,102,0,0,0
2019-05-16 14:45,231,113,118,0,0,0
2019-05-16 15:00,225,107,118,0,0,0
2019-05-16 15:15,221,121,100,0,0,0
2019-05-16 15:30,317,156,161,0,0,0
2019-05-16 15:45,536,285,251,0,0,0
2019-05-16 16:00,442,261,181,0,0,0
2019-05-16 16:15,301,152,149,0,0,0
2019-05-16 16:30,283,131,152,0,0,0
2019-05-16 16:45,253,115,138,0,0,0
2019-05-16 17:00,302,150,152,0,0,0
2019-05-16 17:15,309,163,146,0,0,0
2019-05-16 17:30,425,218,207,0,0,0
2019-05-16 17:45,474,206,268,0,0,0
2019-05-16 18:00,359,199,160,0,0,0
2019-05-16 18:15,286,124,162,0,0,0
2019-05-16 18:30,286,106,180,0,0,0
2019-05-16 18:45,303,131,172,0,0,0
2019-05-16 19:00,227,99,128,0,0,0
2019-05-16 19:15,209,99,110,0,0,0
2019-05-16 19:30,234,82,152,0,0,0
2019-05-16 19:45,308,118,190,0,0,0
2019-05-16 20:00,247,94,153,0,0,0
2019-05-16 20:15,147,65,82,0,0,0
2019-05-16 20:30,120,49,71,0,0,0
2019-05-16 20:45,105,51,54,0,0,0
2019-05-16 21:00,102,40,62,0,0,0
2019-05-16 21:15,112,53,59,0,0,0
2019-05-16 21:30,116,49,67,0,0,0
2019-05-16 21:45,103,49,54,0,0,0
2019-05-16 22:00,109,54,55,0,0,0
2019-05-16 22:15,122,54,68,0,0,0
2019-05-16 22:30,113,50,63,0,0,0
2019-05-16 22:45,101,42,59,0,0,0
2019-05-16 23:00,99,43,56,0,0,0
2019-05-16 23:15,62,29,33,0,0,0
2019-05-16 23:30,71,31,40,0,0,0
2019-05-16 23:45,67,45,22,0,0,0
2019-05-17 00:00,57,16,41,0,0,0
2019-05-17 00:15,35,10,25,0,0,0
2019-05-17 00:30,21,10,11,0,0,0
2019-05-17 00:45,21,10,11,0,0,0
2019-05-17 01:00,27,11,16,0,0,0
2019-05-17 01:15,27,11,16,0,0,0
2019-05-17 01:30,19,2,17,0,0,0
2019-05-17 01:45,28,3,25,0,0,0
2019-05-17 02:00,16,2,14,0,0,0
2019-05-17 02:15,23,4,19,0,0,0
2019-05-17 02:30,20,3,17,0,0,0
2019-05-17 02:45,12,0,12,0,0,0
2019-05-17 03:00,15,1,14,0,0,0
2019-05-17 03:15,17,3,14,0,0,0
2019-05-17 03:30,11,5,6,0,0,0
2019-05-17 03:45,11,2,9,0,0,0
2019-05-17 04:00,11,5,6,0,0,0
2019-05-17 04:15,12,1,11,0,0,0
2019-05-17 04:30,7,1,6,0,0,0
2019-05-17 04:45,11,6,5,0,0,0
2019-05-17 05:00,15,10,5,0,0,0
2019-05-17 05:15,14,11,3,0,0,0
2019-05-17 05:30,20,9,11,0,0,0
2019-05-17 05:45,23,16,7,0,0,0
2019-05-17 06:00,35,23,12,0,0,0
2019-05-17 06:15,33,24,9,0,0,0
2019-05-17 06:30,62,39,23,0,0,0
2019-05-17 06:45,99,62,37,0,0,0
2019-05-17 07:00,110,76,34,0,0,0
2019-05-17 07:15,131,84,47,0,0,0
2019-05-17 07:30,292,203,89,0,0,0
2019-05-17 07:45,356,216,140,0,0,0
2019-05-17 08:00,334,171,163,0,0,0
2019-05-17 08:15,232,142,90,0,0,0
2019-05-17 08:30,227,149,78,0,0,0
2019-05-17 08:45,294,197,97,0,0,0
2019-05-17 09:00,234,153,81,0,0,0
2019-05-17 09:15,190,110,80,0,0,0
2019-05-17 09:30,251,168,83,0,0,0
2019-05-17 09:45,369,189,180,0,0,0
2019-05-17 10:00,302,161,141,0,0,0
2019-05-17 10:15,134,69,65,0,0,0
2019-05-17 10:30,164,100,64,0,0,0
2019-05-17 10:45,119,70,49,0,0,0
2019-05-17 11:00,126,75,51,0,0,0
2019-05-17 11:15,158,84,74,0,0,0
2019-05-17 11:30,174,91,83,0,0,0
2019-05-17 11:45,303,153,150,0,0,0
2019-05-17 12:00,255,137,118,0,0,0
2019-05-17 12:15,232,130,102,0,0,0
2019-05-17 12:30,185,88,97,0,0,0
2019-05-17 12:45,256,129,127,0,0,0
2019-05-17 13:00,255,126,129,0,0,0
2019-05-17 13:15,243,119,124,0,0,0
2019-05-17 13:30,259,123,136,0,0,0
2019-05-17 13:45,318,157,161,0,0,0
2019-05-17 14:00,252,137,115,0,0,0
2019-05-17 14:15,197,99,98,0,0,0
2019-05-17 14:30,197,97,100,0,0,0
2019-05-17 14:45,200,111,89,0,0,0
2019-05-17 15:00,218,104,114,0,0,0
2019-05-17 15:15,217,95,122,0,0,0
2019-05-17 15:30,232,112,120,0,0,0
2019-05-17 15:45,260,143,117,0,0,0
2019-05-17 16:00,229,121,108,0,0,0
2019-05-17 16:15,196,91,105,0,0,0
2019-05-17 16:30,223,108,115,0,0,0
2019-05-17 16:45,232,109,123,0,0,0
2019-05-17 17:00,204,115,89,0,0,0
2019-05-17 17:15,218,114,104,0,0,0
2019-05-17 17:30,239,121,118,0,0,0
2019-05-17 17:45,272,122,150,0,0,0
2019-05-17 18:00,263,130,133,0,0,0
2019-05-17 18:15,213,105,108,0,0,0
2019-05-17 18:30,207,88,119,0,0,0
2019-05-17 18:45,219,126,93,0,0,0
2019-05-17 19:00,220,94,126,0,0,0
2019-05-17 19:15,187,97,90,0,0,0
2019-05-17 19:30,183,95,88,0,0,0
2019-05-17 19:45,186,90,96,0,0,0
2019-05-17 20:00,185,75,110,0,0,0
2019-05-17 20:15,155,72,83,0,0,0
2019-05-17 20:30,137,72,65,0,0,0
2019-05-17 20:45,126,80,46,0,0,0
2019-05-17 21:00,144,62,82,0,0,0
2019-05-17 21:15,97,49,48,0,0,0
2019-05-17 21:30,120,40,80,0,0,0
2019-05-17 21:45,73,28,45,0,0,0
2019-05-17 22:00,93,29,64,0,0,0
2019-05-17 22:15,137,53,84,0,0,0
2019-05-17 22:30,125,52,73,0,0,0
2019-05-17 22:45,98,41,57,0,0,0
2019-05-17 23:00,67,18,49,0,0,0
2019-05-17 23:15,86,32,54,0,0,0
2019-05-17 23:30,65,29,36,0,0,0
2019-05-17 23:45,58,16,42,0,0,0
2019-05-18 00:00,69,22,47,0,0,0
2019-05-18 00:15,59,22,37,0,0,0
2019-05-18 00:30,88,34,54,0,0,0
2019-05-18 00:45,67,22,45,0,0,0
2019-05-18 01:00,77,24,53,0,0,0
2019-05-18 01:15,64,30,34,0,0,0
2019-05-18 01:30,78,44,34,0,0,0
2019-05-18 01:45,67,31,36,0,0,0
2019-05-18 02:00,72,16,56,0,0,0
2019-05-18 02:15,28,7,21,0,0,0
2019-05-18 02:30,51,15,36,0,0,0
2019-05-18 02:45,63,17,46,0,0,0
2019-05-18 03:00,37,13,24,0,0,0
2019-05-18 03:15,44,14,30,0,0,0
2019-05-18 03:30,27,10,17,0,0,0
2019-05-18 03:45,29,13,16,0,0,0
2019-05-18 04:00,15,4,11,0,0,0
2019-05-18 04:15,14,4,10,0,0,0
2019-05-18 04:30,13,4,9,0,0,0
2019-05-18 04:45,24,11,13,0,0,0
2019-05-18 05:00,12,4,8,0,0,0
2019-05-18 05:15,21,13,8,0,0,0
2019-05-18 05:30,19,7,12,0,0,0
2019-05-18 05:45,36,23,13,0,0,0
2019-05-18 06:00,13,10,3,0,0,0
2019-05-18 06:15,8,7,1,0,0,0
2019-05-18 06:30,16,13,3,0,0,0
2019-05-18 06:45,23,16,7,0,0,0
2019-05-18 07:00,36,35,1,0,0,0
2019-05-18 07:15,37,32,5,0,0,0
2019-05-18 07:30,55,42,13,0,0,0
2019-05-18 07:45,67,52,15,0,0,0
2019-05-18 08:00,82,63,19,0,0,0
2019-05-18 08:15,75,58,17,0,0,0
2019-05-18 08:30,96,65,31,0,0,0
2019-05-18 08:45,130,89,41,0,0,0
2019-05-18 09:00,120,86,34,0,0,0
2019-05-18 09:15,125,97,28,0,0,0
2019-05-18 09:30,173,128,45,0,0,0
2019-05-18 09:45,247,189,58,0,0,0
2019-05-18 10:00,222,169,53,0,0,0
2019-05-18 10:15,216,179,37,0,0,0
2019-05-18 10:30,210,147,63,0,0,0
2019-05-18 10:45,238,160,78,0,0,0
2019-05-18 11:00,230,144,86,0,0,0
2019-05-18 11:15,196,123,73,0,0,0
2019-05-18 11:30,186,131,55,0,0,0
2019-05-18 11:45,271,179,92,0,0,0
2019-05-18 12:00,213,140,73,0,0,0
2019-05-18 12:15,264,164,100,0,0,0
2019-05-18 12:30,232,134,98,0,0,0
2019-05-18 12:45,239,136,103,0,0,0
2019-05-18 13:00,239,141,98,0,0,0
2019-05-18 13:15,246,138,108,0,0,0
2019-05-18 13:30,234,108,126,0,0,0
2019-05-18 13:45,238,126,112,0,0,0
2019-05-18 14:00,271,127,144,0,0,0
2019-05-18 14:15,234,119,115,0,0,0
2019-05-18 14:30,275,150,125,0,0,0
2019-05-18 14:45,221,114,107,0,0,0
2019-05-18 15:00,266,122,144,0,0,0
2019-05-18 15:15,230,107,123,0,0,0
2019-05-18 15:30,216,107,109,0,0,0
2019-05-18 15:45,203,96,107,0,0,0
2019-05-18 16:00,185,85,100,0,0,0
2019-05-18 16:15,210,88,122,0,0,0
2019-05-18 16:30,162,72,90,0,0,0
2019-05-18 16:45,157,73,84,0,0,0
2019-05-18 17:00,138,59,79,0,0,0
2019-05-18 17:15,183,74,109,0,0,0
2019-05-18 17:30,243,116,127,0,0,0
2019-05-18 17:45,243,115,128,0,0,0
2019-05-18 18:00,219,103,116,0,0,0
2019-05-18 18:15,162,78,84,0,0,0
2019-05-18 18:30,178,86,92,0,0,0
2019-05-18 18:45,144,81,63,0,0,0
2019-05-18 19:00,182,80,102,0,0,0
2019-05-18 19:15,157,76,81,0,0,0
2019-05-18 19:30,167,60,107,0,0,0
2019-05-18 19:45,156,60,96,0,0,0
2019-05-18 20:00,174,86,88,0,0,0
2019-05-18 20:15,134,55,79,0,0,0
2019-05-18 20:30,114,58,56,0,0,0
2019-05-18 20:45,140,74,66,0,0,0
2019-05-18 21:00,113,59,54,0,0,0
2019-05-18 21:15,84,33,51,0,0,0
2019-05-18 21:30,82,24,58,0,0,0
2019-05-18 21:45,103,45,58,0,0,0
2019-05-18 22:00,87,37,50,0,0,0
2019-05-18 22:15,82,24,58,0,0,0
2019-05-18 22:30,92,37,55,0,0,0
2019-05-18 22:45,68,24,44,0,0,0
2019-05-18 23:00,84,28,56,0,0,0
2019-05-18 23:15,80,35,45,0,0,0
2019-05-18 23:30,72,29,43,0,0,0
2019-05-18 23:45,78,25,53,0,0,0
2019-05-19 00:00,73,26,47,0,0,0
2019-05-19 00:15,87,40,47,0,0,0
2019-05-19 00:30,77,33,44,0,0,0
2019-05-19 00:45,85,28,57,0,0,0
2019-05-19 01:00,82,27,55,0,0,0
2019-05-19 01:15,77,31,46,0,0,0
2019-05-19 01:30,77,30,47,0,0,0
2019-05-19 01:45,61,20,41,0,0,0
2019-05-19 02:00,86,17,69,0,0,0
2019-05-19 02:15,36,8,28,0,0,0
2019-05-19 02:30,64,21,43,0,0,0
2019-05-19 02:45,50,11,39,0,0,0
2019-05-19 03:00,35,13,22,0,0,0
2019-05-19 03:15,49,20,29,0,0,0
2019-05-19 03:30,29,4,25,0,0,0
2019-05-19 03:45,27,8,19,0,0,0
2019-05-19 04:00,21,4,17,0,0,0
2019-05-19 04:15,23,7,16,0,0,0
2019-05-19 04:30,27,8,19,0,0,0
2019-05-19 04:45,19,2,17,0,0,0
2019-05-19 05:00,17,2,15,0,0,0
2019-05-19 05:15,16,2,14,0,0,0
2019-05-19 05:30,21,6,15,0,0,0
2019-05-19 05:45,11,5,6,0,0,0
2019-05-19 06:00,15,9,6,0,0,0
2019-05-19 06:15,13,5,8,0,0,0
2019-05-19 06:30,10,1,9,0,0,0
2019-05-19 06:45,11,4,7,0,0,0
2019-05-19 07:00,10,4,6,0,0,0
2019-05-19 07:15,6,4,2,0,0,0
2019-05-19 07:30,13,10,3,0,0,0
2019-05-19 07:45,20,13,7,0,0,0
2019-05-19 08:00,20,7,13,0,0,0
2019-05-19 08:15,29,13,16,0,0,0
2019-05-19 08:30,29,10,19,0,0,0
2019-05-19 08:45,39,21,18,0,0,0
2019-05-19 09:00,38,24,14,0,0,0
2019-05-19 09:15,58,33,25,0,0,0
2019-05-19 09:30,64,38,26,0,0,0
2019-05-19 09:45,116,86,30,0,0,0
2019-05-19 10:00,85,54,31,0,0,0
2019-05-19 10:15,74,49,25,0,0,0
2019-05-19 10:30,72,49,23,0,0,0
2019-05-19 10:45,94,60,34,0,0,0
2019-05-19 11:00,71,47,24,0,0,0
2019-05-19 11:15,75,44,31,0,0,0
2019-05-19 11:30,114,52,62,0,0,0
2019-05-19 11:45,91,48,43,0,0,0
2019-05-19 12:00,138,72,66,0,0,0
2019-05-19 12:15,117,79,38,0,0,0
2019-05-19 12:30,128,72,56,0,0,0
2019-05-19 12:45,118,56,62,0,0,0
2019-05-19 13:00,100,46,54,0,0,0
2019-05-19 13:15,120,66,54,0,0,0
2019-05-19 13:30,91,53,38,0,0,0
2019-05-19 13:45,158,82,76,0,0,0
2019-05-19 14:00,147,78,69,0,0,0
2019-05-19 14:15,119,67,52,0,0,0
2019-05-19 14:30,140,76,64,0,0,0
2019-05-19 14:45,173,113,60,0,0,0
2019-05-19 15:00,151,68,83,0,0,0
2019-05-19 15:15,157,79,78,0,0,0
2019-05-19 15:30,139,54,85,0,0,0
2019-05-19 15:45,135,76,59,0,0,0
2019-05-19 16:00,141,78,63,0,0,0
2019-05-19 16:15,150,86,64,0,0,0
2019-05-19 16:30,121,55,66,0,0,0
2019-05-19 16:45,142,64,78,0,0,0
2019-05-19 17:00,108,40,68,0,0,0
2019-05-19 17:15,114,60,54,0,0,0
2019-05-19 17:30,147,73,74,0,0,0
2019-05-19 17:45,145,66,79,0,0,0
2019-05-19 18:00,131,46,85,0,0,0
2019-05-19 18:15,102,47,55,0,0,0
2019-05-19 18:30,95,37,58,0,0,0
2019-05-19 18:45,144,87,57,0,0,0
2019-05-19 19:00,96,47,49,0,0,0
2019-05-19 19:15,115,57,58,0,0,0
2019-05-19 19:30,96,41,55,0,0,0
2019-05-19 19:45,137,73,64,0,0,0
2019-05-19 20:00,101,37,64,0,0,0
2019-05-19 20:15,98,46,52,0,0,0
2019-05-19 20:30,67,23,44,0,0,0
2019-05-19 20:45,54,16,38,0,0,0
2019-05-19 21:00,70,13,57,0,0,0
2019-05-19 21:15,68,31,37,0,0,0
2019-05-19 21:30,61,16,45,0,0,0
2019-05-19 21:45,49,20,29,0,0,0
2019-05-19 22:00,68,25,43,0,0,0
2019-05-19 22:15,55,17,38,0,0,0
2019-05-19 22:30,74,15,59,0,0,0
2019-05-19 22:45,51,9,42,0,0,0
2019-05-19 23:00,48,11,37,0,0,0
2019-05-19 23:15,32,11,21,0,0,0
2019-05-19 23:30,19,6,13,0,0,0
2019-05-19 23:45,18,6,12,0,0,0
2019-05-20 00:00,21,5,16,0,0,0
2019-05-20 00:15,5,1,4,0,0,0
2019-05-20 00:30,11,5,6,0,0,0
2019-05-20 00:45,8,1,7,0,0,0
2019-05-20 01:00,14,3,11,0,0,0
2019-05-20 01:15,10,2,8,0,0,0
2019-05-20 01:30,1,1,0,0,0,0
2019-05-20 01:45,7,2,5,0,0,0
2019-05-20 02:00,1,0,1,0,0,0
2019-05-20 02:15,5,4,1,0,0,0
2019-05-20 02:30,5,2,3,0,0,0
2019-05-20 02:45,1,1,0,0,0,0
2019-05-20 03:00,0,0,0,0,0,0
2019-05-20 03:15,1,0,1,0,0,0
2019-05-20 03:30,2,2,0,0,0,0
2019-05-20 03:45,3,2,1,0,0,0
2019-05-20 04:00,0,0,0,0,0,0
2019-05-20 04:15,2,2,0,0,0,0
2019-05-20 04:30,6,3,3,0,0,0
2019-05-20 04:45,6,4,2,0,0,0
2019-05-20 05:00,10,8,2,0,0,0
2019-05-20 05:15,8,4,4,0,0,0
2019-05-20 05:30,18,9,9,0,0,0
2019-05-20 05:45,27,19,8,0,0,0
2019-05-20 06:00,26,22,4,0,0,0
2019-05-20 06:15,37,25,12,0,0,0
2019-05-20 06:30,64,44,20,0,0,0
2019-05-20 06:45,82,53,29,0,0,0
2019-05-20 07:00,111,69,42,0,0,0
2019-05-20 07:15,145,94,51,0,0,0
2019-05-20 07:30,258,170,88,0,0,0
2019-05-20 07:45,357,184,173,0,0,0
2019-05-20 08:00,399,187,212,0,0,0
2019-05-20 08:15,258,174,84,0,0,0
2019-05-20 08:30,192,107,85,0,0,0
2019-05-20 08:45,260,166,94,0,0,0
2019-05-20 09:00,227,152,75,0,0,0
2019-05-20 09:15,164,89,75,0,0,0
2019-05-20 09:30,228,122,106,0,0,0
2019-05-20 09:45,421,207,214,0,0,0
2019-05-20 10:00,476,252,224,0,0,0
2019-05-20 10:15,135,82,53,0,0,0
2019-05-20 10:30,146,63,83,0,0,0
2019-05-20 10:45,128,72,56,0,0,0
2019-05-20 11:00,122,78,44,0,0,0
2019-05-20 11:15,120,60,60,0,0,0
2019-05-20 11:30,180,84,96,0,0,0
2019-05-20 11:45,403,197,206,0,0,0
2019-05-20 12:00,332,214,118,0,0,0
2019-05-20 12:15,197,102,95,0,0,0
2019-05-20 12:30,174,81,93,0,0,0
2019-05-20 12:45,183,87,96,0,0,0
2019-05-20 13:00,290,128,162,0,0,0
2019-05-20 13:15,209,108,101,0,0,0
2019-05-20 13:30,238,111,127,0,0,0
2019-05-20 13:45,450,232,218,0,0,0
2019-05-20 14:00,363,226,137,0,0,0
2019-05-20 14:15,192,112,80,0,0,0
2019-05-20 14:30,194,82,112,0,0,0
2019-05-20 14:45,210,107,103,0,0,0
2019-05-20 15:00,196,88,108,0,0,0
2019-05-20 15:15,221,106,115,0,0,0
2019-05-20 15:30,295,133,162,0,0,0
2019-05-20 15:45,548,299,249,0,0,0
2019-05-20 16:00,423,235,188,0,0,0
2019-05-20 16:15,267,145,122,0,0,0
2019-05-20 16:30,256,125,131,0,0,0
2019-05-20 16:45,283,147,136,0,0,0
2019-05-20 17:00,320,154,166,0,0,0
2019-05-20 17:15,294,124,170,0,0,0
2019-05-20 17:30,407,179,228,0,0,0
2019-05-20 17:45,568,240,328,0,0,0
2019-05-20 18:00,457,221,236,0,0,0
2019-05-20 18:15,335,162,173,0,0,0
2019-05-20 18:30,319,146,173,0,0,0
2019-05-20 18:45,289,137,152,0,0,0
2019-05-20 19:00,319,168,151,0,0,0
2019-05-20 19:15,234,137,97,0,0,0
2019-05-20 19:30,221,90,131,0,0,0
2019-05-20 19:45,345,151,194,0,0,0
2019-05-20 20:00,209,96,113,0,0,0
2019-05-20 20:15,196,97,99,0,0,0
2019-05-20 20:30,156,83,73,0,0,0
2019-05-20 20:45,128,61,67,0,0,0
2019-05-20 21:00,122,48,74,0,0,0
2019-05-20 21:15,128,55,73,0,0,0
2019-05-20 21:30,129,35,94,0,0,0
2019-05-20 21:45,163,67,96,0,0,0
2019-05-20 22:00,118,51,67,0,0,0
2019-05-20 22:15,140,61,79,0,0,0
2019-05-20 22:30,104,28,76,0,0,0
2019-05-20 22:45,68,17,51,0,0,0
2019-05-20 23:00,84,34,50,0,0,0
2019-05-20 23:15,50,18,32,0,0,0
2019-05-20 23:30,62,20,42,0,0,0
2019-05-20 23:45,46,8,38,0,0,0
2019-05-21 00:00,36,22,14,0,0,0
2019-05-21 00:15,35,11,24,0,0,0
2019-05-21 00:30,21,3,18,0,0,0
2019-05-21 00:45,16,2,14,0,0,0
2019-05-21 01:00,21,3,18,0,0,0
2019-05-21 01:15,9,1,8,0,0,0
2019-05-21 01:30,12,5,7,0,0,0
2019-05-21 01:45,11,2,9,0,0,0
2019-05-21 02:00,8,1,7,0,0,0
2019-05-21 02:15,3,2,1,0,0,0
2019-05-21 02:30,6,3,3,0,0,0
2019-05-21 02:45,1,1,0,0,0,0
2019-05-21 03:00,6,2,4,0,0,0
2019-05-21 03:15,1,0,1,0,0,0
2019-05-21 03:30,2,1,1,0,0,0
2019-05-21 03:45,2,1,1,0,0,0
2019-05-21 04:00,0,0,0,0,0,0
2019-05-21 04:15,5,0,5,0,0,0
2019-05-21 04:30,5,4,1,0,0,0
2019-05-21 04:45,7,4,3,0,0,0
2019-05-21 05:00,13,9,4,0,0,0
2019-05-21 05:15,8,3,5,0,0,0
2019-05-21 05:30,16,9,7,0,0,0
2019-05-21 05:45,21,14,7,0,0,0
2019-05-21 06:00,20,14,6,0,0,0
2019-05-21 06:15,32,23,9,0,0,0
2019-05-21 06:30,50,29,21,0,0,0
2019-05-21 06:45,103,74,29,0,0,0
2019-05-21 07:00,94,58,36,0,0,0
2019-05-21 07:15,157,109,48,0,0,0
2019-05-21 07:30,252,142,110,0,0,0
2019-05-21 07:45,362,206,156,0,0,0
2019-05-21 08:00,511,280,231,0,0,0
2019-05-21 08:15,282,163,119,0,0,0
2019-05-21 08:30,212,118,94,0,0,0
2019-05-21 08:45,276,177,99,0,0,0
2019-05-21 09:00,262,196,66,0,0,0
2019-05-21 09:15,181,105,76,0,0,0
2019-05-21 09:30,228,100,128,0,0,0
2019-05-21 09:45,466,192,274,0,0,0
2019-05-21 10:00,450,257,193,0,0,0
2019-05-21 10:15,154,86,68,0,0,0
2019-05-21 10:30,137,61,76,0,0,0
2019-05-21 10:45,131,74,57,0,0,0
2019-05-21 11:00,95,45,50,0,0,0
2019-05-21 11:15,155,73,82,0,0,0
2019-05-21 11:30,217,106,111,0,0,0
2019-05-21 11:45,465,245,220,0,0,0
2019-05-21 12:00,393,249,144,0,0,0
2019-05-21 12:15,191,99,92,0,0,0
2019-05-21 12:30,173,72,101,0,0,0
2019-05-21 12:45,158,86,72,0,0,0
2019-05-21 13:00,205,89,116,0,0,0
2019-05-21 13:15,192,90,102,0,0,0
2019-05-21 13:30,259,110,149,0,0,0
2019-05-21 13:45,487,195,292,0,0,0
2019-05-21 14:00,356,193,163,0,0,0
2019-05-21 14:15,191,98,93,0,0,0
2019-05-21 14:30,167,86,81,0,0,0
2019-05-21 14:45,174,94,80,0,0,0
2019-05-21 15:00,143,39,104,0,0,0
2019-05-21 15:15,225,108,117,0,0,0
2019-05-21 15:30,254,121,133,0,0,0
2019-05-21 15:45,470,256,214,0,0,0
2019-05-21 16:00,382,212,170,0,0,0
2019-05-21 16:15,271,136,135,0,0,0
2019-05-21 16:30,284,149,135,0,0,0
2019-05-21 16:45,279,134,145,0,0,0
2019-05-21 17:00,285,133,152,0,0,0
2019-05-21 17:15,271,144,127,0,0,0
2019-05-21 17:30,407,171,236,0,0,0
2019-05-21 17:45,546,248,298,0,0,0
2019-05-21 18:00,402,189,213,0,0,0
2019-05-21 18:15,309,170,139,0,0,0
2019-05-21 18:30,231,99,132,0,0,0
2019-05-21 18:45,281,143,138,0,0,0
2019-05-21 19:00,264,114,150,0,0,0
2019-05-21 19:15,223,121,102,0,0,0
2019-05-21 19:30,237,104,133,0,0,0
2019-05-21 19:45,359,170,189,0,0,0
2019-05-21 20:00,252,110,142,0,0,0
2019-05-21 20:15,170,82,88,0,0,0
2019-05-21 20:30,159,72,87,0,0,0
2019-05-21 20:45,170,63,107,0,0,0
2019-05-21 21:00,136,64,72,0,0,0
2019-05-21 21:15,123,47,76,0,0,0
2019-05-21 21:30,127,52,75,0,0,0
2019-05-21 21:45,106,38,68,0,0,0
2019-05-21 22:00,144,45,99,0,0,0
2019-05-21 22:15,147,66,81,0,0,0
2019-05-21 22:30,105,46,59,0,0,0
2019-05-21 22:45,79,34,45,0,0,0
2019-05-21 23:00,80,21,59,0,0,0
2019-05-21 23:15,54,15,39,0,0,0
2019-05-21 23:30,71,25,46,0,0,0
2019-05-21 23:45,39,10,29,0,0,0
2019-05-22 00:00,40,13,27,0,0,0
2019-05-22 00:15,31,6,25,0,0,0
2019-05-22 00:30,32,7,25,0,0,0
2019-05-22 00:45,21,5,16,0,0,0
2019-05-22 01:00,24,8,16,0,0,0
2019-05-22 01:15,20,5,15,0,0,0
2019-05-22 01:30,17,4,13,0,0,0
2019-05-22 01:45,9,0,9,0,0,0
2019-05-22 02:00,9,3,6,0,0,0
2019-05-22 02:15,4,2,2,0,0,0
2019-05-22 02:30,6,3,3,0,0,0
2019-05-22 02:45,2,1,1,0,0,0
2019-05-22 03:00,8,1,7,0,0,0
2019-05-22 03:15,1,1,0,0,0,0
2019-05-22 03:30,5,3,2,0,0,0
2019-05-22 03:45,7,7,0,0,0,0
2019-05-22 04:00,2,0,2,0,0,0
2019-05-22 04:15,1,0,1,0,0,0
2019-05-22 04:30,5,3,2,0,0,0
2019-05-22 04:45,9,5,4,0,0,0
2019-05-22 05:00,10,8,2,0,0,0
2019-05-22 05:15,10,7,3,0,0,0
2019-05-22 05:30,15,10,5,0,0,0
2019-05-22 05:45,29,21,8,0,0,0
2019-05-22 06:00,32,24,8,0,0,0
2019-05-22 06:15,49,39,10,0,0,0
2019-05-22 06:30,70,49,21,0,0,0
2019-05-22 06:45,95,65,30,0,0,0
2019-05-22 07:00,114,71,43,0,0,0
2019-05-22 07:15,154,96,58,0,0,0
2019-05-22 07:30,283,176,107,0,0,0
2019-05-22 07:45,503,286,217,0,0,0
2019-05-22 08:00,595,288,307,0,0,0
2019-05-22 08:15,295,151,144,0,0,0
2019-05-22 08:30,242,151,91,0,0,0
2019-05-22 08:45,292,180,112,0,0,0
2019-05-22 09:00,224,136,88,0,0,0
2019-05-22 09:15,170,85,85,0,0,0
2019-05-22 09:30,201,108,93,0,0,0
2019-05-22 09:45,457,221,236,0,0,0
2019-05-22 10:00,422,262,160,0,0,0
2019-05-22 10:15,178,93,85,0,0,0
2019-05-22 10:30,158,89,69,0,0,0
2019-05-22 10:45,185,99,86,0,0,0
2019-05-22 11:00,161,96,65,0,0,0
2019-05-22 11:15,191,103,88,0,0,0
2019-05-22 11:30,227,121,106,0,0,0
2019-05-22 11:45,486,239,247,0,0,0
2019-05-22 12:00,403,245,158,0,0,0
2019-05-22 12:15,246,128,118,0,0,0
2019-05-22 12:30,227,111,116,0,0,0
2019-05-22 12:45,223,107,116,0,0,0
2019-05-22 13:00,267,147,120,0,0,0
2019-05-22 13:15,220,120,100,0,0,0
2019-05-22 13:30,242,125,117,0,0,0
2019-05-22 13:45,450,211,239,0,0,0
2019-05-22 14:00,389,244,145,0,0,0
2019-05-22 14:15,237,138,99,0,0,0
2019-05-22 14:30,240,113,127,0,0,0
2019-05-22 14:45,237,127,110,0,0,0
2019-05-22 15:00,226,126,100,0,0,0
2019-05-22 15:15,253,148,105,0,0,0
2019-05-22 15:30,346,145,201,0,0,0
2019-05-22 15:45,572,237,335,0,0,0
2019-05-22 16:00,474,255,219,0,0,0
2019-05-22 16:15,312,153,159,0,0,0
2019-05-22 16:30,293,128,165,0,0,0
2019-05-22 16:45,310,133,177,0,0,0
2019-05-22 17:00,322,169,153,0,0,0
2019-05-22 17:15,342,171,171,0,0,0
2019-05-22 17:30,409,203,206,0,0,0
2019-05-22 17:45,558,278,280,0,0,0
2019-05-22 18:00,488,262,226,0,0,0
2019-05-22 18:15,372,192,180,0,0,0
2019-05-22 18:30,337,187,150,0,0,0
2019-05-22 18:45,350,181,169,0,0,0
2019-05-22 19:00,318,181,137,0,0,0
2019-05-22 19:15,282,162,120,0,0,0
2019-05-22 19:30,286,135,151,0,0,0
2019-05-22 19:45,347,152,195,0,0,0
2019-05-22 20:00,281,135,146,0,0,0
2019-05-22 20:15,206,100,106,0,0,0
2019-05-22 20:30,188,84,104,0,0,0
2019-05-22 20:45,146,65,81,0,0,0
2019-05-22 21:00,170,75,95,0,0,0
2019-05-22 21:15,166,66,100,0,0,0
2019-05-22 21:30,146,67,79,0,0,0
2019-05-22 21:45,165,72,93,0,0,0
2019-05-22 22:00,269,53,216,0,0,0
2019-05-22 22:15,195,80,115,0,0,0
2019-05-22 22:30,120,50,70,0,0,0
2019-05-22 22:45,109,39,70,0,0,0
2019-05-22 23:00,55,14,41,0,0,0
2019-05-22 23:15,106,49,57,0,0,0
2019-05-22 23:30,70,35,35,0,0,0
2019-05-22 23:45,81,31,50,0,0,0
2019-05-23 00:00,76,31,45,0,0,0
2019-05-23 00:15,58,25,33,0,0,0
2019-05-23 00:30,49,14,35,0,0,0
2019-05-23 00:45,68,33,35,0,0,0
2019-05-23 01:00,53,27,26,0,0,0
2019-05-23 01:15,63,17,46,0,0,0
2019-05-23 01:30,39,10,29,0,0,0
2019-05-23 01:45,22,3,19,0,0,0
2019-05-23 02:00,47,6,41,0,0,0
2019-05-23 02:15,37,4,33,0,0,0
2019-05-23 02:30,38,5,33,0,0,0
2019-05-23 02:45,25,2,23,0,0,0
2019-05-23 03:00,21,5,16,0,0,0
2019-05-23 03:15,19,6,13,0,0,0
2019-05-23 03:30,22,4,18,0,0,0
2019-05-23 03:45,18,4,14,0,0,0
2019-05-23 04:00,10,5,5,0,0,0
2019-05-23 04:15,11,2,9,0,0,0
2019-05-23 04:30,11,7,4,0,0,0
2019-05-23 04:45,13,6,7,0,0,0
2019-05-23 05:00,15,9,6,0,0,0
2019-05-23 05:15,18,7,11,0,0,0
2019-05-23 05:30,23,13,10,0,0,0
2019-05-23 05:45,33,21,12,0,0,0
2019-05-23 06:00,30,18,12,0,0,0
2019-05-23 06:15,46,29,17,0,0,0
2019-05-23 06:30,77,54,23,0,0,0
2019-05-23 06:45,117,84,33,0,0,0
2019-05-23 07:00,116,74,42,0,0,0
2019-05-23 07:15,204,136,68,0,0,0
2019-05-23 07:30,295,194,101,0,0,0
2019-05-23 07:45,461,241,220,0,0,0
2019-05-23 08:00,526,287,239,0,0,0
2019-05-23 08:15,328,192,136,0,0,0
2019-05-23 08:30,247,148,99,0,0,0
2019-05-23 08:45,289,166,123,0,0,0
2019-05-23 09:00,224,144,80,0,0,0
2019-05-23 09:15,220,125,95,0,0,0
2019-05-23 09:30,248,139,109,0,0,0
2019-05-23 09:45,490,250,240,0,0,0
2019-05-23 10:00,499,304,195,0,0,0
2019-05-23 10:15,194,117,77,0,0,0
2019-05-23 10:30,154,83,71,0,0,0
2019-05-23 10:45,153,76,77,0,0,0
2019-05-23 11:00,158,99,59,0,0,0
2019-05-23 11:15,160,84,76,0,0,0
2019-05-23 11:30,303,143,160,0,0,0
2019-05-23 11:45,497,257,240,0,0,0
2019-05-23 12:00,428,256,172,0,0,0
2019-05-23 12:15,233,128,105,0,0,0
2019-05-23 12:30,228,110,118,0,0,0
2019-05-23 12:45,238,132,106,0,0,0
2019-05-23 13:00,237,102,135,0,0,0
2019-05-23 13:15,266,137,129,0,0,0
2019-05-23 13:30,255,121,134,0,0,0
2019-05-23 13:45,509,222,287,0,0,0
2019-05-23 14:00,424,232,192,0,0,0
2019-05-23 14:15,316,150,166,0,0,0
2019-05-23 14:30,230,120,110,0,0,0
2019-05-23 14:45,267,134,133,0,0,0
2019-05-23 15:00,242,133,109,0,0,0
2019-05-23 15:15,276,158,118,0,0,0
2019-05-23 15:30,336,158,178,0,0,0
2019-05-23 15:45,613,329,284,0,0,0
2019-05-23 16:00,451,268,183,0,0,0
2019-05-23 16:15,322,172,150,0,0,0
2019-05-23 16:30,353,198,155,0,0,0
2019-05-23 16:45,368,202,166,0,0,0
2019-05-23 17:00,362,192,170,0,0,0
2019-05-23 17:15,357,180,177,0,0,0
2019-05-23 17:30,390,214,176,0,0,0
2019-05-23 17:45,519,259,260,0,0,0
2019-05-23 18:00,394,214,180,0,0,0
2019-05-23 18:15,384,210,174,0,0,0
2019-05-23 18:30,294,141,153,0,0,0
2019-05-23 18:45,372,197,175,0,0,0
2019-05-23 19:00,317,161,156,0,0,0
2019-05-23 19:15,287,148,139,0,0,0
2019-05-23 19:30,292,147,145,0,0,0
2019-05-23 19:45,348,172,176,0,0,0
2019-05-23 20:00,323,163,160,0,0,0
2019-05-23 20:15,253,117,136,0,0,0
2019-05-23 20:30,194,99,95,0,0,0
2019-05-23 20:45,160,84,76,0,0,0
2019-05-23 21:00,180,66,114,0,0,0
2019-05-23 21:15,166,66,100,0,0,0
2019-05-23 21:30,153,60,93,0,0,0
2019-05-23 21:45,108,54,54,0,0,0
2019-05-23 22:00,142,62,80,0,0,0
2019-05-23 22:15,156,68,88,0,0,0
2019-05-23 22:30,160,53,107,0,0,0
2019-05-23 22:45,129,27,102,0,0,0
2019-05-23 23:00,130,42,88,0,0,0
2019-05-23 23:15,138,40,98,0,0,0
2019-05-23 23:30,122,41,81,0,0,0
2019-05-23 23:45,86,31,55,0,0,0
2019-05-24 00:00,49,16,33,0,0,0
2019-05-24 00:15,59,23,36,0,0,0
2019-05-24 00:30,50,23,27,0,0,0
2019-05-24 00:45,35,10,25,0,0,0
2019-05-24 01:00,31,11,20,0,0,0
2019-05-24 01:15,18,1,17,0,0,0
2019-05-24 01:30,20,4,16,0,0,0
2019-05-24 01:45,18,6,12,0,0,0
2019-05-24 02:00,19,4,15,0,0,0
2019-05-24 02:15,8,1,7,0,0,0
2019-05-24 02:30,13,3,10,0,0,0
2019-05-24 02:45,14,5,9,0,0,0
2019-05-24 03:00,10,3,7,0,0,0
2019-05-24 03:15,9,2,7,0,0,0
2019-05-24 03:30,10,3,7,0,0,0
2019-05-24 03:45,6,0,6,0,0,0
2019-05-24 04:00,15,1,14,0,0,0
2019-05-24 04:15,12,4,8,0,0,0
2019-05-24 04:30,11,3,8,0,0,0
2019-05-24 04:45,12,6,6,0,0,0
2019-05-24 05:00,15,10,5,0,0,0
2019-05-24 05:15,16,9,7,0,0,0
2019-05-24 05:30,24,13,11,0,0,0
2019-05-24 05:45,21,13,8,0,0,0
2019-05-24 06:00,33,22,11,0,0,0
2019-05-24 06:15,46,31,15,0,0,0
2019-05-24 06:30,56,38,18,0,0,0
2019-05-24 06:45,107,72,35,0,0,0
2019-05-24 07:00,102,64,38,0,0,0
2019-05-24 07:15,151,104,47,0,0,0
2019-05-24 07:30,276,177,99,0,0,0
2019-05-24 07:45,281,158,123,0,0,0
2019-05-24 08:00,312,152,160,0,0,0
2019-05-24 08:15,254,146,108,0,0,0
2019-05-24 08:30,253,148,105,0,0,0
2019-05-24 08:45,307,191,116,0,0,0
2019-05-24 09:00,208,132,76,0,0,0
2019-05-24 09:15,153,97,56,0,0,0
2019-05-24 09:30,249,123,126,0,0,0
2019-05-24 09:45,406,259,147,0,0,0
2019-05-24 10:00,383,248,135,0,0,0
2019-05-24 10:15,186,99,87,0,0,0
2019-05-24 10:30,177,115,62,0,0,0
2019-05-24 10:45,186,111,75,0,0,0
2019-05-24 11:00,161,94,67,0,0,0
2019-05-24 11:15,184,112,72,0,0,0
2019-05-24 11:30,223,122,101,0,0,0
2019-05-24 11:45,427,159,268,0,0,0
2019-05-24 12:00,320,168,152,0,0,0
2019-05-24 12:15,259,117,142,0,0,0
2019-05-24 12:30,265,133,132,0,0,0
2019-05-24 12:45,265,157,108,0,0,0
2019-05-24 13:00,301,132,169,0,0,0
2019-05-24 13:15,290,154,136,0,0,0
2019-05-24 13:30,301,126,175,0,0,0
2019-05-24 13:45,382,191,191,0,0,0
2019-05-24 14:00,334,167,167,0,0,0
2019-05-24 14:15,229,115,114,0,0,0
2019-05-24 14:30,225,116,109,0,0,0
2019-05-24 14:45,254,125,129,0,0,0
2019-05-24 15:00,236,118,118,0,0,0
2019-05-24 15:15,252,142,110,0,0,0
2019-05-24 15:30,284,146,138,0,0,0
2019-05-24 15:45,279,140,139,0,0,0
2019-05-24 16:00,260,146,114,0,0,0
2019-05-24 16:15,250,141,109,0,0,0
2019-05-24 16:30,252,134,118,0,0,0
2019-05-24 16:45,246,130,116,0,0,0
2019-05-24 17:00,242,129,113,0,0,0
2019-05-24 17:15,266,138,128,0,0,0
2019-05-24 17:30,295,146,149,0,0,0
2019-05-24 17:45,305,126,179,0,0,0
2019-05-24 18:00,282,159,123,0,0,0
2019-05-24 18:15,283,134,149,0,0,0
2019-05-24 18:30,253,150,103,0,0,0
2019-05-24 18:45,261,150,111,0,0,0
2019-05-24 19:00,267,144,123,0,0,0
2019-05-24 19:15,235,155,80,0,0,0
2019-05-24 19:30,262,156,106,0,0,0
2019-05-24 19:45,249,152,97,0,0,0
2019-05-24 20:00,226,121,105,0,0,0
2019-05-24 20:15,189,120,69,0,0,0
2019-05-24 20:30,179,95,84,0,0,0
2019-05-24 20:45,171,102,69,0,0,0
2019-05-24 21:00,152,80,72,0,0,0
2019-05-24 21:15,153,77,76,0,0,0
2019-05-24 21:30,147,74,73,0,0,0
2019-05-24 21:45,156,51,105,0,0,0
2019-05-24 22:00,144,53,91,0,0,0
2019-05-24 22:15,147,48,99,0,0,0
2019-05-24 22:30,124,43,81,0,0,0
2019-05-24 22:45,133,44,89,0,0,0
2019-05-24 23:00,115,33,82,0,0,0
2019-05-24 23:15,116,28,88,0,0,0
2019-05-24 23:30,109,30,79,0,0,0
2019-05-24 23:45,126,38,88,0,0,0
2019-05-25 00:00,89,28,61,0,0,0
2019-05-25 00:15,94,23,71,0,0,0
2019-05-25 00:30,106,43,63,0,0,0
2019-05-25 00:45,73,24,49,0,0,0
2019-05-25 01:00,89,25,64,0,0,0
2019-05-25 01:15,56,14,42,0,0,0
2019-05-25 01:30,54,11,43,0,0,0
2019-05-25 01:45,49,8,41,0,0,0
2019-05-25 02:00,61,14,47,0,0,0
2019-05-25 02:15,52,17,35,0,0,0
2019-05-25 02:30,40,11,29,0,0,0
2019-05-25 02:45,53,10,43,0,0,0
2019-05-25 03:00,30,11,19,0,0,0
2019-05-25 03:15,36,7,29,0,0,0
2019-05-25 03:30,31,0,31,0,0,0
2019-05-25 03:45,18,6,12,0,0,0
2019-05-25 04:00,23,6,17,0,0,0
2019-05-25 04:15,16,2,14,0,0,0
2019-05-25 04:30,11,4,7,0,0,0
2019-05-25 04:45,13,2,11,0,0,0
2019-05-25 05:00,8,6,2,0,0,0
2019-05-25 05:15,13,2,11,0,0,0
2019-05-25 05:30,21,10,11,0,0,0
2019-05-25 05:45,21,11,10,0,0,0
2019-05-25 06:00,13,10,3,0,0,0
2019-05-25 06:15,11,8,3,0,0,0
2019-05-25 06:30,9,7,2,0,0,0
2019-05-25 06:45,24,14,10,0,0,0
2019-05-25 07:00,18,13,5,0,0,0
2019-05-25 07:15,12,8,4,0,0,0
2019-05-25 07:30,23,17,6,0,0,0
2019-05-25 07:45,60,47,13,0,0,0
2019-05-25 08:00,38,24,14,0,0,0
2019-05-25 08:15,49,29,20,0,0,0
2019-05-25 08:30,87,44,43,0,0,0
2019-05-25 08:45,135,65,70,0,0,0
2019-05-25 09:00,74,46,28,0,0,0
2019-05-25 09:15,99,66,33,0,0,0
2019-05-25 09:30,108,67,41,0,0,0
2019-05-25 09:45,155,123,32,0,0,0
2019-05-25 10:00,151,113,38,0,0,0
2019-05-25 10:15,121,81,40,0,0,0
2019-05-25 10:30,137,81,56,0,0,0
2019-05-25 10:45,185,118,67,0,0,0
2019-05-25 11:00,116,78,38,0,0,0
2019-05-25 11:15,145,100,45,0,0,0
2019-05-25 11:30,154,92,62,0,0,0
2019-05-25 11:45,183,110,73,0,0,0
2019-05-25 12:00,166,89,77,0,0,0
2019-05-25 12:15,156,84,72,0,0,0
2019-05-25 12:30,184,98,86,0,0,0
2019-05-25 12:45,211,114,97,0,0,0
2019-05-25 13:00,180,99,81,0,0,0
2019-05-25 13:15,198,100,98,0,0,0
2019-05-25 13:30,216,108,108,0,0,0
2019-05-25 13:45,198,106,92,0,0,0
2019-05-25 14:00,179,102,77,0,0,0
2019-05-25 14:15,200,108,92,0,0,0
2019-05-25 14:30,194,93,101,0,0,0
2019-05-25 14:45,223,108,115,0,0,0
2019-05-25 15:00,202,102,100,0,0,0
2019-05-25 15:15,205,97,108,0,0,0
2019-05-25 15:30,214,106,108,0,0,0
2019-05-25 15:45,189,104,85,0,0,0
2019-05-25 16:00,188,107,81,0,0,0
2019-05-25 16:15,215,129,86,0,0,0
2019-05-25 16:30,228,117,111,0,0,0
2019-05-25 16:45,228,129,99,0,0,0
2019-05-25 17:00,248,145,103,0,0,0
2019-05-25 17:15,220,127,93,0,0,0
2019-05-25 17:30,210,122,88,0,0,0
2019-05-25 17:45,233,139,94,0,0,0
2019-05-25 18:00,243,140,103,0,0,0
2019-05-25 18:15,232,132,100,0,0,0
2019-05-25 18:30,226,120,106,0,0,0
2019-05-25 18:45,296,152,144,0,0,0
2019-05-25 19:00,277,173,104,0,0,0
2019-05-25 19:15,241,156,85,0,0,0
2019-05-25 19:30,194,119,75,0,0,0
2019-05-25 19:45,209,122,87,0,0,0
2019-05-25 20:00,186,98,88,0,0,0
2019-05-25 20:15,206,113,93,0,0,0
2019-05-25 20:30,161,107,54,0,0,0
2019-05-25 20:45,181,92,89,0,0,0
2019-05-25 21:00,184,120,64,0,0,0
2019-05-25 21:15,180,107,73,0,0,0
2019-05-25 21:30,173,85,88,0,0,0
2019-05-25 21:45,139,68,71,0,0,0
2019-05-25 22:00,169,83,86,0,0,0
2019-05-25 22:15,140,70,70,0,0,0
2019-05-25 22:30,159,72,87,0,0,0
2019-05-25 22:45,148,60,88,0,0,0
2019-05-25 23:00,167,72,95,0,0,0
2019-05-25 23:15,162,57,105,0,0,0
2019-05-25 23:30,134,49,85,0,0,0
2019-05-25 23:45,123,44,79,0,0,0
2019-05-26 00:00,122,48,74,0,0,0
2019-05-26 00:15,107,33,74,0,0,0
2019-05-26 00:30,124,45,79,0,0,0
2019-05-26 00:45,129,46,83,0,0,0
2019-05-26 01:00,112,18,94,0,0,0
2019-05-26 01:15,89,25,64,0,0,0
2019-05-26 01:30,100,11,89,0,0,0
2019-05-26 01:45,76,12,64,0,0,0
2019-05-26 02:00,75,14,61,0,0,0
2019-05-26 02:15,69,17,52,0,0,0
2019-05-26 02:30,87,15,72,0,0,0
2019-05-26 02:45,48,13,35,0,0,0
2019-05-26 03:00,67,7,60,0,0,0
2019-05-26 03:15,53,6,47,0,0,0
2019-05-26 03:30,50,5,45,0,0,0
2019-05-26 03:45,30,4,26,0,0,0
2019-05-26 04:00,34,1,33,0,0,0
2019-05-26 04:15,19,1,18,0,0,0
2019-05-26 04:30,28,9,19,0,0,0
2019-05-26 04:45,23,3,20,0,0,0
2019-05-26 05:00,19,2,17,0,0,0
2019-05-26 05:15,10,2,8,0,0,0
2019-05-26 05:30,7,1,6,0,0,0
2019-05-26 05:45,14,3,11,0,0,0
2019-05-26 06:00,15,3,12,0,0,0
2019-05-26 06:15,10,3,7,0,0,0
2019-05-26 06:30,6,3,3,0,0,0
2019-05-26 06:45,8,6,2,0,0,0
2019-05-26 07:00,9,6,3,0,0,0
2019-05-26 07:15,16,11,5,0,0,0
2019-05-26 07:30,17,11,6,0,0,0
2019-05-26 07:45,18,11,7,0,0,0
2019-05-26 08:00,23,13,10,0,0,0
2019-05-26 08:15,33,17,16,0,0,0
2019-05-26 08:30,20,12,8,0,0,0
2019-05-26 08:45,48,24,24,0,0,0
2019-05-26 09:00,41,21,20,0,0,0
2019-05-26 09:15,67,51,16,0,0,0
2019-05-26 09:30,66,35,31,0,0,0
2019-05-26 09:45,119,75,44,0,0,0
2019-05-26 10:00,97,78,19,0,0,0
2019-05-26 10:15,64,37,27,0,0,0
2019-05-26 10:30,98,61,37,0,0,0
2019-05-26 10:45,110,77,33,0,0,0
2019-05-26 11:00,83,56,27,0,0,0
2019-05-26 11:15,105,58,47,0,0,0
2019-05-26 11:30,99,52,47,0,0,0
2019-05-26 11:45,102,65,37,0,0,0
2019-05-26 12:00,113,54,59,0,0,0
2019-05-26 12:15,94,49,45,0,0,0
2019-05-26 12:30,131,60,71,0,0,0
2019-05-26 12:45,119,67,52,0,0,0
2019-05-26 13:00,164,84,80,0,0,0
2019-05-26 13:15,155,91,64,0,0,0
2019-05-26 13:30,122,56,66,0,0,0
2019-05-26 13:45,129,68,61,0,0,0
2019-05-26 14:00,150,71,79,0,0,0
2019-05-26 14:15,99,64,35,0,0,0
2019-05-26 14:30,134,77,57,0,0,0
2019-05-26 14:45,168,101,67,0,0,0
2019-05-26 15:00,146,69,77,0,0,0
2019-05-26 15:15,185,95,90,0,0,0
2019-05-26 15:30,161,94,67,0,0,0
2019-05-26 15:45,135,80,55,0,0,0
2019-05-26 16:00,133,71,62,0,0,0
2019-05-26 16:15,140,68,72,0,0,0
2019-05-26 16:30,145,74,71,0,0,0
2019-05-26 16:45,156,71,85,0,0,0
2019-05-26 17:00,163,83,80,0,0,0
2019-05-26 17:15,119,58,61,0,0,0
2019-05-26 17:30,131,71,60,0,0,0
2019-05-26 17:45,184,92,92,0,0,0
2019-05-26 18:00,137,64,73,0,0,0
2019-05-26 18:15,139,59,80,0,0,0
2019-05-26 18:30,117,58,59,0,0,0
2019-05-26 18:45,125,77,48,0,0,0
2019-05-26 19:00,102,43,59,0,0,0
2019-05-26 19:15,112,52,60,0,0,0
2019-05-26 19:30,123,62,61,0,0,0
2019-05-26 19:45,129,61,68,0,0,0
2019-05-26 20:00,105,45,60,0,0,0
2019-05-26 20:15,103,34,69,0,0,0
2019-05-26 20:30,93,46,47,0,0,0
2019-05-26 20:45,92,38,54,0,0,0
2019-05-26 21:00,85,25,60,0,0,0
2019-05-26 21:15,60,22,38,0,0,0
2019-05-26 21:30,74,27,47,0,0,0
2019-05-26 21:45,60,15,45,0,0,0
2019-05-26 22:00,60,21,39,0,0,0
2019-05-26 22:15,61,15,46,0,0,0
2019-05-26 22:30,66,26,40,0,0,0
2019-05-26 22:45,63,22,41,0,0,0
2019-05-26 23:00,42,8,34,0,0,0
2019-05-26 23:15,36,8,28,0,0,0
2019-05-26 23:30,29,10,19,0,0,0
2019-05-26 23:45,26,6,20,0,0,0
2019-05-27 00:00,16,1,15,0,0,0
2019-05-27 00:15,27,9,18,0,0,0
2019-05-27 00:30,13,7,6,0,0,0
2019-05-27 00:45,11,5,6,0,0,0
2019-05-27 01:00,14,9,5,0,0,0
2019-05-27 01:15,18,4,14,0,0,0
2019-05-27 01:30,9,3,6,0,0,0
2019-05-27 01:45,8,1,7,0,0,0
2019-05-27 02:00,4,3,1,0,0,0
2019-05-27 02:15,4,1,3,0,0,0
2019-05-27 02:30,6,3,3,0,0,0
2019-05-27 02:45,5,4,1,0,0,0
2019-05-27 03:00,0,0,0,0,0,0
2019-05-27 03:15,0,0,0,0,0,0
2019-05-27 03:30,2,2,0,0,0,0
2019-05-27 03:45,3,2,1,0,0,0
2019-05-27 04:00,0,0,0,0,0,0
2019-05-27 04:15,0,0,0,0,0,0
2019-05-27 04:30,5,2,3,0,0,0
2019-05-27 04:45,12,10,2,0,0,0
2019-05-27 05:00,10,9,1,0,0,0
2019-05-27 05:15,12,5,7,0,0,0
2019-05-27 05:30,24,10,14,0,0,0
2019-05-27 05:45,20,12,8,0,0,0
2019-05-27 06:00,28,21,7,0,0,0
2019-05-27 06:15,46,29,17,0,0,0
2019-05-27 06:30,66,39,27,0,0,0
2019-05-27 06:45,102,66,36,0,0,0
2019-05-27 07:00,100,65,35,0,0,0
2019-05-27 07:15,123,75,48,0,0,0
2019-05-27 07:30,291,192,99,0,0,0
2019-05-27 07:45,376,212,164,0,0,0
2019-05-27 08:00,393,185,208,0,0,0
2019-05-27 08:15,264,155,109,0,0,0
2019-05-27 08:30,230,143,87,0,0,0
2019-05-27 08:45,320,213,107,0,0,0
2019-05-27 09:00,239,170,69,0,0,0
2019-05-27 09:15,194,119,75,0,0,0
2019-05-27 09:30,252,131,121,0,0,0
2019-05-27 09:45,413,219,194,0,0,0
2019-05-27 10:00,443,235,208,0,0,0
2019-05-27 10:15,158,87,71,0,0,0
2019-05-27 10:30,154,81,73,0,0,0
2019-05-27 10:45,148,89,59,0,0,0
2019-05-27 11:00,144,78,66,0,0,0
2019-05-27 11:15,164,86,78,0,0,0
2019-05-27 11:30,257,121,136,0,0,0
2019-05-27 11:45,413,195,218,0,0,0
2019-05-27 12:00,381,228,153,0,0,0
2019-05-27 12:15,225,115,110,0,0,0
2019-05-27 12:30,234,110,124,0,0,0
2019-05-27 12:45,242,126,116,0,0,0
2019-05-27 13:00,306,134,172,0,0,0
2019-05-27 13:15,187,85,102,0,0,0
2019-05-27 13:30,262,132,130,0,0,0
2019-05-27 13:45,430,222,208,0,0,0
2019-05-27 14:00,379,212,167,0,0,0
2019-05-27 14:15,247,126,121,0,0,0
2019-05-27 14:30,253,121,132,0,0,0
2019-05-27 14:45,207,110,97,0,0,0
2019-05-27 15:00,250,135,115,0,0,0
2019-05-27 15:15,274,132,142,0,0,0
2019-05-27 15:30,361,167,194,0,0,0
2019-05-27 15:45,478,231,247,0,0,0
2019-05-27 16:00,427,241,186,0,0,0
2019-05-27 16:15,289,163,126,0,0,0
2019-05-27 16:30,256,134,122,0,0,0
2019-05-27 16:45,303,145,158,0,0,0
2019-05-27 17:00,334,148,186,0,0,0
2019-05-27 17:15,303,141,162,0,0,0
2019-05-27 17:30,423,216,207,0,0,0
2019-05-27 17:45,648,297,351,0,0,0
2019-05-27 18:00,449,203,246,0,0,0
2019-05-27 18:15,324,151,173,0,0,0
2019-05-27 18:30,304,149,155,0,0,0
2019-05-27 18:45,311,136,175,0,0,0
2019-05-27 19:00,297,157,140,0,0,0
2019-05-27 19:15,284,145,139,0,0,0
2019-05-27 19:30,292,129,163,0,0,0
2019-05-27 19:45,333,156,177,0,0,0
2019-05-27 20:00,236,99,137,0,0,0
2019-05-27 20:15,214,111,103,0,0,0
2019-05-27 20:30,180,101,79,0,0,0
2019-05-27 20:45,165,96,69,0,0,0
2019-05-27 21:00,152,74,78,0,0,0
2019-05-27 21:15,113,52,61,0,0,0
2019-05-27 21:30,145,71,74,0,0,0
2019-05-27 21:45,155,46,109,0,0,0
2019-05-27 22:00,151,54,97,0,0,0
2019-05-27 22:15,92,45,47,0,0,0
2019-05-27 22:30,83,35,48,0,0,0
2019-05-27 22:45,89,30,59,0,0,0
2019-05-27 23:00,94,26,68,0,0,0
2019-05-27 23:15,89,27,62,0,0,0
2019-05-27 23:30,49,22,27,0,0,0
2019-05-27 23:45,31,12,19,0,0,0
2019-05-28 00:00,30,6,24,0,0,0
2019-05-28 00:15,40,22,18,0,0,0
2019-05-28 00:30,28,10,18,0,0,0
2019-05-28 00:45,31,7,24,0,0,0
2019-05-28 01:00,32,4,28,0,0,0
2019-05-28 01:15,24,8,16,0,0,0
2019-05-28 01:30,17,6,11,0,0,0
2019-05-28 01:45,24,0,24,0,0,0
2019-05-28 02:00,9,3,6,0,0,0
2019-05-28 02:15,3,2,1,0,0,0
2019-05-28 02:30,5,3,2,0,0,0
2019-05-28 02:45,6,3,3,0,0,0
2019-05-28 03:00,5,2,3,0,0,0
2019-05-28 03:15,5,1,4,0,0,0
2019-05-28 03:30,3,1,2,0,0,0
2019-05-28 03:45,1,0,1,0,0,0
2019-05-28 04:00,0,0,0,0,0,0
2019-05-28 04:15,3,3,0,0,0,0
2019-05-28 04:30,7,6,1,0,0,0
2019-05-28 04:45,5,3,2,0,0,0
2019-05-28 05:00,12,12,0,0,0,0
2019-05-28 05:15,7,5,2,0,0,0
2019-05-28 05:30,15,7,8,0,0,0
2019-05-28 05:45,19,12,7,0,0,0
2019-05-28 06:00,30,18,12,0,0,0
2019-05-28 06:15,36,28,8,0,0,0
2019-05-28 06:30,49,33,16,0,0,0
2019-05-28 06:45,98,64,34,0,0,0
2019-05-28 07:00,81,44,37,0,0,0
2019-05-28 07:15,115,73,42,0,0,0
2019-05-28 07:30,178,111,67,0,0,0
2019-05-28 07:45,250,176,74,0,0,0
2019-05-28 08:00,418,247,171,0,0,0
2019-05-28 08:15,261,165,96,0,0,0
2019-05-28 08:30,210,135,75,0,0,0
2019-05-28 08:45,263,165,98,0,0,0
2019-05-28 09:00,230,178,52,0,0,0
2019-05-28 09:15,170,115,55,0,0,0
2019-05-28 09:30,209,101,108,0,0,0
2019-05-28 09:45,397,157,240,0,0,0
2019-05-28 10:00,430,255,175,0,0,0
2019-05-28 10:15,178,90,88,0,0,0
2019-05-28 10:30,110,59,51,0,0,0
2019-05-28 10:45,106,57,49,0,0,0
2019-05-28 11:00,77,44,33,0,0,0
2019-05-28 11:15,96,46,50,0,0,0
2019-05-28 11:30,152,75,77,0,0,0
2019-05-28 11:45,380,161,219,0,0,0
2019-05-28 12:00,304,179,125,0,0,0
2019-05-28 12:15,138,67,71,0,0,0
2019-05-28 12:30,174,86,88,0,0,0
2019-05-28 12:45,194,89,105,0,0,0
2019-05-28 13:00,209,88,121,0,0,0
2019-05-28 13:15,159,65,94,0,0,0
2019-05-28 13:30,226,104,122,0,0,0
2019-05-28 13:45,398,178,220,0,0,0
2019-05-28 14:00,283,162,121,0,0,0
2019-05-28 14:15,156,81,75,0,0,0
2019-05-28 14:30,179,94,85,0,0,0
2019-05-28 14:45,186,73,113,0,0,0
2019-05-28 15:00,162,76,86,0,0,0
2019-05-28 15:15,190,91,99,0,0,0
2019-05-28 15:30,216,103,113,0,0,0
2019-05-28 15:45,454,236,218,0,0,0
2019-05-28 16:00,331,198,133,0,0,0
2019-05-28 16:15,237,119,118,0,0,0
2019-05-28 16:30,216,105,111,0,0,0
2019-05-28 16:45,268,122,146,0,0,0
2019-05-28 17:00,242,131,111,0,0,0
2019-05-28 17:15,263,141,122,0,0,0
2019-05-28 17:30,356,145,211,0,0,0
2019-05-28 17:45,526,222,304,0,0,0
2019-05-28 18:00,380,181,199,0,0,0
2019-05-28 18:15,267,135,132,0,0,0
2019-05-28 18:30,241,133,108,0,0,0
2019-05-28 18:45,262,133,129,0,0,0
2019-05-28 19:00,213,113,100,0,0,0
2019-05-28 19:15,221,112,109,0,0,0
2019-05-28 19:30,222,95,127,0,0,0
2019-05-28 19:45,349,165,184,0,0,0
2019-05-28 20:00,240,127,113,0,0,0
2019-05-28 20:15,164,80,84,0,0,0
2019-05-28 20:30,129,68,61,0,0,0
2019-05-28 20:45,119,67,52,0,0,0
2019-05-28 21:00,136,80,56,0,0,0
2019-05-28 21:15,133,54,79,0,0,0
2019-05-28 21:30,128,45,83,0,0,0
2019-05-28 21:45,104,48,56,0,0,0
2019-05-28 22:00,140,45,95,0,0,0
2019-05-28 22:15,128,61,67,0,0,0
2019-05-28 22:30,97,28,69,0,0,0
2019-05-28 22:45,106,26,80,0,0,0
2019-05-28 23:00,68,24,44,0,0,0
2019-05-28 23:15,63,20,43,0,0,0
2019-05-28 23:30,47,8,39,0,0,0
2019-05-28 23:45,63,14,49,0,0,0
2019-05-29 00:00,41,6,35,0,0,0
2019-05-29 00:15,26,4,22,0,0,0
2019-05-29 00:30,22,4,18,0,0,0
2019-05-29 00:45,30,9,21,0,0,0
2019-05-29 01:00,18,8,10,0,0,0
2019-05-29 01:15,18,3,15,0,0,0
2019-05-29 01:30,13,4,9,0,0,0
2019-05-29 01:45,13,4,9,0,0,0
2019-05-29 02:00,12,2,10,0,0,0
2019-05-29 02:15,6,1,5,0,0,0
2019-05-29 02:30,4,1,3,0,0,0
2019-05-29 02:45,7,2,5,0,0,0
2019-05-29 03:00,6,1,5,0,0,0
2019-05-29 03:15,5,5,0,0,0,0
2019-05-29 03:30,6,3,3,0,0,0
2019-05-29 03:45,2,2,0,0,0,0
2019-05-29 04:00,1,1,0,0,0,0
2019-05-29 04:15,5,2,3,0,0,0
2019-05-29 04:30,7,6,1,0,0,0
2019-05-29 04:45,9,5,4,0,0,0
2019-05-29 05:00,8,8,0,0,0,0
2019-05-29 05:15,11,8,3,0,0,0
2019-05-29 05:30,23,15,8,0,0,0
2019-05-29 05:45,27,14,13,0,0,0
2019-05-29 06:00,25,16,9,0,0,0
2019-05-29 06:15,57,41,16,0,0,0
2019-05-29 06:30,74,60,14,0,0,0
2019-05-29 06:45,116,92,24,0,0,0
2019-05-29 07:00,118,85,33,0,0,0
2019-05-29 07:15,243,197,46,0,0,0
2019-05-29 07:30,304,200,104,0,0,0
2019-05-29 07:45,387,225,162,0,0,0
2019-05-29 08:00,528,283,245,0,0,0
2019-05-29 08:15,306,184,122,0,0,0
2019-05-29 08:30,273,166,107,0,0,0
2019-05-29 08:45,284,155,129,0,0,0
2019-05-29 09:00,227,139,88,0,0,0
2019-05-29 09:15,187,108,79,0,0,0
2019-05-29 09:30,237,130,107,0,0,0
2019-05-29 09:45,434,216,218,0,0,0
2019-05-29 10:00,519,262,257,0,0,0
2019-05-29 10:15,225,127,98,0,0,0
2019-05-29 10:30,166,92,74,0,0,0
2019-05-29 10:45,169,107,62,0,0,0
2019-05-29 11:00,186,113,73,0,0,0
2019-05-29 11:15,170,97,73,0,0,0
2019-05-29 11:30,239,139,100,0,0,0
2019-05-29 11:45,509,281,228,0,0,0
2019-05-29 12:00,319,165,154,0,0,0
2019-05-29 12:15,221,105,116,0,0,0
2019-05-29 12:30,212,98,114,0,0,0
2019-05-29 12:45,289,155,134,0,0,0
2019-05-29 13:00,232,128,104,0,0,0
2019-05-29 13:15,270,129,141,0,0,0
2019-05-29 13:30,295,155,140,0,0,0
2019-05-29 13:45,473,211,262,0,0,0
2019-05-29 14:00,415,211,204,0,0,0
2019-05-29 14:15,262,134,128,0,0,0
2019-05-29 14:30,244,108,136,0,0,0
2019-05-29 14:45,241,117,124,0,0,0
2019-05-29 15:00,217,95,122,0,0,0
2019-05-29 15:15,259,123,136,0,0,0
2019-05-29 15:30,318,137,181,0,0,0
2019-05-29 15:45,515,254,261,0,0,0
2019-05-29 16:00,478,242,236,0,0,0
2019-05-29 16:15,326,158,168,0,0,0
2019-05-29 16:30,288,132,156,0,0,0
2019-05-29 16:45,305,157,148,0,0,0
2019-05-29 17:00,337,173,164,0,0,0
2019-05-29 17:15,330,179,151,0,0,0
2019-05-29 17:30,382,185,197,0,0,0
2019-05-29 17:45,563,250,313,0,0,0
2019-05-29 18:00,429,234,195,0,0,0
2019-05-29 18:15,302,151,151,0,0,0
2019-05-29 18:30,250,145,105,0,0,0
2019-05-29 18:45,303,165,138,0,0,0
2019-05-29 19:00,294,163,131,0,0,0
2019-05-29 19:15,285,144,141,0,0,0
2019-05-29 19:30,257,135,122,0,0,0
2019-05-29 19:45,333,190,143,0,0,0
2019-05-29 20:00,274,138,136,0,0,0
2019-05-29 20:15,237,133,104,0,0,0
2019-05-29 20:30,208,114,94,0,0,0
2019-05-29 20:45,208,99,109,0,0,0
2019-05-29 21:00,200,96,104,0,0,0
2019-05-29 21:15,166,84,82,0,0,0
2019-05-29 21:30,175,78,97,0,0,0
2019-05-29 21:45,154,70,84,0,0,0
2019-05-29 22:00,133,54,79,0,0,0
2019-05-29 22:15,127,71,56,0,0,0
2019-05-29 22:30,164,80,84,0,0,0
2019-05-29 22:45,94,37,57,0,0,0
2019-05-29 23:00,121,55,66,0,0,0
2019-05-29 23:15,125,54,71,0,0,0
2019-05-29 23:30,116,48,68,0,0,0
2019-05-29 23:45,113,37,76,0,0,0
2019-05-30 00:00,111,35,76,0,0,0
2019-05-30 00:15,106,35,71,0,0,0
2019-05-30 00:30,122,30,92,0,0,0
2019-05-30 00:45,90,48,42,0,0,0
2019-05-30 01:00,104,33,71,0,0,0
2019-05-30 01:15,75,34,41,0,0,0
2019-05-30 01:30,73,29,44,0,0,0
2019-05-30 01:45,88,31,57,0,0,0
2019-05-30 02:00,92,21,71,0,0,0
2019-05-30 02:15,54,13,41,0,0,0
2019-05-30 02:30,50,12,38,0,0,0
2019-05-30 02:45,50,19,31,0,0,0
2019-05-30 03:00,63,18,45,0,0,0
2019-05-30 03:15,58,12,46,0,0,0
2019-05-30 03:30,45,21,24,0,0,0
2019-05-30 03:45,49,12,37,0,0,0
2019-05-30 04:00,40,12,28,0,0,0
2019-05-30 04:15,11,4,7,0,0,0
2019-05-30 04:30,18,8,10,0,0,0
2019-05-30 04:45,17,11,6,0,0,0
2019-05-30 05:00,24,14,10,0,0,0
2019-05-30 05:15,18,10,8,0,0,0
2019-05-30 05:30,11,4,7,0,0,0
2019-05-30 05:45,20,3,17,0,0,0
2019-05-30 06:00,16,8,8,0,0,0
2019-05-30 06:15,11,6,5,0,0,0
2019-05-30 06:30,14,9,5,0,0,0
2019-05-30 06:45,13,6,7,0,0,0
2019-05-30 07:00,5,4,1,0,0,0
2019-05-30 07:15,13,6,7,0,0,0
2019-05-30 07:30,25,14,11,0,0,0
2019-05-30 07:45,33,22,11,0,0,0
2019-05-30 08:00,18,11,7,0,0,0
2019-05-30 08:15,29,14,15,0,0,0
2019-05-30 08:30,40,25,15,0,0,0
2019-05-30 08:45,40,22,18,0,0,0
2019-05-30 09:00,35,23,12,0,0,0
2019-05-30 09:15,53,28,25,0,0,0
2019-05-30 09:30,74,55,19,0,0,0
2019-05-30 09:45,110,81,29,0,0,0
2019-05-30 10:00,73,36,37,0,0,0
2019-05-30 10:15,71,42,29,0,0,0
2019-05-30 10:30,71,40,31,0,0,0
2019-05-30 10:45,93,58,35,0,0,0
2019-05-30 11:00,71,30,41,0,0,0
2019-05-30 11:15,89,42,47,0,0,0
2019-05-30 11:30,94,56,38,0,0,0
2019-05-30 11:45,74,39,35,0,0,0
2019-05-30 12:00,89,49,40,0,0,0
2019-05-30 12:15,102,56,46,0,0,0
2019-05-30 12:30,79,45,34,0,0,0
2019-05-30 12:45,87,50,37,0,0,0
2019-05-30 13:00,74,34,40,0,0,0
2019-05-30 13:15,103,65,38,0,0,0
2019-05-30 13:30,112,57,55,0,0,0
2019-05-30 13:45,128,86,42,0,0,0
2019-05-30 14:00,137,89,48,0,0,0
2019-05-30 14:15,91,52,39,0,0,0
2019-05-30 14:30,120,55,65,0,0,0
2019-05-30 14:45,105,62,43,0,0,0
2019-05-30 15:00,119,45,74,0,0,0
2019-05-30 15:15,106,64,42,0,0,0
2019-05-30 15:30,99,61,38,0,0,0
2019-05-30 15:45,142,86,56,0,0,0
2019-05-30 16:00,114,46,68,0,0,0
2019-05-30 16:15,124,57,67,0,0,0
2019-05-30 16:30,115,58,57,0,0,0
2019-05-30 16:45,123,52,71,0,0,0
2019-05-30 17:00,104,51,53,0,0,0
2019-05-30 17:15,129,53,76,0,0,0
2019-05-30 17:30,135,72,63,0,0,0
2019-05-30 17:45,162,68,94,0,0,0
2019-05-30 18:00,134,68,66,0,0,0
2019-05-30 18:15,133,70,63,0,0,0
2019-05-30 18:30,134,71,63,0,0,0
2019-05-30 18:45,140,60,80,0,0,0
2019-05-30 19:00,101,57,44,0,0,0
2019-05-30 19:15,110,46,64,0,0,0
2019-05-30 19:30,131,61,70,0,0,0
2019-05-30 19:45,120,61,59,0,0,0
2019-05-30 20:00,122,59,63,0,0,0
2019-05-30 20:15,113,51,62,0,0,0
2019-05-30 20:30,92,34,58,0,0,0
2019-05-30 20:45,92,42,50,0,0,0
2019-05-30 21:00,85,34,51,0,0,0
2019-05-30 21:15,83,44,39,0,0,0
2019-05-30 21:30,90,55,35,0,0,0
2019-05-30 21:45,75,26,49,0,0,0
2019-05-30 22:00,72,31,41,0,0,0
2019-05-30 22:15,74,28,46,0,0,0
2019-05-30 22:30,74,29,45,0,0,0
2019-05-30 22:45,71,22,49,0,0,0
2019-05-30 23:00,70,33,37,0,0,0
2019-05-30 23:15,39,20,19,0,0,0
2019-05-30 23:30,46,9,37,0,0,0
2019-05-30 23:45,27,9,18,0,0,0
2019-05-31 00:00,52,12,40,0,0,0
2019-05-31 00:15,40,10,30,0,0,0
2019-05-31 00:30,17,3,14,0,0,0
2019-05-31 00:45,32,13,19,0,0,0
2019-05-31 01:00,26,12,14,0,0,0
2019-05-31 01:15,22,6,16,0,0,0
2019-05-31 01:30,21,4,17,0,0,0
2019-05-31 01:45,19,4,15,0,0,0
2019-05-31 02:00,15,3,12,0,0,0
2019-05-31 02:15,7,2,5,0,0,0
2019-05-31 02:30,18,9,9,0,0,0
2019-05-31 02:45,10,1,9,0,0,0
2019-05-31 03:00,2,1,1,0,0,0
2019-05-31 03:15,7,2,5,0,0,0
2019-05-31 03:30,7,4,3,0,0,0
2019-05-31 03:45,8,6,2,0,0,0
2019-05-31 04:00,1,1,0,0,0,0
2019-05-31 04:15,5,3,2,0,0,0
2019-05-31 04:30,7,6,1,0,0,0
2019-05-31 04:45,8,5,3,0,0,0
2019-05-31 05:00,12,12,0,0,0,0
2019-05-31 05:15,11,8,3,0,0,0
2019-05-31 05:30,15,8,7,0,0,0
2019-05-31 05:45,16,10,6,0,0,0
2019-05-31 06:00,21,10,11,0,0,0
2019-05-31 06:15,27,14,13,0,0,0
2019-05-31 06:30,43,30,13,0,0,0
2019-05-31 06:45,41,25,16,0,0,0
2019-05-31 07:00,62,45,17,0,0,0
2019-05-31 07:15,53,31,22,0,0,0
2019-05-31 07:30,91,47,44,0,0,0
2019-05-31 07:45,172,117,55,0,0,0
2019-05-31 08:00,183,100,83,0,0,0
2019-05-31 08:15,157,107,50,0,0,0
2019-05-31 08:30,131,72,59,0,0,0
2019-05-31 08:45,194,113,81,0,0,0
2019-05-31 09:00,172,117,55,0,0,0
2019-05-31 09:15,144,96,48,0,0,0
2019-05-31 09:30,153,79,74,0,0,0
2019-05-31 09:45,267,136,131,0,0,0
2019-05-31 10:00,308,190,118,0,0,0
2019-05-31 10:15,173,127,46,0,0,0
2019-05-31 10:30,190,105,85,0,0,0
2019-05-31 10:45,226,139,87,0,0,0
2019-05-31 11:00,149,89,60,0,0,0
2019-05-31 11:15,176,101,75,0,0,0
2019-05-31 11:30,225,134,91,0,0,0
2019-05-31 11:45,284,145,139,0,0,0
2019-05-31 12:00,258,153,105,0,0,0
2019-05-31 12:15,199,130,69,0,0,0
2019-05-31 12:30,187,105,82,0,0,0
2019-05-31 12:45,213,126,87,0,0,0
2019-05-31 13:00,232,124,108,0,0,0
2019-05-31 13:15,244,135,109,0,0,0
2019-05-31 13:30,264,135,129,0,0,0
2019-05-31 13:45,270,152,118,0,0,0
2019-05-31 14:00,228,124,104,0,0,0
2019-05-31 14:15,218,125,93,0,0,0
2019-05-31 14:30,197,102,95,0,0,0
2019-05-31 14:45,230,138,92,0,0,0
2019-05-31 15:00,203,85,118,0,0,0
2019-05-31 15:15,184,86,98,0,0,0
2019-05-31 15:30,217,95,122,0,0,0
2019-05-31 15:45,268,134,134,0,0,0
2019-05-31 16:00,228,124,104,0,0,0
2019-05-31 16:15,204,106,98,0,0,0
2019-05-31 16:30,226,122,104,0,0,0
2019-05-31 16:45,258,122,136,0,0,0
2019-05-31 17:00,245,115,130,0,0,0
2019-05-31 17:15,259,141,118,0,0,0
2019-05-31 17:30,261,114,147,0,0,0
2019-05-31 17:45,270,136,134,0,0,0
2019-05-31 18:00,266,144,122,0,0,0
2019-05-31 18:15,223,115,108,0,0,0
2019-05-31 18:30,223,129,94,0,0,0
2019-05-31 18:45,259,135,124,0,0,0
2019-05-31 19:00,208,105,103,0,0,0
2019-05-31 19:15,205,116,89,0,0,0
2019-05-31 19:30,188,113,75,0,0,0
2019-05-31 19:45,205,94,111,0,0,0
2019-05-31 20:00,170,93,77,0,0,0
2019-05-31 20:15,154,84,70,0,0,0
2019-05-31 20:30,150,82,68,0,0,0
2019-05-31 20:45,126,68,58,0,0,0
2019-05-31 21:00,165,75,90,0,0,0
2019-05-31 21:15,129,60,69,0,0,0
2019-05-31 21:30,102,43,59,0,0,0
2019-05-31 21:45,146,56,90,0,0,0
2019-05-31 22:00,108,41,67,0,0,0
2019-05-31 22:15,108,40,68,0,0,0
2019-05-31 22:30,108,44,64,0,0,0
2019-05-31 22:45,107,29,78,0,0,0
2019-05-31 23:00,94,27,67,0,0,0
2019-05-31 23:15,108,29,79,0,0,0
2019-05-31 23:30,108,25,83,0,0,0
2019-05-31 23:45,75,21,54,0,0,0
