Datetime,100035541 (Neutor),101035541 (Neutor stadteinwÃ¤rts),102035541 (Neutor stadtauswÃ¤rts),100035541-status,101035541-status,102035541-status
2019-03-01 00:00,22,2,20,0,0,0
2019-03-01 00:15,31,6,25,0,0,0
2019-03-01 00:30,27,3,24,0,0,0
2019-03-01 00:45,38,9,29,0,0,0
2019-03-01 01:00,29,15,14,0,0,0
2019-03-01 01:15,19,3,16,0,0,0
2019-03-01 01:30,18,2,16,0,0,0
2019-03-01 01:45,11,2,9,0,0,0
2019-03-01 02:00,22,1,21,0,0,0
2019-03-01 02:15,8,2,6,0,0,0
2019-03-01 02:30,6,1,5,0,0,0
2019-03-01 02:45,9,1,8,0,0,0
2019-03-01 03:00,13,2,11,0,0,0
2019-03-01 03:15,6,2,4,0,0,0
2019-03-01 03:30,9,1,8,0,0,0
2019-03-01 03:45,3,1,2,0,0,0
2019-03-01 04:00,3,2,1,0,0,0
2019-03-01 04:15,4,0,4,0,0,0
2019-03-01 04:30,7,3,4,0,0,0
2019-03-01 04:45,6,3,3,0,0,0
2019-03-01 05:00,11,5,6,0,0,0
2019-03-01 05:15,12,6,6,0,0,0
2019-03-01 05:30,13,8,5,0,0,0
2019-03-01 05:45,18,12,6,0,0,0
2019-03-01 06:00,22,14,8,0,0,0
2019-03-01 06:15,39,30,9,0,0,0
2019-03-01 06:30,37,24,13,0,0,0
2019-03-01 06:45,77,49,28,0,0,0
2019-03-01 07:00,76,50,26,0,0,0
2019-03-01 07:15,117,79,38,0,0,0
2019-03-01 07:30,184,133,51,0,0,0
2019-03-01 07:45,203,143,60,0,0,0
2019-03-01 08:00,143,82,61,0,0,0
2019-03-01 08:15,159,92,67,0,0,0
2019-03-01 08:30,168,98,70,0,0,0
2019-03-01 08:45,202,132,70,0,0,0
2019-03-01 09:00,120,88,32,0,0,0
2019-03-01 09:15,122,79,43,0,0,0
2019-03-01 09:30,106,58,48,0,0,0
2019-03-01 09:45,119,74,45,0,0,0
2019-03-01 10:00,95,59,36,0,0,0
2019-03-01 10:15,85,56,29,0,0,0
2019-03-01 10:30,102,66,36,0,0,0
2019-03-01 10:45,89,48,41,0,0,0
2019-03-01 11:00,90,50,40,0,0,0
2019-03-01 11:15,95,55,40,0,0,0
2019-03-01 11:30,99,50,49,0,0,0
2019-03-01 11:45,128,76,52,0,0,0
2019-03-01 12:00,106,46,60,0,0,0
2019-03-01 12:15,116,59,57,0,0,0
2019-03-01 12:30,124,66,58,0,0,0
2019-03-01 12:45,161,95,66,0,0,0
2019-03-01 13:00,187,86,101,0,0,0
2019-03-01 13:15,132,63,69,0,0,0
2019-03-01 13:30,136,75,61,0,0,0
2019-03-01 13:45,141,72,69,0,0,0
2019-03-01 14:00,123,61,62,0,0,0
2019-03-01 14:15,117,64,53,0,0,0
2019-03-01 14:30,114,45,69,0,0,0
2019-03-01 14:45,144,60,84,0,0,0
2019-03-01 15:00,130,69,61,0,0,0
2019-03-01 15:15,139,64,75,0,0,0
2019-03-01 15:30,174,97,77,0,0,0
2019-03-01 15:45,165,92,73,0,0,0
2019-03-01 16:00,141,71,70,0,0,0
2019-03-01 16:15,149,68,81,0,0,0
2019-03-01 16:30,152,67,85,0,0,0
2019-03-01 16:45,151,78,73,0,0,0
2019-03-01 17:00,157,74,83,0,0,0
2019-03-01 17:15,126,65,61,0,0,0
2019-03-01 17:30,159,72,87,0,0,0
2019-03-01 17:45,145,69,76,0,0,0
2019-03-01 18:00,166,68,98,0,0,0
2019-03-01 18:15,125,74,51,0,0,0
2019-03-01 18:30,117,51,66,0,0,0
2019-03-01 18:45,158,69,89,0,0,0
2019-03-01 19:00,130,67,63,0,0,0
2019-03-01 19:15,135,73,62,0,0,0
2019-03-01 19:30,119,63,56,0,0,0
2019-03-01 19:45,108,62,46,0,0,0
2019-03-01 20:00,86,35,51,0,0,0
2019-03-01 20:15,85,28,57,0,0,0
2019-03-01 20:30,64,31,33,0,0,0
2019-03-01 20:45,66,24,42,0,0,0
2019-03-01 21:00,77,38,39,0,0,0
2019-03-01 21:15,38,17,21,0,0,0
2019-03-01 21:30,56,14,42,0,0,0
2019-03-01 21:45,64,18,46,0,0,0
2019-03-01 22:00,68,38,30,0,0,0
2019-03-01 22:15,54,21,33,0,0,0
2019-03-01 22:30,40,19,21,0,0,0
2019-03-01 22:45,42,15,27,0,0,0
2019-03-01 23:00,39,18,21,0,0,0
2019-03-01 23:15,35,12,23,0,0,0
2019-03-01 23:30,26,10,16,0,0,0
2019-03-01 23:45,53,14,39,0,0,0
2019-03-02 00:00,45,10,35,0,0,0
2019-03-02 00:15,43,9,34,0,0,0
2019-03-02 00:30,27,6,21,0,0,0
2019-03-02 00:45,36,7,29,0,0,0
2019-03-02 01:00,40,20,20,0,0,0
2019-03-02 01:15,32,10,22,0,0,0
2019-03-02 01:30,23,6,17,0,0,0
2019-03-02 01:45,30,9,21,0,0,0
2019-03-02 02:00,22,9,13,0,0,0
2019-03-02 02:15,9,2,7,0,0,0
2019-03-02 02:30,13,4,9,0,0,0
2019-03-02 02:45,20,0,20,0,0,0
2019-03-02 03:00,18,3,15,0,0,0
2019-03-02 03:15,16,0,16,0,0,0
2019-03-02 03:30,14,1,13,0,0,0
2019-03-02 03:45,11,5,6,0,0,0
2019-03-02 04:00,11,3,8,0,0,0
2019-03-02 04:15,9,1,8,0,0,0
2019-03-02 04:30,6,1,5,0,0,0
2019-03-02 04:45,6,2,4,0,0,0
2019-03-02 05:00,9,2,7,0,0,0
2019-03-02 05:15,7,3,4,0,0,0
2019-03-02 05:30,9,3,6,0,0,0
2019-03-02 05:45,8,6,2,0,0,0
2019-03-02 06:00,7,3,4,0,0,0
2019-03-02 06:15,8,5,3,0,0,0
2019-03-02 06:30,10,8,2,0,0,0
2019-03-02 06:45,11,6,5,0,0,0
2019-03-02 07:00,7,3,4,0,0,0
2019-03-02 07:15,20,13,7,0,0,0
2019-03-02 07:30,24,20,4,0,0,0
2019-03-02 07:45,42,36,6,0,0,0
2019-03-02 08:00,22,17,5,0,0,0
2019-03-02 08:15,37,25,12,0,0,0
2019-03-02 08:30,33,21,12,0,0,0
2019-03-02 08:45,63,47,16,0,0,0
2019-03-02 09:00,41,30,11,0,0,0
2019-03-02 09:15,69,54,15,0,0,0
2019-03-02 09:30,64,40,24,0,0,0
2019-03-02 09:45,100,73,27,0,0,0
2019-03-02 10:00,98,75,23,0,0,0
2019-03-02 10:15,84,64,20,0,0,0
2019-03-02 10:30,109,80,29,0,0,0
2019-03-02 10:45,95,68,27,0,0,0
2019-03-02 11:00,109,68,41,0,0,0
2019-03-02 11:15,102,71,31,0,0,0
2019-03-02 11:30,92,58,34,0,0,0
2019-03-02 11:45,111,63,48,0,0,0
2019-03-02 12:00,112,66,46,0,0,0
2019-03-02 12:15,124,79,45,0,0,0
2019-03-02 12:30,108,75,33,0,0,0
2019-03-02 12:45,139,90,49,0,0,0
2019-03-02 13:00,122,64,58,0,0,0
2019-03-02 13:15,97,45,52,0,0,0
2019-03-02 13:30,102,62,40,0,0,0
2019-03-02 13:45,115,49,66,0,0,0
2019-03-02 14:00,108,43,65,0,0,0
2019-03-02 14:15,105,57,48,0,0,0
2019-03-02 14:30,94,53,41,0,0,0
2019-03-02 14:45,144,74,70,0,0,0
2019-03-02 15:00,95,49,46,0,0,0
2019-03-02 15:15,104,44,60,0,0,0
2019-03-02 15:30,97,45,52,0,0,0
2019-03-02 15:45,96,51,45,0,0,0
2019-03-02 16:00,96,42,54,0,0,0
2019-03-02 16:15,112,43,69,0,0,0
2019-03-02 16:30,100,36,64,0,0,0
2019-03-02 16:45,119,51,68,0,0,0
2019-03-02 17:00,114,52,62,0,0,0
2019-03-02 17:15,114,63,51,0,0,0
2019-03-02 17:30,94,43,51,0,0,0
2019-03-02 17:45,134,61,73,0,0,0
2019-03-02 18:00,106,44,62,0,0,0
2019-03-02 18:15,123,60,63,0,0,0
2019-03-02 18:30,57,26,31,0,0,0
2019-03-02 18:45,73,40,33,0,0,0
2019-03-02 19:00,89,40,49,0,0,0
2019-03-02 19:15,64,37,27,0,0,0
2019-03-02 19:30,50,24,26,0,0,0
2019-03-02 19:45,78,35,43,0,0,0
2019-03-02 20:00,66,30,36,0,0,0
2019-03-02 20:15,65,35,30,0,0,0
2019-03-02 20:30,42,19,23,0,0,0
2019-03-02 20:45,42,19,23,0,0,0
2019-03-02 21:00,40,19,21,0,0,0
2019-03-02 21:15,54,25,29,0,0,0
2019-03-02 21:30,52,16,36,0,0,0
2019-03-02 21:45,59,24,35,0,0,0
2019-03-02 22:00,34,15,19,0,0,0
2019-03-02 22:15,34,16,18,0,0,0
2019-03-02 22:30,27,4,23,0,0,0
2019-03-02 22:45,49,13,36,0,0,0
2019-03-02 23:00,21,7,14,0,0,0
2019-03-02 23:15,30,11,19,0,0,0
2019-03-02 23:30,26,9,17,0,0,0
2019-03-02 23:45,26,6,20,0,0,0
2019-03-03 00:00,32,7,25,0,0,0
2019-03-03 00:15,25,6,19,0,0,0
2019-03-03 00:30,37,17,20,0,0,0
2019-03-03 00:45,48,21,27,0,0,0
2019-03-03 01:00,28,4,24,0,0,0
2019-03-03 01:15,25,6,19,0,0,0
2019-03-03 01:30,13,3,10,0,0,0
2019-03-03 01:45,21,5,16,0,0,0
2019-03-03 02:00,21,5,16,0,0,0
2019-03-03 02:15,19,2,17,0,0,0
2019-03-03 02:30,20,4,16,0,0,0
2019-03-03 02:45,21,7,14,0,0,0
2019-03-03 03:00,8,2,6,0,0,0
2019-03-03 03:15,17,0,17,0,0,0
2019-03-03 03:30,14,5,9,0,0,0
2019-03-03 03:45,6,0,6,0,0,0
2019-03-03 04:00,3,2,1,0,0,0
2019-03-03 04:15,12,2,10,0,0,0
2019-03-03 04:30,6,3,3,0,0,0
2019-03-03 04:45,5,0,5,0,0,0
2019-03-03 05:00,5,0,5,0,0,0
2019-03-03 05:15,8,3,5,0,0,0
2019-03-03 05:30,7,2,5,0,0,0
2019-03-03 05:45,10,3,7,0,0,0
2019-03-03 06:00,8,2,6,0,0,0
2019-03-03 06:15,2,2,0,0,0,0
2019-03-03 06:30,3,2,1,0,0,0
2019-03-03 06:45,7,3,4,0,0,0
2019-03-03 07:00,2,2,0,0,0,0
2019-03-03 07:15,5,3,2,0,0,0
2019-03-03 07:30,6,5,1,0,0,0
2019-03-03 07:45,13,6,7,0,0,0
2019-03-03 08:00,6,5,1,0,0,0
2019-03-03 08:15,10,4,6,0,0,0
2019-03-03 08:30,17,9,8,0,0,0
2019-03-03 08:45,12,9,3,0,0,0
2019-03-03 09:00,9,5,4,0,0,0
2019-03-03 09:15,17,11,6,0,0,0
2019-03-03 09:30,14,12,2,0,0,0
2019-03-03 09:45,47,41,6,0,0,0
2019-03-03 10:00,31,26,5,0,0,0
2019-03-03 10:15,39,25,14,0,0,0
2019-03-03 10:30,33,23,10,0,0,0
2019-03-03 10:45,30,21,9,0,0,0
2019-03-03 11:00,14,9,5,0,0,0
2019-03-03 11:15,22,16,6,0,0,0
2019-03-03 11:30,21,14,7,0,0,0
2019-03-03 11:45,37,22,15,0,0,0
2019-03-03 12:00,19,15,4,0,0,0
2019-03-03 12:15,26,20,6,0,0,0
2019-03-03 12:30,51,26,25,0,0,0
2019-03-03 12:45,44,29,15,0,0,0
2019-03-03 13:00,39,21,18,0,0,0
2019-03-03 13:15,37,19,18,0,0,0
2019-03-03 13:30,58,22,36,0,0,0
2019-03-03 13:45,47,29,18,0,0,0
2019-03-03 14:00,32,15,17,0,0,0
2019-03-03 14:15,42,21,21,0,0,0
2019-03-03 14:30,51,30,21,0,0,0
2019-03-03 14:45,62,43,19,0,0,0
2019-03-03 15:00,31,17,14,0,0,0
2019-03-03 15:15,35,13,22,0,0,0
2019-03-03 15:30,27,16,11,0,0,0
2019-03-03 15:45,34,11,23,0,0,0
2019-03-03 16:00,29,21,8,0,0,0
2019-03-03 16:15,31,18,13,0,0,0
2019-03-03 16:30,52,21,31,0,0,0
2019-03-03 16:45,61,25,36,0,0,0
2019-03-03 17:00,52,25,27,0,0,0
2019-03-03 17:15,48,19,29,0,0,0
2019-03-03 17:30,68,33,35,0,0,0
2019-03-03 17:45,72,28,44,0,0,0
2019-03-03 18:00,34,19,15,0,0,0
2019-03-03 18:15,57,21,36,0,0,0
2019-03-03 18:30,74,28,46,0,0,0
2019-03-03 18:45,63,32,31,0,0,0
2019-03-03 19:00,47,18,29,0,0,0
2019-03-03 19:15,43,15,28,0,0,0
2019-03-03 19:30,48,29,19,0,0,0
2019-03-03 19:45,50,19,31,0,0,0
2019-03-03 20:00,48,17,31,0,0,0
2019-03-03 20:15,56,17,39,0,0,0
2019-03-03 20:30,32,11,21,0,0,0
2019-03-03 20:45,27,11,16,0,0,0
2019-03-03 21:00,38,11,27,0,0,0
2019-03-03 21:15,31,14,17,0,0,0
2019-03-03 21:30,18,8,10,0,0,0
2019-03-03 21:45,19,8,11,0,0,0
2019-03-03 22:00,40,7,33,0,0,0
2019-03-03 22:15,20,8,12,0,0,0
2019-03-03 22:30,13,6,7,0,0,0
2019-03-03 22:45,27,5,22,0,0,0
2019-03-03 23:00,19,1,18,0,0,0
2019-03-03 23:15,26,8,18,0,0,0
2019-03-03 23:30,15,8,7,0,0,0
2019-03-03 23:45,5,2,3,0,0,0
2019-03-04 00:00,15,7,8,0,0,0
2019-03-04 00:15,9,5,4,0,0,0
2019-03-04 00:30,16,4,12,0,0,0
2019-03-04 00:45,6,3,3,0,0,0
2019-03-04 01:00,9,6,3,0,0,0
2019-03-04 01:15,3,1,2,0,0,0
2019-03-04 01:30,5,1,4,0,0,0
2019-03-04 01:45,6,2,4,0,0,0
2019-03-04 02:00,1,0,1,0,0,0
2019-03-04 02:15,3,3,0,0,0,0
2019-03-04 02:30,5,2,3,0,0,0
2019-03-04 02:45,3,3,0,0,0,0
2019-03-04 03:00,1,1,0,0,0,0
2019-03-04 03:15,0,0,0,0,0,0
2019-03-04 03:30,2,1,1,0,0,0
2019-03-04 03:45,3,1,2,0,0,0
2019-03-04 04:00,5,2,3,0,0,0
2019-03-04 04:15,3,0,3,0,0,0
2019-03-04 04:30,2,1,1,0,0,0
2019-03-04 04:45,6,2,4,0,0,0
2019-03-04 05:00,6,3,3,0,0,0
2019-03-04 05:15,9,5,4,0,0,0
2019-03-04 05:30,11,7,4,0,0,0
2019-03-04 05:45,7,5,2,0,0,0
2019-03-04 06:00,11,8,3,0,0,0
2019-03-04 06:15,22,15,7,0,0,0
2019-03-04 06:30,30,21,9,0,0,0
2019-03-04 06:45,23,18,5,0,0,0
2019-03-04 07:00,23,17,6,0,0,0
2019-03-04 07:15,28,18,10,0,0,0
2019-03-04 07:30,51,37,14,0,0,0
2019-03-04 07:45,58,39,19,0,0,0
2019-03-04 08:00,44,30,14,0,0,0
2019-03-04 08:15,49,28,21,0,0,0
2019-03-04 08:30,57,37,20,0,0,0
2019-03-04 08:45,66,41,25,0,0,0
2019-03-04 09:00,45,30,15,0,0,0
2019-03-04 09:15,36,21,15,0,0,0
2019-03-04 09:30,36,16,20,0,0,0
2019-03-04 09:45,57,32,25,0,0,0
2019-03-04 10:00,55,28,27,0,0,0
2019-03-04 10:15,59,33,26,0,0,0
2019-03-04 10:30,51,33,18,0,0,0
2019-03-04 10:45,79,44,35,0,0,0
2019-03-04 11:00,56,26,30,0,0,0
2019-03-04 11:15,48,23,25,0,0,0
2019-03-04 11:30,53,19,34,0,0,0
2019-03-04 11:45,55,37,18,0,0,0
2019-03-04 12:00,55,26,29,0,0,0
2019-03-04 12:15,40,26,14,0,0,0
2019-03-04 12:30,41,19,22,0,0,0
2019-03-04 12:45,59,39,20,0,0,0
2019-03-04 13:00,70,40,30,0,0,0
2019-03-04 13:15,74,44,30,0,0,0
2019-03-04 13:30,89,53,36,0,0,0
2019-03-04 13:45,121,84,37,0,0,0
2019-03-04 14:00,144,111,33,0,0,0
2019-03-04 14:15,113,84,29,0,0,0
2019-03-04 14:30,96,64,32,0,0,0
2019-03-04 14:45,89,51,38,0,0,0
2019-03-04 15:00,91,52,39,0,0,0
2019-03-04 15:15,81,56,25,0,0,0
2019-03-04 15:30,124,64,60,0,0,0
2019-03-04 15:45,126,41,85,0,0,0
2019-03-04 16:00,129,30,99,0,0,0
2019-03-04 16:15,87,51,36,0,0,0
2019-03-04 16:30,93,39,54,0,0,0
2019-03-04 16:45,90,39,51,0,0,0
2019-03-04 17:00,75,31,44,0,0,0
2019-03-04 17:15,89,36,53,0,0,0
2019-03-04 17:30,107,39,68,0,0,0
2019-03-04 17:45,101,46,55,0,0,0
2019-03-04 18:00,97,37,60,0,0,0
2019-03-04 18:15,97,39,58,0,0,0
2019-03-04 18:30,94,31,63,0,0,0
2019-03-04 18:45,91,38,53,0,0,0
2019-03-04 19:00,95,36,59,0,0,0
2019-03-04 19:15,73,27,46,0,0,0
2019-03-04 19:30,77,31,46,0,0,0
2019-03-04 19:45,61,26,35,0,0,0
2019-03-04 20:00,61,24,37,0,0,0
2019-03-04 20:15,75,20,55,0,0,0
2019-03-04 20:30,54,24,30,0,0,0
2019-03-04 20:45,44,13,31,0,0,0
2019-03-04 21:00,51,14,37,0,0,0
2019-03-04 21:15,46,16,30,0,0,0
2019-03-04 21:30,26,11,15,0,0,0
2019-03-04 21:45,26,9,17,0,0,0
2019-03-04 22:00,50,18,32,0,0,0
2019-03-04 22:15,41,12,29,0,0,0
2019-03-04 22:30,33,9,24,0,0,0
2019-03-04 22:45,31,8,23,0,0,0
2019-03-04 23:00,49,11,38,0,0,0
2019-03-04 23:15,27,8,19,0,0,0
2019-03-04 23:30,22,2,20,0,0,0
2019-03-04 23:45,27,8,19,0,0,0
2019-03-05 00:00,29,5,24,0,0,0
2019-03-05 00:15,17,5,12,0,0,0
2019-03-05 00:30,12,3,9,0,0,0
2019-03-05 00:45,14,4,10,0,0,0
2019-03-05 01:00,11,6,5,0,0,0
2019-03-05 01:15,4,1,3,0,0,0
2019-03-05 01:30,9,1,8,0,0,0
2019-03-05 01:45,8,1,7,0,0,0
2019-03-05 02:00,7,1,6,0,0,0
2019-03-05 02:15,7,0,7,0,0,0
2019-03-05 02:30,3,1,2,0,0,0
2019-03-05 02:45,7,2,5,0,0,0
2019-03-05 03:00,5,2,3,0,0,0
2019-03-05 03:15,3,1,2,0,0,0
2019-03-05 03:30,3,0,3,0,0,0
2019-03-05 03:45,1,0,1,0,0,0
2019-03-05 04:00,8,4,4,0,0,0
2019-03-05 04:15,0,0,0,0,0,0
2019-03-05 04:30,2,2,0,0,0,0
2019-03-05 04:45,4,2,2,0,0,0
2019-03-05 05:00,8,4,4,0,0,0
2019-03-05 05:15,8,3,5,0,0,0
2019-03-05 05:30,22,11,11,0,0,0
2019-03-05 05:45,14,11,3,0,0,0
2019-03-05 06:00,16,12,4,0,0,0
2019-03-05 06:15,31,25,6,0,0,0
2019-03-05 06:30,45,32,13,0,0,0
2019-03-05 06:45,57,38,19,0,0,0
2019-03-05 07:00,83,54,29,0,0,0
2019-03-05 07:15,71,47,24,0,0,0
2019-03-05 07:30,134,73,61,0,0,0
2019-03-05 07:45,199,131,68,0,0,0
2019-03-05 08:00,150,94,56,0,0,0
2019-03-05 08:15,149,95,54,0,0,0
2019-03-05 08:30,172,104,68,0,0,0
2019-03-05 08:45,204,143,61,0,0,0
2019-03-05 09:00,137,92,45,0,0,0
2019-03-05 09:15,104,60,44,0,0,0
2019-03-05 09:30,130,75,55,0,0,0
2019-03-05 09:45,117,70,47,0,0,0
2019-03-05 10:00,86,57,29,0,0,0
2019-03-05 10:15,92,56,36,0,0,0
2019-03-05 10:30,93,59,34,0,0,0
2019-03-05 10:45,98,61,37,0,0,0
2019-03-05 11:00,87,45,42,0,0,0
2019-03-05 11:15,100,57,43,0,0,0
2019-03-05 11:30,126,73,53,0,0,0
2019-03-05 11:45,106,54,52,0,0,0
2019-03-05 12:00,92,52,40,0,0,0
2019-03-05 12:15,113,64,49,0,0,0
2019-03-05 12:30,136,80,56,0,0,0
2019-03-05 12:45,116,67,49,0,0,0
2019-03-05 13:00,125,73,52,0,0,0
2019-03-05 13:15,125,59,66,0,0,0
2019-03-05 13:30,124,63,61,0,0,0
2019-03-05 13:45,118,75,43,0,0,0
2019-03-05 14:00,92,38,54,0,0,0
2019-03-05 14:15,140,63,77,0,0,0
2019-03-05 14:30,141,78,63,0,0,0
2019-03-05 14:45,156,82,74,0,0,0
2019-03-05 15:00,135,68,67,0,0,0
2019-03-05 15:15,142,84,58,0,0,0
2019-03-05 15:30,151,79,72,0,0,0
2019-03-05 15:45,194,113,81,0,0,0
2019-03-05 16:00,185,90,95,0,0,0
2019-03-05 16:15,190,99,91,0,0,0
2019-03-05 16:30,193,102,91,0,0,0
2019-03-05 16:45,193,89,104,0,0,0
2019-03-05 17:00,196,91,105,0,0,0
2019-03-05 17:15,220,107,113,0,0,0
2019-03-05 17:30,234,107,127,0,0,0
2019-03-05 17:45,188,88,100,0,0,0
2019-03-05 18:00,203,79,124,0,0,0
2019-03-05 18:15,182,81,101,0,0,0
2019-03-05 18:30,184,69,115,0,0,0
2019-03-05 18:45,169,71,98,0,0,0
2019-03-05 19:00,154,65,89,0,0,0
2019-03-05 19:15,154,76,78,0,0,0
2019-03-05 19:30,158,74,84,0,0,0
2019-03-05 19:45,146,69,77,0,0,0
2019-03-05 20:00,106,48,58,0,0,0
2019-03-05 20:15,123,50,73,0,0,0
2019-03-05 20:30,63,20,43,0,0,0
2019-03-05 20:45,55,19,36,0,0,0
2019-03-05 21:00,72,32,40,0,0,0
2019-03-05 21:15,55,17,38,0,0,0
2019-03-05 21:30,68,36,32,0,0,0
2019-03-05 21:45,46,17,29,0,0,0
2019-03-05 22:00,70,24,46,0,0,0
2019-03-05 22:15,63,21,42,0,0,0
2019-03-05 22:30,58,20,38,0,0,0
2019-03-05 22:45,53,17,36,0,0,0
2019-03-05 23:00,42,16,26,0,0,0
2019-03-05 23:15,50,12,38,0,0,0
2019-03-05 23:30,19,5,14,0,0,0
2019-03-05 23:45,29,9,20,0,0,0
2019-03-06 00:00,13,5,8,0,0,0
2019-03-06 00:15,15,5,10,0,0,0
2019-03-06 00:30,17,2,15,0,0,0
2019-03-06 00:45,13,3,10,0,0,0
2019-03-06 01:00,8,4,4,0,0,0
2019-03-06 01:15,7,2,5,0,0,0
2019-03-06 01:30,9,3,6,0,0,0
2019-03-06 01:45,7,0,7,0,0,0
2019-03-06 02:00,1,0,1,0,0,0
2019-03-06 02:15,0,0,0,0,0,0
2019-03-06 02:30,2,1,1,0,0,0
2019-03-06 02:45,2,1,1,0,0,0
2019-03-06 03:00,1,1,0,0,0,0
2019-03-06 03:15,0,0,0,0,0,0
2019-03-06 03:30,2,0,2,0,0,0
2019-03-06 03:45,2,2,0,0,0,0
2019-03-06 04:00,1,1,0,0,0,0
2019-03-06 04:15,0,0,0,0,0,0
2019-03-06 04:30,5,4,1,0,0,0
2019-03-06 04:45,5,3,2,0,0,0
2019-03-06 05:00,7,5,2,0,0,0
2019-03-06 05:15,10,4,6,0,0,0
2019-03-06 05:30,20,13,7,0,0,0
2019-03-06 05:45,14,12,2,0,0,0
2019-03-06 06:00,26,20,6,0,0,0
2019-03-06 06:15,38,30,8,0,0,0
2019-03-06 06:30,61,40,21,0,0,0
2019-03-06 06:45,86,68,18,0,0,0
2019-03-06 07:00,99,64,35,0,0,0
2019-03-06 07:15,124,94,30,0,0,0
2019-03-06 07:30,263,192,71,0,0,0
2019-03-06 07:45,268,178,90,0,0,0
2019-03-06 08:00,209,132,77,0,0,0
2019-03-06 08:15,220,138,82,0,0,0
2019-03-06 08:30,237,140,97,0,0,0
2019-03-06 08:45,221,130,91,0,0,0
2019-03-06 09:00,179,114,65,0,0,0
2019-03-06 09:15,132,73,59,0,0,0
2019-03-06 09:30,162,102,60,0,0,0
2019-03-06 09:45,143,105,38,0,0,0
2019-03-06 10:00,125,89,36,0,0,0
2019-03-06 10:15,129,82,47,0,0,0
2019-03-06 10:30,123,71,52,0,0,0
2019-03-06 10:45,141,94,47,0,0,0
2019-03-06 11:00,103,59,44,0,0,0
2019-03-06 11:15,117,67,50,0,0,0
2019-03-06 11:30,141,90,51,0,0,0
2019-03-06 11:45,135,83,52,0,0,0
2019-03-06 12:00,129,71,58,0,0,0
2019-03-06 12:15,133,66,67,0,0,0
2019-03-06 12:30,145,80,65,0,0,0
2019-03-06 12:45,174,95,79,0,0,0
2019-03-06 13:00,154,59,95,0,0,0
2019-03-06 13:15,129,55,74,0,0,0
2019-03-06 13:30,147,70,77,0,0,0
2019-03-06 13:45,152,70,82,0,0,0
2019-03-06 14:00,139,57,82,0,0,0
2019-03-06 14:15,153,75,78,0,0,0
2019-03-06 14:30,156,78,78,0,0,0
2019-03-06 14:45,145,66,79,0,0,0
2019-03-06 15:00,114,43,71,0,0,0
2019-03-06 15:15,181,84,97,0,0,0
2019-03-06 15:30,227,80,147,0,0,0
2019-03-06 15:45,168,74,94,0,0,0
2019-03-06 16:00,197,82,115,0,0,0
2019-03-06 16:15,233,106,127,0,0,0
2019-03-06 16:30,179,78,101,0,0,0
2019-03-06 16:45,180,77,103,0,0,0
2019-03-06 17:00,199,76,123,0,0,0
2019-03-06 17:15,241,121,120,0,0,0
2019-03-06 17:30,242,93,149,0,0,0
2019-03-06 17:45,235,108,127,0,0,0
2019-03-06 18:00,247,103,144,0,0,0
2019-03-06 18:15,173,75,98,0,0,0
2019-03-06 18:30,186,67,119,0,0,0
2019-03-06 18:45,235,134,101,0,0,0
2019-03-06 19:00,185,89,96,0,0,0
2019-03-06 19:15,184,96,88,0,0,0
2019-03-06 19:30,167,79,88,0,0,0
2019-03-06 19:45,152,72,80,0,0,0
2019-03-06 20:00,110,47,63,0,0,0
2019-03-06 20:15,82,32,50,0,0,0
2019-03-06 20:30,95,39,56,0,0,0
2019-03-06 20:45,77,31,46,0,0,0
2019-03-06 21:00,82,44,38,0,0,0
2019-03-06 21:15,56,19,37,0,0,0
2019-03-06 21:30,83,21,62,0,0,0
2019-03-06 21:45,66,33,33,0,0,0
2019-03-06 22:00,71,23,48,0,0,0
2019-03-06 22:15,70,32,38,0,0,0
2019-03-06 22:30,70,25,45,0,0,0
2019-03-06 22:45,49,13,36,0,0,0
2019-03-06 23:00,71,14,57,0,0,0
2019-03-06 23:15,32,8,24,0,0,0
2019-03-06 23:30,45,14,31,0,0,0
2019-03-06 23:45,37,14,23,0,0,0
2019-03-07 00:00,23,11,12,0,0,0
2019-03-07 00:15,15,7,8,0,0,0
2019-03-07 00:30,15,5,10,0,0,0
2019-03-07 00:45,12,4,8,0,0,0
2019-03-07 01:00,8,3,5,0,0,0
2019-03-07 01:15,22,8,14,0,0,0
2019-03-07 01:30,8,4,4,0,0,0
2019-03-07 01:45,10,1,9,0,0,0
2019-03-07 02:00,11,1,10,0,0,0
2019-03-07 02:15,8,1,7,0,0,0
2019-03-07 02:30,10,2,8,0,0,0
2019-03-07 02:45,3,1,2,0,0,0
2019-03-07 03:00,5,0,5,0,0,0
2019-03-07 03:15,1,0,1,0,0,0
2019-03-07 03:30,2,2,0,0,0,0
2019-03-07 03:45,3,1,2,0,0,0
2019-03-07 04:00,0,0,0,0,0,0
2019-03-07 04:15,3,1,2,0,0,0
2019-03-07 04:30,4,3,1,0,0,0
2019-03-07 04:45,6,2,4,0,0,0
2019-03-07 05:00,10,8,2,0,0,0
2019-03-07 05:15,13,9,4,0,0,0
2019-03-07 05:30,19,7,12,0,0,0
2019-03-07 05:45,12,8,4,0,0,0
2019-03-07 06:00,24,17,7,0,0,0
2019-03-07 06:15,42,37,5,0,0,0
2019-03-07 06:30,56,38,18,0,0,0
2019-03-07 06:45,73,54,19,0,0,0
2019-03-07 07:00,95,54,41,0,0,0
2019-03-07 07:15,130,88,42,0,0,0
2019-03-07 07:30,261,179,82,0,0,0
2019-03-07 07:45,250,156,94,0,0,0
2019-03-07 08:00,181,123,58,0,0,0
2019-03-07 08:15,141,100,41,0,0,0
2019-03-07 08:30,176,89,87,0,0,0
2019-03-07 08:45,183,111,72,0,0,0
2019-03-07 09:00,142,101,41,0,0,0
2019-03-07 09:15,82,54,28,0,0,0
2019-03-07 09:30,94,63,31,0,0,0
2019-03-07 09:45,104,72,32,0,0,0
2019-03-07 10:00,79,47,32,0,0,0
2019-03-07 10:15,86,50,36,0,0,0
2019-03-07 10:30,81,47,34,0,0,0
2019-03-07 10:45,88,42,46,0,0,0
2019-03-07 11:00,64,44,20,0,0,0
2019-03-07 11:15,89,54,35,0,0,0
2019-03-07 11:30,86,42,44,0,0,0
2019-03-07 11:45,94,48,46,0,0,0
2019-03-07 12:00,101,54,47,0,0,0
2019-03-07 12:15,125,69,56,0,0,0
2019-03-07 12:30,127,68,59,0,0,0
2019-03-07 12:45,177,109,68,0,0,0
2019-03-07 13:00,131,63,68,0,0,0
2019-03-07 13:15,110,58,52,0,0,0
2019-03-07 13:30,98,39,59,0,0,0
2019-03-07 13:45,142,64,78,0,0,0
2019-03-07 14:00,140,64,76,0,0,0
2019-03-07 14:15,140,79,61,0,0,0
2019-03-07 14:30,131,75,56,0,0,0
2019-03-07 14:45,170,81,89,0,0,0
2019-03-07 15:00,131,67,64,0,0,0
2019-03-07 15:15,135,62,73,0,0,0
2019-03-07 15:30,188,69,119,0,0,0
2019-03-07 15:45,166,92,74,0,0,0
2019-03-07 16:00,192,89,103,0,0,0
2019-03-07 16:15,185,79,106,0,0,0
2019-03-07 16:30,184,82,102,0,0,0
2019-03-07 16:45,142,81,61,0,0,0
2019-03-07 17:00,124,48,76,0,0,0
2019-03-07 17:15,206,101,105,0,0,0
2019-03-07 17:30,201,84,117,0,0,0
2019-03-07 17:45,209,89,120,0,0,0
2019-03-07 18:00,205,82,123,0,0,0
2019-03-07 18:15,179,76,103,0,0,0
2019-03-07 18:30,181,83,98,0,0,0
2019-03-07 18:45,179,79,100,0,0,0
2019-03-07 19:00,154,80,74,0,0,0
2019-03-07 19:15,133,76,57,0,0,0
2019-03-07 19:30,119,47,72,0,0,0
2019-03-07 19:45,140,72,68,0,0,0
2019-03-07 20:00,111,52,59,0,0,0
2019-03-07 20:15,110,53,57,0,0,0
2019-03-07 20:30,90,46,44,0,0,0
2019-03-07 20:45,61,20,41,0,0,0
2019-03-07 21:00,77,44,33,0,0,0
2019-03-07 21:15,53,22,31,0,0,0
2019-03-07 21:30,69,24,45,0,0,0
2019-03-07 21:45,54,24,30,0,0,0
2019-03-07 22:00,66,21,45,0,0,0
2019-03-07 22:15,66,31,35,0,0,0
2019-03-07 22:30,63,15,48,0,0,0
2019-03-07 22:45,52,15,37,0,0,0
2019-03-07 23:00,77,26,51,0,0,0
2019-03-07 23:15,59,27,32,0,0,0
2019-03-07 23:30,41,18,23,0,0,0
2019-03-07 23:45,33,11,22,0,0,0
2019-03-08 00:00,20,5,15,0,0,0
2019-03-08 00:15,14,9,5,0,0,0
2019-03-08 00:30,12,7,5,0,0,0
2019-03-08 00:45,19,3,16,0,0,0
2019-03-08 01:00,4,1,3,0,0,0
2019-03-08 01:15,5,1,4,0,0,0
2019-03-08 01:30,5,1,4,0,0,0
2019-03-08 01:45,6,1,5,0,0,0
2019-03-08 02:00,3,1,2,0,0,0
2019-03-08 02:15,5,3,2,0,0,0
2019-03-08 02:30,4,1,3,0,0,0
2019-03-08 02:45,3,3,0,0,0,0
2019-03-08 03:00,5,2,3,0,0,0
2019-03-08 03:15,3,0,3,0,0,0
2019-03-08 03:30,3,2,1,0,0,0
2019-03-08 03:45,3,2,1,0,0,0
2019-03-08 04:00,1,0,1,0,0,0
2019-03-08 04:15,2,0,2,0,0,0
2019-03-08 04:30,3,1,2,0,0,0
2019-03-08 04:45,3,0,3,0,0,0
2019-03-08 05:00,10,7,3,0,0,0
2019-03-08 05:15,7,5,2,0,0,0
2019-03-08 05:30,12,7,5,0,0,0
2019-03-08 05:45,16,10,6,0,0,0
2019-03-08 06:00,20,12,8,0,0,0
2019-03-08 06:15,45,38,7,0,0,0
2019-03-08 06:30,37,22,15,0,0,0
2019-03-08 06:45,70,48,22,0,0,0
2019-03-08 07:00,91,56,35,0,0,0
2019-03-08 07:15,117,83,34,0,0,0
2019-03-08 07:30,238,171,67,0,0,0
2019-03-08 07:45,236,156,80,0,0,0
2019-03-08 08:00,178,104,74,0,0,0
2019-03-08 08:15,151,85,66,0,0,0
2019-03-08 08:30,187,109,78,0,0,0
2019-03-08 08:45,210,144,66,0,0,0
2019-03-08 09:00,147,100,47,0,0,0
2019-03-08 09:15,122,81,41,0,0,0
2019-03-08 09:30,106,62,44,0,0,0
2019-03-08 09:45,131,81,50,0,0,0
2019-03-08 10:00,88,53,35,0,0,0
2019-03-08 10:15,111,78,33,0,0,0
2019-03-08 10:30,104,60,44,0,0,0
2019-03-08 10:45,114,70,44,0,0,0
2019-03-08 11:00,100,59,41,0,0,0
2019-03-08 11:15,116,68,48,0,0,0
2019-03-08 11:30,100,61,39,0,0,0
2019-03-08 11:45,103,53,50,0,0,0
2019-03-08 12:00,99,56,43,0,0,0
2019-03-08 12:15,118,56,62,0,0,0
2019-03-08 12:30,134,61,73,0,0,0
2019-03-08 12:45,148,86,62,0,0,0
2019-03-08 13:00,182,74,108,0,0,0
2019-03-08 13:15,149,77,72,0,0,0
2019-03-08 13:30,149,71,78,0,0,0
2019-03-08 13:45,175,78,97,0,0,0
2019-03-08 14:00,149,65,84,0,0,0
2019-03-08 14:15,158,75,83,0,0,0
2019-03-08 14:30,145,82,63,0,0,0
2019-03-08 14:45,139,59,80,0,0,0
2019-03-08 15:00,151,71,80,0,0,0
2019-03-08 15:15,157,78,79,0,0,0
2019-03-08 15:30,179,93,86,0,0,0
2019-03-08 15:45,156,82,74,0,0,0
2019-03-08 16:00,169,101,68,0,0,0
2019-03-08 16:15,171,94,77,0,0,0
2019-03-08 16:30,164,79,85,0,0,0
2019-03-08 16:45,160,81,79,0,0,0
2019-03-08 17:00,174,87,87,0,0,0
2019-03-08 17:15,186,98,88,0,0,0
2019-03-08 17:30,167,87,80,0,0,0
2019-03-08 17:45,193,105,88,0,0,0
2019-03-08 18:00,174,73,101,0,0,0
2019-03-08 18:15,167,77,90,0,0,0
2019-03-08 18:30,106,51,55,0,0,0
2019-03-08 18:45,165,90,75,0,0,0
2019-03-08 19:00,134,80,54,0,0,0
2019-03-08 19:15,140,76,64,0,0,0
2019-03-08 19:30,127,68,59,0,0,0
2019-03-08 19:45,141,66,75,0,0,0
2019-03-08 20:00,132,70,62,0,0,0
2019-03-08 20:15,103,48,55,0,0,0
2019-03-08 20:30,90,42,48,0,0,0
2019-03-08 20:45,79,39,40,0,0,0
2019-03-08 21:00,74,38,36,0,0,0
2019-03-08 21:15,60,31,29,0,0,0
2019-03-08 21:30,41,18,23,0,0,0
2019-03-08 21:45,57,20,37,0,0,0
2019-03-08 22:00,63,22,41,0,0,0
2019-03-08 22:15,62,28,34,0,0,0
2019-03-08 22:30,92,31,61,0,0,0
2019-03-08 22:45,49,15,34,0,0,0
2019-03-08 23:00,53,17,36,0,0,0
2019-03-08 23:15,55,30,25,0,0,0
2019-03-08 23:30,54,17,37,0,0,0
2019-03-08 23:45,43,18,25,0,0,0
2019-03-09 00:00,55,15,40,0,0,0
2019-03-09 00:15,48,16,32,0,0,0
2019-03-09 00:30,27,11,16,0,0,0
2019-03-09 00:45,34,10,24,0,0,0
2019-03-09 01:00,36,6,30,0,0,0
2019-03-09 01:15,33,8,25,0,0,0
2019-03-09 01:30,24,6,18,0,0,0
2019-03-09 01:45,17,6,11,0,0,0
2019-03-09 02:00,20,3,17,0,0,0
2019-03-09 02:15,25,5,20,0,0,0
2019-03-09 02:30,12,0,12,0,0,0
2019-03-09 02:45,7,0,7,0,0,0
2019-03-09 03:00,9,3,6,0,0,0
2019-03-09 03:15,16,3,13,0,0,0
2019-03-09 03:30,12,5,7,0,0,0
2019-03-09 03:45,16,2,14,0,0,0
2019-03-09 04:00,7,3,4,0,0,0
2019-03-09 04:15,7,1,6,0,0,0
2019-03-09 04:30,6,3,3,0,0,0
2019-03-09 04:45,4,1,3,0,0,0
2019-03-09 05:00,6,0,6,0,0,0
2019-03-09 05:15,8,5,3,0,0,0
2019-03-09 05:30,10,4,6,0,0,0
2019-03-09 05:45,7,5,2,0,0,0
2019-03-09 06:00,10,6,4,0,0,0
2019-03-09 06:15,4,4,0,0,0,0
2019-03-09 06:30,10,5,5,0,0,0
2019-03-09 06:45,19,7,12,0,0,0
2019-03-09 07:00,16,11,5,0,0,0
2019-03-09 07:15,10,7,3,0,0,0
2019-03-09 07:30,19,15,4,0,0,0
2019-03-09 07:45,31,23,8,0,0,0
2019-03-09 08:00,29,22,7,0,0,0
2019-03-09 08:15,41,26,15,0,0,0
2019-03-09 08:30,51,29,22,0,0,0
2019-03-09 08:45,73,43,30,0,0,0
2019-03-09 09:00,67,47,20,0,0,0
2019-03-09 09:15,70,53,17,0,0,0
2019-03-09 09:30,70,48,22,0,0,0
2019-03-09 09:45,120,97,23,0,0,0
2019-03-09 10:00,83,63,20,0,0,0
2019-03-09 10:15,101,70,31,0,0,0
2019-03-09 10:30,97,66,31,0,0,0
2019-03-09 10:45,117,74,43,0,0,0
2019-03-09 11:00,70,45,25,0,0,0
2019-03-09 11:15,98,65,33,0,0,0
2019-03-09 11:30,113,69,44,0,0,0
2019-03-09 11:45,118,89,29,0,0,0
2019-03-09 12:00,115,73,42,0,0,0
2019-03-09 12:15,116,61,55,0,0,0
2019-03-09 12:30,129,78,51,0,0,0
2019-03-09 12:45,112,72,40,0,0,0
2019-03-09 13:00,113,51,62,0,0,0
2019-03-09 13:15,97,49,48,0,0,0
2019-03-09 13:30,93,48,45,0,0,0
2019-03-09 13:45,116,62,54,0,0,0
2019-03-09 14:00,97,48,49,0,0,0
2019-03-09 14:15,121,55,66,0,0,0
2019-03-09 14:30,80,27,53,0,0,0
2019-03-09 14:45,74,29,45,0,0,0
2019-03-09 15:00,91,33,58,0,0,0
2019-03-09 15:15,78,38,40,0,0,0
2019-03-09 15:30,71,30,41,0,0,0
2019-03-09 15:45,85,36,49,0,0,0
2019-03-09 16:00,46,15,31,0,0,0
2019-03-09 16:15,42,14,28,0,0,0
2019-03-09 16:30,39,10,29,0,0,0
2019-03-09 16:45,50,11,39,0,0,0
2019-03-09 17:00,62,20,42,0,0,0
2019-03-09 17:15,94,31,63,0,0,0
2019-03-09 17:30,87,48,39,0,0,0
2019-03-09 17:45,105,57,48,0,0,0
2019-03-09 18:00,66,25,41,0,0,0
2019-03-09 18:15,75,31,44,0,0,0
2019-03-09 18:30,66,26,40,0,0,0
2019-03-09 18:45,92,42,50,0,0,0
2019-03-09 19:00,87,44,43,0,0,0
2019-03-09 19:15,69,39,30,0,0,0
2019-03-09 19:30,71,32,39,0,0,0
2019-03-09 19:45,110,52,58,0,0,0
2019-03-09 20:00,68,35,33,0,0,0
2019-03-09 20:15,62,35,27,0,0,0
2019-03-09 20:30,63,35,28,0,0,0
2019-03-09 20:45,61,28,33,0,0,0
2019-03-09 21:00,48,29,19,0,0,0
2019-03-09 21:15,33,18,15,0,0,0
2019-03-09 21:30,52,26,26,0,0,0
2019-03-09 21:45,44,12,32,0,0,0
2019-03-09 22:00,25,9,16,0,0,0
2019-03-09 22:15,44,25,19,0,0,0
2019-03-09 22:30,39,18,21,0,0,0
2019-03-09 22:45,30,16,14,0,0,0
2019-03-09 23:00,36,21,15,0,0,0
2019-03-09 23:15,37,14,23,0,0,0
2019-03-09 23:30,28,13,15,0,0,0
2019-03-09 23:45,41,12,29,0,0,0
2019-03-10 00:00,40,12,28,0,0,0
2019-03-10 00:15,31,11,20,0,0,0
2019-03-10 00:30,35,7,28,0,0,0
2019-03-10 00:45,27,4,23,0,0,0
2019-03-10 01:00,24,9,15,0,0,0
2019-03-10 01:15,44,16,28,0,0,0
2019-03-10 01:30,18,2,16,0,0,0
2019-03-10 01:45,40,11,29,0,0,0
2019-03-10 02:00,33,15,18,0,0,0
2019-03-10 02:15,22,6,16,0,0,0
2019-03-10 02:30,16,6,10,0,0,0
2019-03-10 02:45,26,2,24,0,0,0
2019-03-10 03:00,9,0,9,0,0,0
2019-03-10 03:15,15,0,15,0,0,0
2019-03-10 03:30,18,3,15,0,0,0
2019-03-10 03:45,10,1,9,0,0,0
2019-03-10 04:00,8,2,6,0,0,0
2019-03-10 04:15,21,6,15,0,0,0
2019-03-10 04:30,12,5,7,0,0,0
2019-03-10 04:45,7,0,7,0,0,0
2019-03-10 05:00,11,6,5,0,0,0
2019-03-10 05:15,6,2,4,0,0,0
2019-03-10 05:30,5,2,3,0,0,0
2019-03-10 05:45,5,3,2,0,0,0
2019-03-10 06:00,8,3,5,0,0,0
2019-03-10 06:15,6,2,4,0,0,0
2019-03-10 06:30,7,4,3,0,0,0
2019-03-10 06:45,5,4,1,0,0,0
2019-03-10 07:00,4,2,2,0,0,0
2019-03-10 07:15,7,6,1,0,0,0
2019-03-10 07:30,3,0,3,0,0,0
2019-03-10 07:45,9,6,3,0,0,0
2019-03-10 08:00,10,5,5,0,0,0
2019-03-10 08:15,6,5,1,0,0,0
2019-03-10 08:30,13,4,9,0,0,0
2019-03-10 08:45,11,10,1,0,0,0
2019-03-10 09:00,20,14,6,0,0,0
2019-03-10 09:15,15,8,7,0,0,0
2019-03-10 09:30,22,16,6,0,0,0
2019-03-10 09:45,48,35,13,0,0,0
2019-03-10 10:00,27,22,5,0,0,0
2019-03-10 10:15,30,22,8,0,0,0
2019-03-10 10:30,29,15,14,0,0,0
2019-03-10 10:45,42,31,11,0,0,0
2019-03-10 11:00,22,13,9,0,0,0
2019-03-10 11:15,26,10,16,0,0,0
2019-03-10 11:30,40,20,20,0,0,0
2019-03-10 11:45,38,21,17,0,0,0
2019-03-10 12:00,41,16,25,0,0,0
2019-03-10 12:15,41,22,19,0,0,0
2019-03-10 12:30,30,14,16,0,0,0
2019-03-10 12:45,49,23,26,0,0,0
2019-03-10 13:00,39,20,19,0,0,0
2019-03-10 13:15,36,18,18,0,0,0
2019-03-10 13:30,45,26,19,0,0,0
2019-03-10 13:45,50,34,16,0,0,0
2019-03-10 14:00,36,22,14,0,0,0
2019-03-10 14:15,46,24,22,0,0,0
2019-03-10 14:30,52,26,26,0,0,0
2019-03-10 14:45,28,18,10,0,0,0
2019-03-10 15:00,37,21,16,0,0,0
2019-03-10 15:15,46,32,14,0,0,0
2019-03-10 15:30,43,26,17,0,0,0
2019-03-10 15:45,45,22,23,0,0,0
2019-03-10 16:00,34,17,17,0,0,0
2019-03-10 16:15,27,10,17,0,0,0
2019-03-10 16:30,36,13,23,0,0,0
2019-03-10 16:45,37,15,22,0,0,0
2019-03-10 17:00,38,18,20,0,0,0
2019-03-10 17:15,39,19,20,0,0,0
2019-03-10 17:30,41,16,25,0,0,0
2019-03-10 17:45,61,27,34,0,0,0
2019-03-10 18:00,39,12,27,0,0,0
2019-03-10 18:15,36,13,23,0,0,0
2019-03-10 18:30,33,15,18,0,0,0
2019-03-10 18:45,39,17,22,0,0,0
2019-03-10 19:00,29,10,19,0,0,0
2019-03-10 19:15,35,10,25,0,0,0
2019-03-10 19:30,47,20,27,0,0,0
2019-03-10 19:45,48,8,40,0,0,0
2019-03-10 20:00,34,14,20,0,0,0
2019-03-10 20:15,24,9,15,0,0,0
2019-03-10 20:30,30,12,18,0,0,0
2019-03-10 20:45,15,10,5,0,0,0
2019-03-10 21:00,15,6,9,0,0,0
2019-03-10 21:15,19,4,15,0,0,0
2019-03-10 21:30,31,8,23,0,0,0
2019-03-10 21:45,22,11,11,0,0,0
2019-03-10 22:00,18,5,13,0,0,0
2019-03-10 22:15,23,10,13,0,0,0
2019-03-10 22:30,12,4,8,0,0,0
2019-03-10 22:45,12,8,4,0,0,0
2019-03-10 23:00,17,7,10,0,0,0
2019-03-10 23:15,9,3,6,0,0,0
2019-03-10 23:30,8,1,7,0,0,0
2019-03-10 23:45,7,4,3,0,0,0
2019-03-11 00:00,7,5,2,0,0,0
2019-03-11 00:15,1,0,1,0,0,0
2019-03-11 00:30,2,0,2,0,0,0
2019-03-11 00:45,3,2,1,0,0,0
2019-03-11 01:00,4,2,2,0,0,0
2019-03-11 01:15,4,1,3,0,0,0
2019-03-11 01:30,1,1,0,0,0,0
2019-03-11 01:45,1,0,1,0,0,0
2019-03-11 02:00,4,1,3,0,0,0
2019-03-11 02:15,5,2,3,0,0,0
2019-03-11 02:30,0,0,0,0,0,0
2019-03-11 02:45,0,0,0,0,0,0
2019-03-11 03:00,0,0,0,0,0,0
2019-03-11 03:15,0,0,0,0,0,0
2019-03-11 03:30,1,1,0,0,0,0
2019-03-11 03:45,0,0,0,0,0,0
2019-03-11 04:00,0,0,0,0,0,0
2019-03-11 04:15,0,0,0,0,0,0
2019-03-11 04:30,2,1,1,0,0,0
2019-03-11 04:45,4,1,3,0,0,0
2019-03-11 05:00,7,6,1,0,0,0
2019-03-11 05:15,9,6,3,0,0,0
2019-03-11 05:30,23,11,12,0,0,0
2019-03-11 05:45,15,10,5,0,0,0
2019-03-11 06:00,12,11,1,0,0,0
2019-03-11 06:15,30,22,8,0,0,0
2019-03-11 06:30,52,32,20,0,0,0
2019-03-11 06:45,58,42,16,0,0,0
2019-03-11 07:00,66,43,23,0,0,0
2019-03-11 07:15,100,73,27,0,0,0
2019-03-11 07:30,187,127,60,0,0,0
2019-03-11 07:45,235,160,75,0,0,0
2019-03-11 08:00,188,111,77,0,0,0
2019-03-11 08:15,153,102,51,0,0,0
2019-03-11 08:30,138,75,63,0,0,0
2019-03-11 08:45,156,105,51,0,0,0
2019-03-11 09:00,141,101,40,0,0,0
2019-03-11 09:15,98,64,34,0,0,0
2019-03-11 09:30,96,49,47,0,0,0
2019-03-11 09:45,111,64,47,0,0,0
2019-03-11 10:00,72,43,29,0,0,0
2019-03-11 10:15,63,47,16,0,0,0
2019-03-11 10:30,66,47,19,0,0,0
2019-03-11 10:45,61,41,20,0,0,0
2019-03-11 11:00,78,45,33,0,0,0
2019-03-11 11:15,82,33,49,0,0,0
2019-03-11 11:30,88,51,37,0,0,0
2019-03-11 11:45,93,54,39,0,0,0
2019-03-11 12:00,77,40,37,0,0,0
2019-03-11 12:15,98,61,37,0,0,0
2019-03-11 12:30,129,66,63,0,0,0
2019-03-11 12:45,118,70,48,0,0,0
2019-03-11 13:00,114,57,57,0,0,0
2019-03-11 13:15,83,45,38,0,0,0
2019-03-11 13:30,87,45,42,0,0,0
2019-03-11 13:45,146,79,67,0,0,0
2019-03-11 14:00,123,53,70,0,0,0
2019-03-11 14:15,88,53,35,0,0,0
2019-03-11 14:30,94,44,50,0,0,0
2019-03-11 14:45,124,61,63,0,0,0
2019-03-11 15:00,120,64,56,0,0,0
2019-03-11 15:15,113,47,66,0,0,0
2019-03-11 15:30,144,58,86,0,0,0
2019-03-11 15:45,133,60,73,0,0,0
2019-03-11 16:00,138,63,75,0,0,0
2019-03-11 16:15,121,58,63,0,0,0
2019-03-11 16:30,133,62,71,0,0,0
2019-03-11 16:45,149,87,62,0,0,0
2019-03-11 17:00,146,70,76,0,0,0
2019-03-11 17:15,159,62,97,0,0,0
2019-03-11 17:30,146,55,91,0,0,0
2019-03-11 17:45,159,93,66,0,0,0
2019-03-11 18:00,142,54,88,0,0,0
2019-03-11 18:15,137,57,80,0,0,0
2019-03-11 18:30,122,56,66,0,0,0
2019-03-11 18:45,130,68,62,0,0,0
2019-03-11 19:00,117,51,66,0,0,0
2019-03-11 19:15,124,58,66,0,0,0
2019-03-11 19:30,100,60,40,0,0,0
2019-03-11 19:45,101,47,54,0,0,0
2019-03-11 20:00,90,36,54,0,0,0
2019-03-11 20:15,78,24,54,0,0,0
2019-03-11 20:30,68,17,51,0,0,0
2019-03-11 20:45,51,29,22,0,0,0
2019-03-11 21:00,39,19,20,0,0,0
2019-03-11 21:15,37,15,22,0,0,0
2019-03-11 21:30,54,22,32,0,0,0
2019-03-11 21:45,48,12,36,0,0,0
2019-03-11 22:00,44,18,26,0,0,0
2019-03-11 22:15,48,17,31,0,0,0
2019-03-11 22:30,43,6,37,0,0,0
2019-03-11 22:45,20,3,17,0,0,0
2019-03-11 23:00,26,8,18,0,0,0
2019-03-11 23:15,19,9,10,0,0,0
2019-03-11 23:30,24,10,14,0,0,0
2019-03-11 23:45,9,6,3,0,0,0
2019-03-12 00:00,6,2,4,0,0,0
2019-03-12 00:15,6,3,3,0,0,0
2019-03-12 00:30,3,2,1,0,0,0
2019-03-12 00:45,7,3,4,0,0,0
2019-03-12 01:00,4,2,2,0,0,0
2019-03-12 01:15,5,3,2,0,0,0
2019-03-12 01:30,6,2,4,0,0,0
2019-03-12 01:45,5,3,2,0,0,0
2019-03-12 02:00,5,2,3,0,0,0
2019-03-12 02:15,1,0,1,0,0,0
2019-03-12 02:30,3,2,1,0,0,0
2019-03-12 02:45,1,0,1,0,0,0
2019-03-12 03:00,0,0,0,0,0,0
2019-03-12 03:15,0,0,0,0,0,0
2019-03-12 03:30,6,2,4,0,0,0
2019-03-12 03:45,0,0,0,0,0,0
2019-03-12 04:00,0,0,0,0,0,0
2019-03-12 04:15,1,0,1,0,0,0
2019-03-12 04:30,3,3,0,0,0,0
2019-03-12 04:45,9,4,5,0,0,0
2019-03-12 05:00,10,6,4,0,0,0
2019-03-12 05:15,15,7,8,0,0,0
2019-03-12 05:30,21,13,8,0,0,0
2019-03-12 05:45,12,9,3,0,0,0
2019-03-12 06:00,16,12,4,0,0,0
2019-03-12 06:15,36,27,9,0,0,0
2019-03-12 06:30,58,38,20,0,0,0
2019-03-12 06:45,81,58,23,0,0,0
2019-03-12 07:00,96,58,38,0,0,0
2019-03-12 07:15,140,89,51,0,0,0
2019-03-12 07:30,215,148,67,0,0,0
2019-03-12 07:45,273,175,98,0,0,0
2019-03-12 08:00,221,119,102,0,0,0
2019-03-12 08:15,176,112,64,0,0,0
2019-03-12 08:30,188,108,80,0,0,0
2019-03-12 08:45,197,137,60,0,0,0
2019-03-12 09:00,154,109,45,0,0,0
2019-03-12 09:15,127,79,48,0,0,0
2019-03-12 09:30,131,76,55,0,0,0
2019-03-12 09:45,163,100,63,0,0,0
2019-03-12 10:00,102,71,31,0,0,0
2019-03-12 10:15,97,66,31,0,0,0
2019-03-12 10:30,100,54,46,0,0,0
2019-03-12 10:45,108,62,46,0,0,0
2019-03-12 11:00,91,54,37,0,0,0
2019-03-12 11:15,104,55,49,0,0,0
2019-03-12 11:30,102,63,39,0,0,0
2019-03-12 11:45,120,72,48,0,0,0
2019-03-12 12:00,115,64,51,0,0,0
2019-03-12 12:15,148,91,57,0,0,0
2019-03-12 12:30,147,77,70,0,0,0
2019-03-12 12:45,155,92,63,0,0,0
2019-03-12 13:00,158,64,94,0,0,0
2019-03-12 13:15,147,74,73,0,0,0
2019-03-12 13:30,132,66,66,0,0,0
2019-03-12 13:45,160,88,72,0,0,0
2019-03-12 14:00,173,90,83,0,0,0
2019-03-12 14:15,147,80,67,0,0,0
2019-03-12 14:30,172,88,84,0,0,0
2019-03-12 14:45,169,84,85,0,0,0
2019-03-12 15:00,141,61,80,0,0,0
2019-03-12 15:15,147,68,79,0,0,0
2019-03-12 15:30,192,65,127,0,0,0
2019-03-12 15:45,197,118,79,0,0,0
2019-03-12 16:00,210,115,95,0,0,0
2019-03-12 16:15,205,110,95,0,0,0
2019-03-12 16:30,214,110,104,0,0,0
2019-03-12 16:45,217,104,113,0,0,0
2019-03-12 17:00,213,93,120,0,0,0
2019-03-12 17:15,183,86,97,0,0,0
2019-03-12 17:30,208,89,119,0,0,0
2019-03-12 17:45,259,129,130,0,0,0
2019-03-12 18:00,227,114,113,0,0,0
2019-03-12 18:15,185,102,83,0,0,0
2019-03-12 18:30,198,83,115,0,0,0
2019-03-12 18:45,135,66,69,0,0,0
2019-03-12 19:00,134,58,76,0,0,0
2019-03-12 19:15,167,72,95,0,0,0
2019-03-12 19:30,141,62,79,0,0,0
2019-03-12 19:45,131,63,68,0,0,0
2019-03-12 20:00,121,55,66,0,0,0
2019-03-12 20:15,91,39,52,0,0,0
2019-03-12 20:30,68,30,38,0,0,0
2019-03-12 20:45,62,27,35,0,0,0
2019-03-12 21:00,106,47,59,0,0,0
2019-03-12 21:15,86,21,65,0,0,0
2019-03-12 21:30,60,26,34,0,0,0
2019-03-12 21:45,71,22,49,0,0,0
2019-03-12 22:00,47,16,31,0,0,0
2019-03-12 22:15,53,23,30,0,0,0
2019-03-12 22:30,60,23,37,0,0,0
2019-03-12 22:45,48,11,37,0,0,0
2019-03-12 23:00,45,16,29,0,0,0
2019-03-12 23:15,40,14,26,0,0,0
2019-03-12 23:30,31,10,21,0,0,0
2019-03-12 23:45,25,6,19,0,0,0
2019-03-13 00:00,10,4,6,0,0,0
2019-03-13 00:15,16,5,11,0,0,0
2019-03-13 00:30,3,2,1,0,0,0
2019-03-13 00:45,7,0,7,0,0,0
2019-03-13 01:00,9,0,9,0,0,0
2019-03-13 01:15,6,2,4,0,0,0
2019-03-13 01:30,9,3,6,0,0,0
2019-03-13 01:45,3,2,1,0,0,0
2019-03-13 02:00,6,2,4,0,0,0
2019-03-13 02:15,4,0,4,0,0,0
2019-03-13 02:30,1,1,0,0,0,0
2019-03-13 02:45,5,2,3,0,0,0
2019-03-13 03:00,3,2,1,0,0,0
2019-03-13 03:15,1,1,0,0,0,0
2019-03-13 03:30,5,0,5,0,0,0
2019-03-13 03:45,2,2,0,0,0,0
2019-03-13 04:00,1,0,1,0,0,0
2019-03-13 04:15,2,1,1,0,0,0
2019-03-13 04:30,6,5,1,0,0,0
2019-03-13 04:45,7,2,5,0,0,0
2019-03-13 05:00,10,7,3,0,0,0
2019-03-13 05:15,13,9,4,0,0,0
2019-03-13 05:30,19,11,8,0,0,0
2019-03-13 05:45,12,8,4,0,0,0
2019-03-13 06:00,20,17,3,0,0,0
2019-03-13 06:15,34,27,7,0,0,0
2019-03-13 06:30,45,32,13,0,0,0
2019-03-13 06:45,77,58,19,0,0,0
2019-03-13 07:00,77,45,32,0,0,0
2019-03-13 07:15,114,82,32,0,0,0
2019-03-13 07:30,222,152,70,0,0,0
2019-03-13 07:45,244,151,93,0,0,0
2019-03-13 08:00,215,117,98,0,0,0
2019-03-13 08:15,156,105,51,0,0,0
2019-03-13 08:30,147,93,54,0,0,0
2019-03-13 08:45,159,84,75,0,0,0
2019-03-13 09:00,145,103,42,0,0,0
2019-03-13 09:15,107,75,32,0,0,0
2019-03-13 09:30,114,74,40,0,0,0
2019-03-13 09:45,154,94,60,0,0,0
2019-03-13 10:00,101,59,42,0,0,0
2019-03-13 10:15,87,55,32,0,0,0
2019-03-13 10:30,91,66,25,0,0,0
2019-03-13 10:45,118,83,35,0,0,0
2019-03-13 11:00,71,39,32,0,0,0
2019-03-13 11:15,94,49,45,0,0,0
2019-03-13 11:30,77,41,36,0,0,0
2019-03-13 11:45,107,70,37,0,0,0
2019-03-13 12:00,121,56,65,0,0,0
2019-03-13 12:15,117,65,52,0,0,0
2019-03-13 12:30,139,66,73,0,0,0
2019-03-13 12:45,128,75,53,0,0,0
2019-03-13 13:00,106,47,59,0,0,0
2019-03-13 13:15,104,55,49,0,0,0
2019-03-13 13:30,81,37,44,0,0,0
2019-03-13 13:45,131,84,47,0,0,0
2019-03-13 14:00,126,58,68,0,0,0
2019-03-13 14:15,103,50,53,0,0,0
2019-03-13 14:30,95,40,55,0,0,0
2019-03-13 14:45,92,38,54,0,0,0
2019-03-13 15:00,95,32,63,0,0,0
2019-03-13 15:15,79,40,39,0,0,0
2019-03-13 15:30,154,58,96,0,0,0
2019-03-13 15:45,140,60,80,0,0,0
2019-03-13 16:00,165,86,79,0,0,0
2019-03-13 16:15,145,74,71,0,0,0
2019-03-13 16:30,123,56,67,0,0,0
2019-03-13 16:45,151,85,66,0,0,0
2019-03-13 17:00,148,68,80,0,0,0
2019-03-13 17:15,172,81,91,0,0,0
2019-03-13 17:30,174,74,100,0,0,0
2019-03-13 17:45,157,79,78,0,0,0
2019-03-13 18:00,170,89,81,0,0,0
2019-03-13 18:15,169,89,80,0,0,0
2019-03-13 18:30,147,75,72,0,0,0
2019-03-13 18:45,162,99,63,0,0,0
2019-03-13 19:00,133,60,73,0,0,0
2019-03-13 19:15,126,62,64,0,0,0
2019-03-13 19:30,130,62,68,0,0,0
2019-03-13 19:45,125,58,67,0,0,0
2019-03-13 20:00,131,61,70,0,0,0
2019-03-13 20:15,116,50,66,0,0,0
2019-03-13 20:30,106,46,60,0,0,0
2019-03-13 20:45,78,31,47,0,0,0
2019-03-13 21:00,65,36,29,0,0,0
2019-03-13 21:15,60,27,33,0,0,0
2019-03-13 21:30,59,17,42,0,0,0
2019-03-13 21:45,64,25,39,0,0,0
2019-03-13 22:00,61,28,33,0,0,0
2019-03-13 22:15,45,27,18,0,0,0
2019-03-13 22:30,54,20,34,0,0,0
2019-03-13 22:45,66,23,43,0,0,0
2019-03-13 23:00,86,47,39,0,0,0
2019-03-13 23:15,74,39,35,0,0,0
2019-03-13 23:30,37,15,22,0,0,0
2019-03-13 23:45,33,13,20,0,0,0
2019-03-14 00:00,30,16,14,0,0,0
2019-03-14 00:15,18,6,12,0,0,0
2019-03-14 00:30,19,9,10,0,0,0
2019-03-14 00:45,17,9,8,0,0,0
2019-03-14 01:00,18,6,12,0,0,0
2019-03-14 01:15,13,2,11,0,0,0
2019-03-14 01:30,13,3,10,0,0,0
2019-03-14 01:45,16,1,15,0,0,0
2019-03-14 02:00,21,1,20,0,0,0
2019-03-14 02:15,14,3,11,0,0,0
2019-03-14 02:30,8,0,8,0,0,0
2019-03-14 02:45,5,1,4,0,0,0
2019-03-14 03:00,11,2,9,0,0,0
2019-03-14 03:15,8,0,8,0,0,0
2019-03-14 03:30,17,1,16,0,0,0
2019-03-14 03:45,6,1,5,0,0,0
2019-03-14 04:00,3,0,3,0,0,0
2019-03-14 04:15,5,0,5,0,0,0
2019-03-14 04:30,6,4,2,0,0,0
2019-03-14 04:45,8,4,4,0,0,0
2019-03-14 05:00,12,8,4,0,0,0
2019-03-14 05:15,14,8,6,0,0,0
2019-03-14 05:30,23,13,10,0,0,0
2019-03-14 05:45,18,14,4,0,0,0
2019-03-14 06:00,16,13,3,0,0,0
2019-03-14 06:15,30,26,4,0,0,0
2019-03-14 06:30,45,33,12,0,0,0
2019-03-14 06:45,59,44,15,0,0,0
2019-03-14 07:00,74,47,27,0,0,0
2019-03-14 07:15,129,86,43,0,0,0
2019-03-14 07:30,170,125,45,0,0,0
2019-03-14 07:45,220,147,73,0,0,0
2019-03-14 08:00,190,99,91,0,0,0
2019-03-14 08:15,147,102,45,0,0,0
2019-03-14 08:30,139,80,59,0,0,0
2019-03-14 08:45,160,95,65,0,0,0
2019-03-14 09:00,126,90,36,0,0,0
2019-03-14 09:15,98,68,30,0,0,0
2019-03-14 09:30,104,65,39,0,0,0
2019-03-14 09:45,109,69,40,0,0,0
2019-03-14 10:00,72,49,23,0,0,0
2019-03-14 10:15,66,36,30,0,0,0
2019-03-14 10:30,64,33,31,0,0,0
2019-03-14 10:45,92,57,35,0,0,0
2019-03-14 11:00,63,30,33,0,0,0
2019-03-14 11:15,61,38,23,0,0,0
2019-03-14 11:30,64,34,30,0,0,0
2019-03-14 11:45,82,48,34,0,0,0
2019-03-14 12:00,88,42,46,0,0,0
2019-03-14 12:15,83,53,30,0,0,0
2019-03-14 12:30,97,46,51,0,0,0
2019-03-14 12:45,84,45,39,0,0,0
2019-03-14 13:00,86,48,38,0,0,0
2019-03-14 13:15,70,30,40,0,0,0
2019-03-14 13:30,91,46,45,0,0,0
2019-03-14 13:45,107,59,48,0,0,0
2019-03-14 14:00,90,30,60,0,0,0
2019-03-14 14:15,87,33,54,0,0,0
2019-03-14 14:30,77,38,39,0,0,0
2019-03-14 14:45,106,41,65,0,0,0
2019-03-14 15:00,100,44,56,0,0,0
2019-03-14 15:15,89,45,44,0,0,0
2019-03-14 15:30,154,58,96,0,0,0
2019-03-14 15:45,168,77,91,0,0,0
2019-03-14 16:00,171,91,80,0,0,0
2019-03-14 16:15,133,65,68,0,0,0
2019-03-14 16:30,128,68,60,0,0,0
2019-03-14 16:45,155,83,72,0,0,0
2019-03-14 17:00,168,88,80,0,0,0
2019-03-14 17:15,168,91,77,0,0,0
2019-03-14 17:30,162,75,87,0,0,0
2019-03-14 17:45,179,93,86,0,0,0
2019-03-14 18:00,152,73,79,0,0,0
2019-03-14 18:15,144,77,67,0,0,0
2019-03-14 18:30,163,73,90,0,0,0
2019-03-14 18:45,152,73,79,0,0,0
2019-03-14 19:00,130,62,68,0,0,0
2019-03-14 19:15,121,69,52,0,0,0
2019-03-14 19:30,126,43,83,0,0,0
2019-03-14 19:45,113,65,48,0,0,0
2019-03-14 20:00,107,54,53,0,0,0
2019-03-14 20:15,99,48,51,0,0,0
2019-03-14 20:30,79,35,44,0,0,0
2019-03-14 20:45,76,34,42,0,0,0
2019-03-14 21:00,53,24,29,0,0,0
2019-03-14 21:15,58,28,30,0,0,0
2019-03-14 21:30,55,22,33,0,0,0
2019-03-14 21:45,58,14,44,0,0,0
2019-03-14 22:00,68,22,46,0,0,0
2019-03-14 22:15,75,41,34,0,0,0
2019-03-14 22:30,66,25,41,0,0,0
2019-03-14 22:45,66,23,43,0,0,0
2019-03-14 23:00,36,11,25,0,0,0
2019-03-14 23:15,38,18,20,0,0,0
2019-03-14 23:30,36,12,24,0,0,0
2019-03-14 23:45,21,7,14,0,0,0
2019-03-15 00:00,12,3,9,0,0,0
2019-03-15 00:15,19,3,16,0,0,0
2019-03-15 00:30,9,3,6,0,0,0
2019-03-15 00:45,16,7,9,0,0,0
2019-03-15 01:00,12,6,6,0,0,0
2019-03-15 01:15,4,0,4,0,0,0
2019-03-15 01:30,17,5,12,0,0,0
2019-03-15 01:45,7,4,3,0,0,0
2019-03-15 02:00,7,1,6,0,0,0
2019-03-15 02:15,5,0,5,0,0,0
2019-03-15 02:30,3,0,3,0,0,0
2019-03-15 02:45,4,1,3,0,0,0
2019-03-15 03:00,6,3,3,0,0,0
2019-03-15 03:15,3,0,3,0,0,0
2019-03-15 03:30,3,2,1,0,0,0
2019-03-15 03:45,8,1,7,0,0,0
2019-03-15 04:00,4,3,1,0,0,0
2019-03-15 04:15,1,0,1,0,0,0
2019-03-15 04:30,2,1,1,0,0,0
2019-03-15 04:45,5,0,5,0,0,0
2019-03-15 05:00,10,6,4,0,0,0
2019-03-15 05:15,13,11,2,0,0,0
2019-03-15 05:30,17,9,8,0,0,0
2019-03-15 05:45,12,9,3,0,0,0
2019-03-15 06:00,13,10,3,0,0,0
2019-03-15 06:15,24,16,8,0,0,0
2019-03-15 06:30,38,22,16,0,0,0
2019-03-15 06:45,60,40,20,0,0,0
2019-03-15 07:00,68,52,16,0,0,0
2019-03-15 07:15,105,68,37,0,0,0
2019-03-15 07:30,200,155,45,0,0,0
2019-03-15 07:45,211,156,55,0,0,0
2019-03-15 08:00,160,94,66,0,0,0
2019-03-15 08:15,150,95,55,0,0,0
2019-03-15 08:30,177,87,90,0,0,0
2019-03-15 08:45,190,124,66,0,0,0
2019-03-15 09:00,127,96,31,0,0,0
2019-03-15 09:15,115,74,41,0,0,0
2019-03-15 09:30,106,66,40,0,0,0
2019-03-15 09:45,149,104,45,0,0,0
2019-03-15 10:00,113,81,32,0,0,0
2019-03-15 10:15,92,57,35,0,0,0
2019-03-15 10:30,98,62,36,0,0,0
2019-03-15 10:45,119,77,42,0,0,0
2019-03-15 11:00,92,52,40,0,0,0
2019-03-15 11:15,88,35,53,0,0,0
2019-03-15 11:30,88,47,41,0,0,0
2019-03-15 11:45,110,63,47,0,0,0
2019-03-15 12:00,132,70,62,0,0,0
2019-03-15 12:15,126,61,65,0,0,0
2019-03-15 12:30,107,52,55,0,0,0
2019-03-15 12:45,153,86,67,0,0,0
2019-03-15 13:00,178,70,108,0,0,0
2019-03-15 13:15,118,61,57,0,0,0
2019-03-15 13:30,147,65,82,0,0,0
2019-03-15 13:45,148,74,74,0,0,0
2019-03-15 14:00,123,61,62,0,0,0
2019-03-15 14:15,120,50,70,0,0,0
2019-03-15 14:30,138,83,55,0,0,0
2019-03-15 14:45,111,51,60,0,0,0
2019-03-15 15:00,116,62,54,0,0,0
2019-03-15 15:15,100,42,58,0,0,0
2019-03-15 15:30,78,40,38,0,0,0
2019-03-15 15:45,83,38,45,0,0,0
2019-03-15 16:00,86,38,48,0,0,0
2019-03-15 16:15,121,51,70,0,0,0
2019-03-15 16:30,132,62,70,0,0,0
2019-03-15 16:45,105,51,54,0,0,0
2019-03-15 17:00,122,68,54,0,0,0
2019-03-15 17:15,138,72,66,0,0,0
2019-03-15 17:30,126,54,72,0,0,0
2019-03-15 17:45,145,70,75,0,0,0
2019-03-15 18:00,108,61,47,0,0,0
2019-03-15 18:15,99,49,50,0,0,0
2019-03-15 18:30,122,52,70,0,0,0
2019-03-15 18:45,133,66,67,0,0,0
2019-03-15 19:00,116,62,54,0,0,0
2019-03-15 19:15,124,57,67,0,0,0
2019-03-15 19:30,119,70,49,0,0,0
2019-03-15 19:45,121,47,74,0,0,0
2019-03-15 20:00,106,70,36,0,0,0
2019-03-15 20:15,89,48,41,0,0,0
2019-03-15 20:30,78,47,31,0,0,0
2019-03-15 20:45,70,35,35,0,0,0
2019-03-15 21:00,70,35,35,0,0,0
2019-03-15 21:15,55,31,24,0,0,0
2019-03-15 21:30,46,16,30,0,0,0
2019-03-15 21:45,44,17,27,0,0,0
2019-03-15 22:00,48,30,18,0,0,0
2019-03-15 22:15,35,13,22,0,0,0
2019-03-15 22:30,51,30,21,0,0,0
2019-03-15 22:45,51,26,25,0,0,0
2019-03-15 23:00,47,18,29,0,0,0
2019-03-15 23:15,40,19,21,0,0,0
2019-03-15 23:30,49,20,29,0,0,0
2019-03-15 23:45,62,24,38,0,0,0
2019-03-16 00:00,49,23,26,0,0,0
2019-03-16 00:15,54,25,29,0,0,0
2019-03-16 00:30,52,25,27,0,0,0
2019-03-16 00:45,37,12,25,0,0,0
2019-03-16 01:00,35,9,26,0,0,0
2019-03-16 01:15,24,6,18,0,0,0
2019-03-16 01:30,41,9,32,0,0,0
2019-03-16 01:45,22,3,19,0,0,0
2019-03-16 02:00,23,8,15,0,0,0
2019-03-16 02:15,17,4,13,0,0,0
2019-03-16 02:30,28,7,21,0,0,0
2019-03-16 02:45,21,1,20,0,0,0
2019-03-16 03:00,15,5,10,0,0,0
2019-03-16 03:15,19,6,13,0,0,0
2019-03-16 03:30,15,3,12,0,0,0
2019-03-16 03:45,26,4,22,0,0,0
2019-03-16 04:00,23,5,18,0,0,0
2019-03-16 04:15,8,2,6,0,0,0
2019-03-16 04:30,13,3,10,0,0,0
2019-03-16 04:45,4,1,3,0,0,0
2019-03-16 05:00,12,2,10,0,0,0
2019-03-16 05:15,7,4,3,0,0,0
2019-03-16 05:30,10,4,6,0,0,0
2019-03-16 05:45,13,8,5,0,0,0
2019-03-16 06:00,8,5,3,0,0,0
2019-03-16 06:15,6,3,3,0,0,0
2019-03-16 06:30,9,6,3,0,0,0
2019-03-16 06:45,7,5,2,0,0,0
2019-03-16 07:00,11,6,5,0,0,0
2019-03-16 07:15,10,6,4,0,0,0
2019-03-16 07:30,21,16,5,0,0,0
2019-03-16 07:45,32,25,7,0,0,0
2019-03-16 08:00,14,12,2,0,0,0
2019-03-16 08:15,34,25,9,0,0,0
2019-03-16 08:30,41,22,19,0,0,0
2019-03-16 08:45,47,38,9,0,0,0
2019-03-16 09:00,41,35,6,0,0,0
2019-03-16 09:15,35,22,13,0,0,0
2019-03-16 09:30,53,39,14,0,0,0
2019-03-16 09:45,82,62,20,0,0,0
2019-03-16 10:00,79,61,18,0,0,0
2019-03-16 10:15,52,38,14,0,0,0
2019-03-16 10:30,43,32,11,0,0,0
2019-03-16 10:45,70,42,28,0,0,0
2019-03-16 11:00,55,40,15,0,0,0
2019-03-16 11:15,49,30,19,0,0,0
2019-03-16 11:30,67,48,19,0,0,0
2019-03-16 11:45,75,49,26,0,0,0
2019-03-16 12:00,58,30,28,0,0,0
2019-03-16 12:15,62,34,28,0,0,0
2019-03-16 12:30,72,44,28,0,0,0
2019-03-16 12:45,73,42,31,0,0,0
2019-03-16 13:00,84,52,32,0,0,0
2019-03-16 13:15,86,57,29,0,0,0
2019-03-16 13:30,72,38,34,0,0,0
2019-03-16 13:45,103,71,32,0,0,0
2019-03-16 14:00,102,56,46,0,0,0
2019-03-16 14:15,77,39,38,0,0,0
2019-03-16 14:30,76,35,41,0,0,0
2019-03-16 14:45,117,57,60,0,0,0
2019-03-16 15:00,73,28,45,0,0,0
2019-03-16 15:15,83,32,51,0,0,0
2019-03-16 15:30,74,39,35,0,0,0
2019-03-16 15:45,89,46,43,0,0,0
2019-03-16 16:00,91,39,52,0,0,0
2019-03-16 16:15,81,25,56,0,0,0
2019-03-16 16:30,89,47,42,0,0,0
2019-03-16 16:45,90,45,45,0,0,0
2019-03-16 17:00,83,31,52,0,0,0
2019-03-16 17:15,90,36,54,0,0,0
2019-03-16 17:30,106,34,72,0,0,0
2019-03-16 17:45,115,60,55,0,0,0
2019-03-16 18:00,76,28,48,0,0,0
2019-03-16 18:15,84,44,40,0,0,0
2019-03-16 18:30,73,37,36,0,0,0
2019-03-16 18:45,94,46,48,0,0,0
2019-03-16 19:00,97,42,55,0,0,0
2019-03-16 19:15,87,55,32,0,0,0
2019-03-16 19:30,72,37,35,0,0,0
2019-03-16 19:45,100,45,55,0,0,0
2019-03-16 20:00,77,34,43,0,0,0
2019-03-16 20:15,77,41,36,0,0,0
2019-03-16 20:30,55,25,30,0,0,0
2019-03-16 20:45,59,33,26,0,0,0
2019-03-16 21:00,49,23,26,0,0,0
2019-03-16 21:15,44,21,23,0,0,0
2019-03-16 21:30,52,26,26,0,0,0
2019-03-16 21:45,42,23,19,0,0,0
2019-03-16 22:00,32,18,14,0,0,0
2019-03-16 22:15,50,34,16,0,0,0
2019-03-16 22:30,48,23,25,0,0,0
2019-03-16 22:45,50,21,29,0,0,0
2019-03-16 23:00,43,9,34,0,0,0
2019-03-16 23:15,37,14,23,0,0,0
2019-03-16 23:30,71,44,27,0,0,0
2019-03-16 23:45,41,23,18,0,0,0
2019-03-17 00:00,60,21,39,0,0,0
2019-03-17 00:15,39,14,25,0,0,0
2019-03-17 00:30,35,17,18,0,0,0
2019-03-17 00:45,30,11,19,0,0,0
2019-03-17 01:00,24,10,14,0,0,0
2019-03-17 01:15,39,15,24,0,0,0
2019-03-17 01:30,31,14,17,0,0,0
2019-03-17 01:45,25,5,20,0,0,0
2019-03-17 02:00,25,10,15,0,0,0
2019-03-17 02:15,20,4,16,0,0,0
2019-03-17 02:30,22,7,15,0,0,0
2019-03-17 02:45,22,7,15,0,0,0
2019-03-17 03:00,22,9,13,0,0,0
2019-03-17 03:15,15,2,13,0,0,0
2019-03-17 03:30,28,6,22,0,0,0
2019-03-17 03:45,25,2,23,0,0,0
2019-03-17 04:00,17,4,13,0,0,0
2019-03-17 04:15,3,0,3,0,0,0
2019-03-17 04:30,14,3,11,0,0,0
2019-03-17 04:45,13,1,12,0,0,0
2019-03-17 05:00,10,2,8,0,0,0
2019-03-17 05:15,7,2,5,0,0,0
2019-03-17 05:30,17,3,14,0,0,0
2019-03-17 05:45,9,4,5,0,0,0
2019-03-17 06:00,6,4,2,0,0,0
2019-03-17 06:15,5,2,3,0,0,0
2019-03-17 06:30,11,4,7,0,0,0
2019-03-17 06:45,7,2,5,0,0,0
2019-03-17 07:00,3,1,2,0,0,0
2019-03-17 07:15,10,7,3,0,0,0
2019-03-17 07:30,8,6,2,0,0,0
2019-03-17 07:45,4,2,2,0,0,0
2019-03-17 08:00,8,6,2,0,0,0
2019-03-17 08:15,9,7,2,0,0,0
2019-03-17 08:30,16,13,3,0,0,0
2019-03-17 08:45,16,9,7,0,0,0
2019-03-17 09:00,13,7,6,0,0,0
2019-03-17 09:15,18,11,7,0,0,0
2019-03-17 09:30,24,17,7,0,0,0
2019-03-17 09:45,52,42,10,0,0,0
2019-03-17 10:00,59,47,12,0,0,0
2019-03-17 10:15,45,35,10,0,0,0
2019-03-17 10:30,43,28,15,0,0,0
2019-03-17 10:45,55,37,18,0,0,0
2019-03-17 11:00,34,21,13,0,0,0
2019-03-17 11:15,41,31,10,0,0,0
2019-03-17 11:30,48,32,16,0,0,0
2019-03-17 11:45,54,35,19,0,0,0
2019-03-17 12:00,54,28,26,0,0,0
2019-03-17 12:15,59,36,23,0,0,0
2019-03-17 12:30,59,28,31,0,0,0
2019-03-17 12:45,59,39,20,0,0,0
2019-03-17 13:00,56,19,37,0,0,0
2019-03-17 13:15,55,21,34,0,0,0
2019-03-17 13:30,69,49,20,0,0,0
2019-03-17 13:45,72,36,36,0,0,0
2019-03-17 14:00,59,35,24,0,0,0
2019-03-17 14:15,61,34,27,0,0,0
2019-03-17 14:30,46,18,28,0,0,0
2019-03-17 14:45,76,52,24,0,0,0
2019-03-17 15:00,62,35,27,0,0,0
2019-03-17 15:15,80,40,40,0,0,0
2019-03-17 15:30,77,38,39,0,0,0
2019-03-17 15:45,67,46,21,0,0,0
2019-03-17 16:00,55,32,23,0,0,0
2019-03-17 16:15,58,32,26,0,0,0
2019-03-17 16:30,85,41,44,0,0,0
2019-03-17 16:45,82,45,37,0,0,0
2019-03-17 17:00,44,16,28,0,0,0
2019-03-17 17:15,73,26,47,0,0,0
2019-03-17 17:30,71,31,40,0,0,0
2019-03-17 17:45,78,43,35,0,0,0
2019-03-17 18:00,66,26,40,0,0,0
2019-03-17 18:15,84,45,39,0,0,0
2019-03-17 18:30,74,31,43,0,0,0
2019-03-17 18:45,81,50,31,0,0,0
2019-03-17 19:00,37,19,18,0,0,0
2019-03-17 19:15,76,46,30,0,0,0
2019-03-17 19:30,68,26,42,0,0,0
2019-03-17 19:45,85,29,56,0,0,0
2019-03-17 20:00,74,33,41,0,0,0
2019-03-17 20:15,48,20,28,0,0,0
2019-03-17 20:30,32,12,20,0,0,0
2019-03-17 20:45,38,20,18,0,0,0
2019-03-17 21:00,34,16,18,0,0,0
2019-03-17 21:15,39,8,31,0,0,0
2019-03-17 21:30,15,5,10,0,0,0
2019-03-17 21:45,30,15,15,0,0,0
2019-03-17 22:00,30,12,18,0,0,0
2019-03-17 22:15,41,12,29,0,0,0
2019-03-17 22:30,20,8,12,0,0,0
2019-03-17 22:45,31,10,21,0,0,0
2019-03-17 23:00,20,9,11,0,0,0
2019-03-17 23:15,15,6,9,0,0,0
2019-03-17 23:30,8,3,5,0,0,0
2019-03-17 23:45,13,5,8,0,0,0
2019-03-18 00:00,12,9,3,0,0,0
2019-03-18 00:15,12,4,8,0,0,0
2019-03-18 00:30,6,2,4,0,0,0
2019-03-18 00:45,5,3,2,0,0,0
2019-03-18 01:00,6,4,2,0,0,0
2019-03-18 01:15,7,4,3,0,0,0
2019-03-18 01:30,1,1,0,0,0,0
2019-03-18 01:45,1,0,1,0,0,0
2019-03-18 02:00,1,1,0,0,0,0
2019-03-18 02:15,3,2,1,0,0,0
2019-03-18 02:30,0,0,0,0,0,0
2019-03-18 02:45,1,1,0,0,0,0
2019-03-18 03:00,0,0,0,0,0,0
2019-03-18 03:15,2,2,0,0,0,0
2019-03-18 03:30,2,1,1,0,0,0
2019-03-18 03:45,0,0,0,0,0,0
2019-03-18 04:00,0,0,0,0,0,0
2019-03-18 04:15,1,1,0,0,0,0
2019-03-18 04:30,3,2,1,0,0,0
2019-03-18 04:45,7,3,4,0,0,0
2019-03-18 05:00,7,4,3,0,0,0
2019-03-18 05:15,8,5,3,0,0,0
2019-03-18 05:30,21,9,12,0,0,0
2019-03-18 05:45,20,14,6,0,0,0
2019-03-18 06:00,21,19,2,0,0,0
2019-03-18 06:15,33,19,14,0,0,0
2019-03-18 06:30,51,37,14,0,0,0
2019-03-18 06:45,58,45,13,0,0,0
2019-03-18 07:00,42,9,33,0,0,0
2019-03-18 07:15,93,64,29,0,0,0
2019-03-18 07:30,251,164,87,0,0,0
2019-03-18 07:45,244,156,88,0,0,0
2019-03-18 08:00,202,121,81,0,0,0
2019-03-18 08:15,176,115,61,0,0,0
2019-03-18 08:30,181,103,78,0,0,0
2019-03-18 08:45,210,142,68,0,0,0
2019-03-18 09:00,178,129,49,0,0,0
2019-03-18 09:15,127,85,42,0,0,0
2019-03-18 09:30,130,84,46,0,0,0
2019-03-18 09:45,159,88,71,0,0,0
2019-03-18 10:00,133,83,50,0,0,0
2019-03-18 10:15,88,57,31,0,0,0
2019-03-18 10:30,107,66,41,0,0,0
2019-03-18 10:45,114,66,48,0,0,0
2019-03-18 11:00,89,44,45,0,0,0
2019-03-18 11:15,114,75,39,0,0,0
2019-03-18 11:30,109,63,46,0,0,0
2019-03-18 11:45,130,76,54,0,0,0
2019-03-18 12:00,127,61,66,0,0,0
2019-03-18 12:15,117,60,57,0,0,0
2019-03-18 12:30,114,55,59,0,0,0
2019-03-18 12:45,147,82,65,0,0,0
2019-03-18 13:00,123,48,75,0,0,0
2019-03-18 13:15,106,50,56,0,0,0
2019-03-18 13:30,143,86,57,0,0,0
2019-03-18 13:45,177,87,90,0,0,0
2019-03-18 14:00,153,69,84,0,0,0
2019-03-18 14:15,143,81,62,0,0,0
2019-03-18 14:30,131,73,58,0,0,0
2019-03-18 14:45,159,80,79,0,0,0
2019-03-18 15:00,168,93,75,0,0,0
2019-03-18 15:15,144,72,72,0,0,0
2019-03-18 15:30,217,103,114,0,0,0
2019-03-18 15:45,206,113,93,0,0,0
2019-03-18 16:00,212,100,112,0,0,0
2019-03-18 16:15,184,87,97,0,0,0
2019-03-18 16:30,210,103,107,0,0,0
2019-03-18 16:45,214,116,98,0,0,0
2019-03-18 17:00,245,122,123,0,0,0
2019-03-18 17:15,236,109,127,0,0,0
2019-03-18 17:30,245,110,135,0,0,0
2019-03-18 17:45,278,157,121,0,0,0
2019-03-18 18:00,237,100,137,0,0,0
2019-03-18 18:15,209,84,125,0,0,0
2019-03-18 18:30,175,89,86,0,0,0
2019-03-18 18:45,176,81,95,0,0,0
2019-03-18 19:00,153,75,78,0,0,0
2019-03-18 19:15,166,67,99,0,0,0
2019-03-18 19:30,136,71,65,0,0,0
2019-03-18 19:45,155,75,80,0,0,0
2019-03-18 20:00,131,54,77,0,0,0
2019-03-18 20:15,90,43,47,0,0,0
2019-03-18 20:30,99,47,52,0,0,0
2019-03-18 20:45,88,49,39,0,0,0
2019-03-18 21:00,77,40,37,0,0,0
2019-03-18 21:15,60,22,38,0,0,0
2019-03-18 21:30,60,26,34,0,0,0
2019-03-18 21:45,80,30,50,0,0,0
2019-03-18 22:00,81,28,53,0,0,0
2019-03-18 22:15,63,26,37,0,0,0
2019-03-18 22:30,39,15,24,0,0,0
2019-03-18 22:45,62,15,47,0,0,0
2019-03-18 23:00,26,8,18,0,0,0
2019-03-18 23:15,36,11,25,0,0,0
2019-03-18 23:30,25,11,14,0,0,0
2019-03-18 23:45,20,10,10,0,0,0
2019-03-19 00:00,15,4,11,0,0,0
2019-03-19 00:15,17,6,11,0,0,0
2019-03-19 00:30,16,9,7,0,0,0
2019-03-19 00:45,9,1,8,0,0,0
2019-03-19 01:00,20,2,18,0,0,0
2019-03-19 01:15,11,3,8,0,0,0
2019-03-19 01:30,6,2,4,0,0,0
2019-03-19 01:45,6,2,4,0,0,0
2019-03-19 02:00,3,2,1,0,0,0
2019-03-19 02:15,6,0,6,0,0,0
2019-03-19 02:30,2,0,2,0,0,0
2019-03-19 02:45,3,2,1,0,0,0
2019-03-19 03:00,2,2,0,0,0,0
2019-03-19 03:15,2,0,2,0,0,0
2019-03-19 03:30,1,1,0,0,0,0
2019-03-19 03:45,6,1,5,0,0,0
2019-03-19 04:00,2,2,0,0,0,0
2019-03-19 04:15,2,2,0,0,0,0
2019-03-19 04:30,6,3,3,0,0,0
2019-03-19 04:45,6,3,3,0,0,0
2019-03-19 05:00,10,7,3,0,0,0
2019-03-19 05:15,13,9,4,0,0,0
2019-03-19 05:30,22,12,10,0,0,0
2019-03-19 05:45,17,12,5,0,0,0
2019-03-19 06:00,26,21,5,0,0,0
2019-03-19 06:15,43,33,10,0,0,0
2019-03-19 06:30,74,48,26,0,0,0
2019-03-19 06:45,89,63,26,0,0,0
2019-03-19 07:00,93,51,42,0,0,0
2019-03-19 07:15,125,81,44,0,0,0
2019-03-19 07:30,243,176,67,0,0,0
2019-03-19 07:45,256,167,89,0,0,0
2019-03-19 08:00,229,129,100,0,0,0
2019-03-19 08:15,189,120,69,0,0,0
2019-03-19 08:30,196,120,76,0,0,0
2019-03-19 08:45,223,150,73,0,0,0
2019-03-19 09:00,143,92,51,0,0,0
2019-03-19 09:15,133,95,38,0,0,0
2019-03-19 09:30,162,99,63,0,0,0
2019-03-19 09:45,170,104,66,0,0,0
2019-03-19 10:00,111,70,41,0,0,0
2019-03-19 10:15,125,87,38,0,0,0
2019-03-19 10:30,111,62,49,0,0,0
2019-03-19 10:45,141,79,62,0,0,0
2019-03-19 11:00,108,58,50,0,0,0
2019-03-19 11:15,102,50,52,0,0,0
2019-03-19 11:30,123,59,64,0,0,0
2019-03-19 11:45,162,93,69,0,0,0
2019-03-19 12:00,159,71,88,0,0,0
2019-03-19 12:15,145,80,65,0,0,0
2019-03-19 12:30,161,85,76,0,0,0
2019-03-19 12:45,148,86,62,0,0,0
2019-03-19 13:00,192,68,124,0,0,0
2019-03-19 13:15,149,70,79,0,0,0
2019-03-19 13:30,142,78,64,0,0,0
2019-03-19 13:45,155,81,74,0,0,0
2019-03-19 14:00,174,75,99,0,0,0
2019-03-19 14:15,157,81,76,0,0,0
2019-03-19 14:30,137,68,69,0,0,0
2019-03-19 14:45,184,92,92,0,0,0
2019-03-19 15:00,166,73,93,0,0,0
2019-03-19 15:15,209,111,98,0,0,0
2019-03-19 15:30,198,84,114,0,0,0
2019-03-19 15:45,228,109,119,0,0,0
2019-03-19 16:00,207,107,100,0,0,0
2019-03-19 16:15,212,103,109,0,0,0
2019-03-19 16:30,230,93,137,0,0,0
2019-03-19 16:45,233,112,121,0,0,0
2019-03-19 17:00,223,107,116,0,0,0
2019-03-19 17:15,191,88,103,0,0,0
2019-03-19 17:30,244,106,138,0,0,0
2019-03-19 17:45,244,108,136,0,0,0
2019-03-19 18:00,246,98,148,0,0,0
2019-03-19 18:15,226,106,120,0,0,0
2019-03-19 18:30,222,101,121,0,0,0
2019-03-19 18:45,225,108,117,0,0,0
2019-03-19 19:00,193,78,115,0,0,0
2019-03-19 19:15,172,93,79,0,0,0
2019-03-19 19:30,179,85,94,0,0,0
2019-03-19 19:45,174,67,107,0,0,0
2019-03-19 20:00,156,83,73,0,0,0
2019-03-19 20:15,114,50,64,0,0,0
2019-03-19 20:30,86,28,58,0,0,0
2019-03-19 20:45,95,38,57,0,0,0
2019-03-19 21:00,79,36,43,0,0,0
2019-03-19 21:15,77,29,48,0,0,0
2019-03-19 21:30,92,32,60,0,0,0
2019-03-19 21:45,95,25,70,0,0,0
2019-03-19 22:00,76,31,45,0,0,0
2019-03-19 22:15,76,28,48,0,0,0
2019-03-19 22:30,57,25,32,0,0,0
2019-03-19 22:45,47,23,24,0,0,0
2019-03-19 23:00,51,17,34,0,0,0
2019-03-19 23:15,40,11,29,0,0,0
2019-03-19 23:30,41,8,33,0,0,0
2019-03-19 23:45,35,11,24,0,0,0
2019-03-20 00:00,22,14,8,0,0,0
2019-03-20 00:15,15,5,10,0,0,0
2019-03-20 00:30,15,1,14,0,0,0
2019-03-20 00:45,18,5,13,0,0,0
2019-03-20 01:00,9,1,8,0,0,0
2019-03-20 01:15,7,2,5,0,0,0
2019-03-20 01:30,10,1,9,0,0,0
2019-03-20 01:45,3,1,2,0,0,0
2019-03-20 02:00,10,6,4,0,0,0
2019-03-20 02:15,2,0,2,0,0,0
2019-03-20 02:30,7,1,6,0,0,0
2019-03-20 02:45,0,0,0,0,0,0
2019-03-20 03:00,2,0,2,0,0,0
2019-03-20 03:15,0,0,0,0,0,0
2019-03-20 03:30,2,2,0,0,0,0
2019-03-20 03:45,3,3,0,0,0,0
2019-03-20 04:00,1,0,1,0,0,0
2019-03-20 04:15,0,0,0,0,0,0
2019-03-20 04:30,4,3,1,0,0,0
2019-03-20 04:45,5,2,3,0,0,0
2019-03-20 05:00,8,5,3,0,0,0
2019-03-20 05:15,9,7,2,0,0,0
2019-03-20 05:30,22,13,9,0,0,0
2019-03-20 05:45,20,17,3,0,0,0
2019-03-20 06:00,22,12,10,0,0,0
2019-03-20 06:15,52,39,13,0,0,0
2019-03-20 06:30,74,47,27,0,0,0
2019-03-20 06:45,93,60,33,0,0,0
2019-03-20 07:00,99,63,36,0,0,0
2019-03-20 07:15,127,86,41,0,0,0
2019-03-20 07:30,261,180,81,0,0,0
2019-03-20 07:45,311,208,103,0,0,0
2019-03-20 08:00,245,125,120,0,0,0
2019-03-20 08:15,206,138,68,0,0,0
2019-03-20 08:30,201,120,81,0,0,0
2019-03-20 08:45,227,153,74,0,0,0
2019-03-20 09:00,167,115,52,0,0,0
2019-03-20 09:15,121,85,36,0,0,0
2019-03-20 09:30,170,102,68,0,0,0
2019-03-20 09:45,176,109,67,0,0,0
2019-03-20 10:00,139,82,57,0,0,0
2019-03-20 10:15,109,76,33,0,0,0
2019-03-20 10:30,122,81,41,0,0,0
2019-03-20 10:45,142,90,52,0,0,0
2019-03-20 11:00,103,68,35,0,0,0
2019-03-20 11:15,126,68,58,0,0,0
2019-03-20 11:30,144,91,53,0,0,0
2019-03-20 11:45,154,106,48,0,0,0
2019-03-20 12:00,159,91,68,0,0,0
2019-03-20 12:15,152,88,64,0,0,0
2019-03-20 12:30,141,73,68,0,0,0
2019-03-20 12:45,192,103,89,0,0,0
2019-03-20 13:00,172,85,87,0,0,0
2019-03-20 13:15,133,60,73,0,0,0
2019-03-20 13:30,185,81,104,0,0,0
2019-03-20 13:45,164,83,81,0,0,0
2019-03-20 14:00,190,90,100,0,0,0
2019-03-20 14:15,159,77,82,0,0,0
2019-03-20 14:30,170,90,80,0,0,0
2019-03-20 14:45,175,88,87,0,0,0
2019-03-20 15:00,162,70,92,0,0,0
2019-03-20 15:15,172,77,95,0,0,0
2019-03-20 15:30,237,85,152,0,0,0
2019-03-20 15:45,216,113,103,0,0,0
2019-03-20 16:00,204,79,125,0,0,0
2019-03-20 16:15,180,87,93,0,0,0
2019-03-20 16:30,200,97,103,0,0,0
2019-03-20 16:45,206,98,108,0,0,0
2019-03-20 17:00,236,106,130,0,0,0
2019-03-20 17:15,231,104,127,0,0,0
2019-03-20 17:30,261,109,152,0,0,0
2019-03-20 17:45,244,140,104,0,0,0
2019-03-20 18:00,208,92,116,0,0,0
2019-03-20 18:15,212,106,106,0,0,0
2019-03-20 18:30,198,88,110,0,0,0
2019-03-20 18:45,236,120,116,0,0,0
2019-03-20 19:00,178,81,97,0,0,0
2019-03-20 19:15,171,79,92,0,0,0
2019-03-20 19:30,185,89,96,0,0,0
2019-03-20 19:45,184,89,95,0,0,0
2019-03-20 20:00,152,57,95,0,0,0
2019-03-20 20:15,135,74,61,0,0,0
2019-03-20 20:30,90,46,44,0,0,0
2019-03-20 20:45,97,44,53,0,0,0
2019-03-20 21:00,93,45,48,0,0,0
2019-03-20 21:15,93,41,52,0,0,0
2019-03-20 21:30,90,31,59,0,0,0
2019-03-20 21:45,80,40,40,0,0,0
2019-03-20 22:00,86,35,51,0,0,0
2019-03-20 22:15,99,52,47,0,0,0
2019-03-20 22:30,67,18,49,0,0,0
2019-03-20 22:45,64,24,40,0,0,0
2019-03-20 23:00,61,29,32,0,0,0
2019-03-20 23:15,68,18,50,0,0,0
2019-03-20 23:30,95,17,78,0,0,0
2019-03-20 23:45,74,30,44,0,0,0
2019-03-21 00:00,38,13,25,0,0,0
2019-03-21 00:15,28,6,22,0,0,0
2019-03-21 00:30,39,12,27,0,0,0
2019-03-21 00:45,28,9,19,0,0,0
2019-03-21 01:00,33,7,26,0,0,0
2019-03-21 01:15,26,14,12,0,0,0
2019-03-21 01:30,17,1,16,0,0,0
2019-03-21 01:45,13,1,12,0,0,0
2019-03-21 02:00,17,3,14,0,0,0
2019-03-21 02:15,14,5,9,0,0,0
2019-03-21 02:30,14,2,12,0,0,0
2019-03-21 02:45,18,2,16,0,0,0
2019-03-21 03:00,22,6,16,0,0,0
2019-03-21 03:15,9,2,7,0,0,0
2019-03-21 03:30,12,4,8,0,0,0
2019-03-21 03:45,15,1,14,0,0,0
2019-03-21 04:00,6,1,5,0,0,0
2019-03-21 04:15,12,2,10,0,0,0
2019-03-21 04:30,9,5,4,0,0,0
2019-03-21 04:45,9,5,4,0,0,0
2019-03-21 05:00,8,5,3,0,0,0
2019-03-21 05:15,17,8,9,0,0,0
2019-03-21 05:30,21,11,10,0,0,0
2019-03-21 05:45,15,12,3,0,0,0
2019-03-21 06:00,24,13,11,0,0,0
2019-03-21 06:15,47,29,18,0,0,0
2019-03-21 06:30,68,44,24,0,0,0
2019-03-21 06:45,92,69,23,0,0,0
2019-03-21 07:00,90,59,31,0,0,0
2019-03-21 07:15,142,94,48,0,0,0
2019-03-21 07:30,250,181,69,0,0,0
2019-03-21 07:45,292,176,116,0,0,0
2019-03-21 08:00,191,111,80,0,0,0
2019-03-21 08:15,196,120,76,0,0,0
2019-03-21 08:30,204,125,79,0,0,0
2019-03-21 08:45,227,155,72,0,0,0
2019-03-21 09:00,163,127,36,0,0,0
2019-03-21 09:15,160,110,50,0,0,0
2019-03-21 09:30,127,69,58,0,0,0
2019-03-21 09:45,181,102,79,0,0,0
2019-03-21 10:00,105,51,54,0,0,0
2019-03-21 10:15,115,66,49,0,0,0
2019-03-21 10:30,122,81,41,0,0,0
2019-03-21 10:45,141,84,57,0,0,0
2019-03-21 11:00,110,67,43,0,0,0
2019-03-21 11:15,119,57,62,0,0,0
2019-03-21 11:30,126,73,53,0,0,0
2019-03-21 11:45,139,77,62,0,0,0
2019-03-21 12:00,146,66,80,0,0,0
2019-03-21 12:15,162,82,80,0,0,0
2019-03-21 12:30,154,72,82,0,0,0
2019-03-21 12:45,168,84,84,0,0,0
2019-03-21 13:00,184,92,92,0,0,0
2019-03-21 13:15,185,93,92,0,0,0
2019-03-21 13:30,185,91,94,0,0,0
2019-03-21 13:45,200,100,100,0,0,0
2019-03-21 14:00,211,111,100,0,0,0
2019-03-21 14:15,184,111,73,0,0,0
2019-03-21 14:30,191,103,88,0,0,0
2019-03-21 14:45,182,108,74,0,0,0
2019-03-21 15:00,173,95,78,0,0,0
2019-03-21 15:15,191,91,100,0,0,0
2019-03-21 15:30,236,89,147,0,0,0
2019-03-21 15:45,243,138,105,0,0,0
2019-03-21 16:00,235,110,125,0,0,0
2019-03-21 16:15,282,126,156,0,0,0
2019-03-21 16:30,232,118,114,0,0,0
2019-03-21 16:45,253,125,128,0,0,0
2019-03-21 17:00,224,97,127,0,0,0
2019-03-21 17:15,281,149,132,0,0,0
2019-03-21 17:30,279,128,151,0,0,0
2019-03-21 17:45,320,156,164,0,0,0
2019-03-21 18:00,290,120,170,0,0,0
2019-03-21 18:15,238,111,127,0,0,0
2019-03-21 18:30,293,120,173,0,0,0
2019-03-21 18:45,248,123,125,0,0,0
2019-03-21 19:00,218,91,127,0,0,0
2019-03-21 19:15,178,97,81,0,0,0
2019-03-21 19:30,168,68,100,0,0,0
2019-03-21 19:45,170,75,95,0,0,0
2019-03-21 20:00,190,67,123,0,0,0
2019-03-21 20:15,161,54,107,0,0,0
2019-03-21 20:30,89,30,59,0,0,0
2019-03-21 20:45,99,35,64,0,0,0
2019-03-21 21:00,94,31,63,0,0,0
2019-03-21 21:15,101,32,69,0,0,0
2019-03-21 21:30,85,29,56,0,0,0
2019-03-21 21:45,76,23,53,0,0,0
2019-03-21 22:00,97,35,62,0,0,0
2019-03-21 22:15,110,46,64,0,0,0
2019-03-21 22:30,124,57,67,0,0,0
2019-03-21 22:45,86,35,51,0,0,0
2019-03-21 23:00,70,14,56,0,0,0
2019-03-21 23:15,55,22,33,0,0,0
2019-03-21 23:30,46,17,29,0,0,0
2019-03-21 23:45,41,12,29,0,0,0
2019-03-22 00:00,39,15,24,0,0,0
2019-03-22 00:15,22,6,16,0,0,0
2019-03-22 00:30,25,7,18,0,0,0
2019-03-22 00:45,21,4,17,0,0,0
2019-03-22 01:00,15,4,11,0,0,0
2019-03-22 01:15,16,9,7,0,0,0
2019-03-22 01:30,17,2,15,0,0,0
2019-03-22 01:45,5,1,4,0,0,0
2019-03-22 02:00,13,2,11,0,0,0
2019-03-22 02:15,9,0,9,0,0,0
2019-03-22 02:30,3,0,3,0,0,0
2019-03-22 02:45,8,1,7,0,0,0
2019-03-22 03:00,5,3,2,0,0,0
2019-03-22 03:15,1,0,1,0,0,0
2019-03-22 03:30,2,1,1,0,0,0
2019-03-22 03:45,4,1,3,0,0,0
2019-03-22 04:00,4,2,2,0,0,0
2019-03-22 04:15,0,0,0,0,0,0
2019-03-22 04:30,6,5,1,0,0,0
2019-03-22 04:45,7,6,1,0,0,0
2019-03-22 05:00,5,4,1,0,0,0
2019-03-22 05:15,9,7,2,0,0,0
2019-03-22 05:30,21,9,12,0,0,0
2019-03-22 05:45,23,18,5,0,0,0
2019-03-22 06:00,29,22,7,0,0,0
2019-03-22 06:15,45,30,15,0,0,0
2019-03-22 06:30,58,42,16,0,0,0
2019-03-22 06:45,83,53,30,0,0,0
2019-03-22 07:00,112,79,33,0,0,0
2019-03-22 07:15,142,98,44,0,0,0
2019-03-22 07:30,261,185,76,0,0,0
2019-03-22 07:45,276,193,83,0,0,0
2019-03-22 08:00,194,92,102,0,0,0
2019-03-22 08:15,203,115,88,0,0,0
2019-03-22 08:30,170,96,74,0,0,0
2019-03-22 08:45,217,142,75,0,0,0
2019-03-22 09:00,147,104,43,0,0,0
2019-03-22 09:15,128,86,42,0,0,0
2019-03-22 09:30,153,94,59,0,0,0
2019-03-22 09:45,164,97,67,0,0,0
2019-03-22 10:00,115,83,32,0,0,0
2019-03-22 10:15,111,71,40,0,0,0
2019-03-22 10:30,110,59,51,0,0,0
2019-03-22 10:45,155,98,57,0,0,0
2019-03-22 11:00,127,72,55,0,0,0
2019-03-22 11:15,116,63,53,0,0,0
2019-03-22 11:30,153,94,59,0,0,0
2019-03-22 11:45,156,91,65,0,0,0
2019-03-22 12:00,168,86,82,0,0,0
2019-03-22 12:15,174,95,79,0,0,0
2019-03-22 12:30,153,76,77,0,0,0
2019-03-22 12:45,191,121,70,0,0,0
2019-03-22 13:00,233,102,131,0,0,0
2019-03-22 13:15,207,102,105,0,0,0
2019-03-22 13:30,251,127,124,0,0,0
2019-03-22 13:45,252,134,118,0,0,0
2019-03-22 14:00,210,118,92,0,0,0
2019-03-22 14:15,220,127,93,0,0,0
2019-03-22 14:30,211,102,109,0,0,0
2019-03-22 14:45,196,107,89,0,0,0
2019-03-22 15:00,230,111,119,0,0,0
2019-03-22 15:15,218,113,105,0,0,0
2019-03-22 15:30,236,112,124,0,0,0
2019-03-22 15:45,238,116,122,0,0,0
2019-03-22 16:00,219,116,103,0,0,0
2019-03-22 16:15,242,114,128,0,0,0
2019-03-22 16:30,206,96,110,0,0,0
2019-03-22 16:45,252,128,124,0,0,0
2019-03-22 17:00,217,94,123,0,0,0
2019-03-22 17:15,226,122,104,0,0,0
2019-03-22 17:30,230,91,139,0,0,0
2019-03-22 17:45,268,125,143,0,0,0
2019-03-22 18:00,220,82,138,0,0,0
2019-03-22 18:15,208,102,106,0,0,0
2019-03-22 18:30,181,74,107,0,0,0
2019-03-22 18:45,253,118,135,0,0,0
2019-03-22 19:00,191,85,106,0,0,0
2019-03-22 19:15,169,79,90,0,0,0
2019-03-22 19:30,155,65,90,0,0,0
2019-03-22 19:45,151,67,84,0,0,0
2019-03-22 20:00,174,83,91,0,0,0
2019-03-22 20:15,151,61,90,0,0,0
2019-03-22 20:30,110,53,57,0,0,0
2019-03-22 20:45,106,40,66,0,0,0
2019-03-22 21:00,96,48,48,0,0,0
2019-03-22 21:15,105,60,45,0,0,0
2019-03-22 21:30,92,34,58,0,0,0
2019-03-22 21:45,87,30,57,0,0,0
2019-03-22 22:00,103,29,74,0,0,0
2019-03-22 22:15,62,24,38,0,0,0
2019-03-22 22:30,59,23,36,0,0,0
2019-03-22 22:45,64,15,49,0,0,0
2019-03-22 23:00,82,28,54,0,0,0
2019-03-22 23:15,63,27,36,0,0,0
2019-03-22 23:30,76,25,51,0,0,0
2019-03-22 23:45,74,37,37,0,0,0
2019-03-23 00:00,77,34,43,0,0,0
2019-03-23 00:15,55,20,35,0,0,0
2019-03-23 00:30,51,19,32,0,0,0
2019-03-23 00:45,87,48,39,0,0,0
2019-03-23 01:00,61,16,45,0,0,0
2019-03-23 01:15,41,14,27,0,0,0
2019-03-23 01:30,40,8,32,0,0,0
2019-03-23 01:45,40,16,24,0,0,0
2019-03-23 02:00,39,9,30,0,0,0
2019-03-23 02:15,44,3,41,0,0,0
2019-03-23 02:30,31,5,26,0,0,0
2019-03-23 02:45,34,8,26,0,0,0
2019-03-23 03:00,29,6,23,0,0,0
2019-03-23 03:15,16,2,14,0,0,0
2019-03-23 03:30,25,3,22,0,0,0
2019-03-23 03:45,16,2,14,0,0,0
2019-03-23 04:00,17,1,16,0,0,0
2019-03-23 04:15,11,2,9,0,0,0
2019-03-23 04:30,2,0,2,0,0,0
2019-03-23 04:45,17,3,14,0,0,0
2019-03-23 05:00,8,2,6,0,0,0
2019-03-23 05:15,9,3,6,0,0,0
2019-03-23 05:30,10,5,5,0,0,0
2019-03-23 05:45,11,8,3,0,0,0
2019-03-23 06:00,9,6,3,0,0,0
2019-03-23 06:15,7,4,3,0,0,0
2019-03-23 06:30,11,7,4,0,0,0
2019-03-23 06:45,16,8,8,0,0,0
2019-03-23 07:00,10,8,2,0,0,0
2019-03-23 07:15,16,13,3,0,0,0
2019-03-23 07:30,22,14,8,0,0,0
2019-03-23 07:45,36,32,4,0,0,0
2019-03-23 08:00,37,27,10,0,0,0
2019-03-23 08:15,53,36,17,0,0,0
2019-03-23 08:30,64,46,18,0,0,0
2019-03-23 08:45,67,46,21,0,0,0
2019-03-23 09:00,55,43,12,0,0,0
2019-03-23 09:15,75,54,21,0,0,0
2019-03-23 09:30,110,79,31,0,0,0
2019-03-23 09:45,129,102,27,0,0,0
2019-03-23 10:00,106,82,24,0,0,0
2019-03-23 10:15,100,62,38,0,0,0
2019-03-23 10:30,119,66,53,0,0,0
2019-03-23 10:45,133,83,50,0,0,0
2019-03-23 11:00,112,83,29,0,0,0
2019-03-23 11:15,132,91,41,0,0,0
2019-03-23 11:30,130,82,48,0,0,0
2019-03-23 11:45,168,125,43,0,0,0
2019-03-23 12:00,122,78,44,0,0,0
2019-03-23 12:15,106,71,35,0,0,0
2019-03-23 12:30,121,78,43,0,0,0
2019-03-23 12:45,189,118,71,0,0,0
2019-03-23 13:00,143,76,67,0,0,0
2019-03-23 13:15,147,94,53,0,0,0
2019-03-23 13:30,144,89,55,0,0,0
2019-03-23 13:45,148,83,65,0,0,0
2019-03-23 14:00,133,66,67,0,0,0
2019-03-23 14:15,159,62,97,0,0,0
2019-03-23 14:30,165,97,68,0,0,0
2019-03-23 14:45,165,89,76,0,0,0
2019-03-23 15:00,144,49,95,0,0,0
2019-03-23 15:15,134,56,78,0,0,0
2019-03-23 15:30,142,68,74,0,0,0
2019-03-23 15:45,146,68,78,0,0,0
2019-03-23 16:00,132,50,82,0,0,0
2019-03-23 16:15,167,70,97,0,0,0
2019-03-23 16:30,137,52,85,0,0,0
2019-03-23 16:45,150,60,90,0,0,0
2019-03-23 17:00,122,48,74,0,0,0
2019-03-23 17:15,121,49,72,0,0,0
2019-03-23 17:30,111,37,74,0,0,0
2019-03-23 17:45,159,69,90,0,0,0
2019-03-23 18:00,109,40,69,0,0,0
2019-03-23 18:15,117,55,62,0,0,0
2019-03-23 18:30,114,48,66,0,0,0
2019-03-23 18:45,163,72,91,0,0,0
2019-03-23 19:00,98,45,53,0,0,0
2019-03-23 19:15,125,66,59,0,0,0
2019-03-23 19:30,95,47,48,0,0,0
2019-03-23 19:45,119,46,73,0,0,0
2019-03-23 20:00,116,63,53,0,0,0
2019-03-23 20:15,119,61,58,0,0,0
2019-03-23 20:30,89,48,41,0,0,0
2019-03-23 20:45,84,47,37,0,0,0
2019-03-23 21:00,89,42,47,0,0,0
2019-03-23 21:15,76,33,43,0,0,0
2019-03-23 21:30,70,24,46,0,0,0
2019-03-23 21:45,79,24,55,0,0,0
2019-03-23 22:00,69,37,32,0,0,0
2019-03-23 22:15,65,33,32,0,0,0
2019-03-23 22:30,62,17,45,0,0,0
2019-03-23 22:45,44,18,26,0,0,0
2019-03-23 23:00,51,12,39,0,0,0
2019-03-23 23:15,72,30,42,0,0,0
2019-03-23 23:30,66,29,37,0,0,0
2019-03-23 23:45,43,21,22,0,0,0
2019-03-24 00:00,52,18,34,0,0,0
2019-03-24 00:15,34,12,22,0,0,0
2019-03-24 00:30,48,21,27,0,0,0
2019-03-24 00:45,59,32,27,0,0,0
2019-03-24 01:00,45,21,24,0,0,0
2019-03-24 01:15,39,18,21,0,0,0
2019-03-24 01:30,44,25,19,0,0,0
2019-03-24 01:45,36,14,22,0,0,0
2019-03-24 02:00,37,8,29,0,0,0
2019-03-24 02:15,42,8,34,0,0,0
2019-03-24 02:30,27,4,23,0,0,0
2019-03-24 02:45,32,3,29,0,0,0
2019-03-24 03:00,26,5,21,0,0,0
2019-03-24 03:15,15,0,15,0,0,0
2019-03-24 03:30,31,4,27,0,0,0
2019-03-24 03:45,15,1,14,0,0,0
2019-03-24 04:00,18,1,17,0,0,0
2019-03-24 04:15,13,0,13,0,0,0
2019-03-24 04:30,8,1,7,0,0,0
2019-03-24 04:45,10,0,10,0,0,0
2019-03-24 05:00,6,0,6,0,0,0
2019-03-24 05:15,12,3,9,0,0,0
2019-03-24 05:30,10,2,8,0,0,0
2019-03-24 05:45,12,6,6,0,0,0
2019-03-24 06:00,11,6,5,0,0,0
2019-03-24 06:15,4,2,2,0,0,0
2019-03-24 06:30,8,4,4,0,0,0
2019-03-24 06:45,6,3,3,0,0,0
2019-03-24 07:00,4,3,1,0,0,0
2019-03-24 07:15,11,6,5,0,0,0
2019-03-24 07:30,11,7,4,0,0,0
2019-03-24 07:45,16,11,5,0,0,0
2019-03-24 08:00,14,9,5,0,0,0
2019-03-24 08:15,24,16,8,0,0,0
2019-03-24 08:30,26,21,5,0,0,0
2019-03-24 08:45,33,19,14,0,0,0
2019-03-24 09:00,20,13,7,0,0,0
2019-03-24 09:15,29,23,6,0,0,0
2019-03-24 09:30,45,31,14,0,0,0
2019-03-24 09:45,99,78,21,0,0,0
2019-03-24 10:00,74,49,25,0,0,0
2019-03-24 10:15,72,49,23,0,0,0
2019-03-24 10:30,65,41,24,0,0,0
2019-03-24 10:45,99,74,25,0,0,0
2019-03-24 11:00,84,61,23,0,0,0
2019-03-24 11:15,95,61,34,0,0,0
2019-03-24 11:30,106,62,44,0,0,0
2019-03-24 11:45,116,87,29,0,0,0
2019-03-24 12:00,129,60,69,0,0,0
2019-03-24 12:15,81,41,40,0,0,0
2019-03-24 12:30,89,46,43,0,0,0
2019-03-24 12:45,123,67,56,0,0,0
2019-03-24 13:00,123,82,41,0,0,0
2019-03-24 13:15,125,63,62,0,0,0
2019-03-24 13:30,135,66,69,0,0,0
2019-03-24 13:45,140,74,66,0,0,0
2019-03-24 14:00,141,87,54,0,0,0
2019-03-24 14:15,109,68,41,0,0,0
2019-03-24 14:30,171,93,78,0,0,0
2019-03-24 14:45,194,118,76,0,0,0
2019-03-24 15:00,137,80,57,0,0,0
2019-03-24 15:15,135,88,47,0,0,0
2019-03-24 15:30,143,82,61,0,0,0
2019-03-24 15:45,186,100,86,0,0,0
2019-03-24 16:00,187,119,68,0,0,0
2019-03-24 16:15,146,68,78,0,0,0
2019-03-24 16:30,152,71,81,0,0,0
2019-03-24 16:45,174,67,107,0,0,0
2019-03-24 17:00,145,65,80,0,0,0
2019-03-24 17:15,163,71,92,0,0,0
2019-03-24 17:30,190,81,109,0,0,0
2019-03-24 17:45,192,82,110,0,0,0
2019-03-24 18:00,169,71,98,0,0,0
2019-03-24 18:15,148,40,108,0,0,0
2019-03-24 18:30,129,52,77,0,0,0
2019-03-24 18:45,131,67,64,0,0,0
2019-03-24 19:00,148,66,82,0,0,0
2019-03-24 19:15,103,35,68,0,0,0
2019-03-24 19:30,90,34,56,0,0,0
2019-03-24 19:45,106,49,57,0,0,0
2019-03-24 20:00,87,29,58,0,0,0
2019-03-24 20:15,93,30,63,0,0,0
2019-03-24 20:30,55,19,36,0,0,0
2019-03-24 20:45,64,32,32,0,0,0
2019-03-24 21:00,75,24,51,0,0,0
2019-03-24 21:15,39,15,24,0,0,0
2019-03-24 21:30,41,11,30,0,0,0
2019-03-24 21:45,51,10,41,0,0,0
2019-03-24 22:00,39,12,27,0,0,0
2019-03-24 22:15,35,13,22,0,0,0
2019-03-24 22:30,39,9,30,0,0,0
2019-03-24 22:45,43,10,33,0,0,0
2019-03-24 23:00,29,11,18,0,0,0
2019-03-24 23:15,19,9,10,0,0,0
2019-03-24 23:30,12,2,10,0,0,0
2019-03-24 23:45,18,4,14,0,0,0
2019-03-25 00:00,11,2,9,0,0,0
2019-03-25 00:15,18,5,13,0,0,0
2019-03-25 00:30,16,3,13,0,0,0
2019-03-25 00:45,8,5,3,0,0,0
2019-03-25 01:00,6,1,5,0,0,0
2019-03-25 01:15,9,4,5,0,0,0
2019-03-25 01:30,9,3,6,0,0,0
2019-03-25 01:45,9,5,4,0,0,0
2019-03-25 02:00,8,1,7,0,0,0
2019-03-25 02:15,7,0,7,0,0,0
2019-03-25 02:30,2,0,2,0,0,0
2019-03-25 02:45,0,0,0,0,0,0
2019-03-25 03:00,1,0,1,0,0,0
2019-03-25 03:15,1,0,1,0,0,0
2019-03-25 03:30,1,1,0,0,0,0
2019-03-25 03:45,0,0,0,0,0,0
2019-03-25 04:00,1,1,0,0,0,0
2019-03-25 04:15,2,1,1,0,0,0
2019-03-25 04:30,5,5,0,0,0,0
2019-03-25 04:45,6,2,4,0,0,0
2019-03-25 05:00,2,0,2,0,0,0
2019-03-25 05:15,6,4,2,0,0,0
2019-03-25 05:30,13,8,5,0,0,0
2019-03-25 05:45,15,8,7,0,0,0
2019-03-25 06:00,21,15,6,0,0,0
2019-03-25 06:15,23,19,4,0,0,0
2019-03-25 06:30,57,42,15,0,0,0
2019-03-25 06:45,77,55,22,0,0,0
2019-03-25 07:00,70,58,12,0,0,0
2019-03-25 07:15,111,81,30,0,0,0
2019-03-25 07:30,221,180,41,0,0,0
2019-03-25 07:45,245,177,68,0,0,0
2019-03-25 08:00,189,95,94,0,0,0
2019-03-25 08:15,179,110,69,0,0,0
2019-03-25 08:30,185,103,82,0,0,0
2019-03-25 08:45,174,102,72,0,0,0
2019-03-25 09:00,122,72,50,0,0,0
2019-03-25 09:15,122,78,44,0,0,0
2019-03-25 09:30,115,70,45,0,0,0
2019-03-25 09:45,176,98,78,0,0,0
2019-03-25 10:00,150,49,101,0,0,0
2019-03-25 10:15,102,58,44,0,0,0
2019-03-25 10:30,87,35,52,0,0,0
2019-03-25 10:45,83,44,39,0,0,0
2019-03-25 11:00,87,45,42,0,0,0
2019-03-25 11:15,92,57,35,0,0,0
2019-03-25 11:30,87,47,40,0,0,0
2019-03-25 11:45,130,91,39,0,0,0
2019-03-25 12:00,156,85,71,0,0,0
2019-03-25 12:15,114,56,58,0,0,0
2019-03-25 12:30,100,56,44,0,0,0
2019-03-25 12:45,144,79,65,0,0,0
2019-03-25 13:00,144,68,76,0,0,0
2019-03-25 13:15,155,64,91,0,0,0
2019-03-25 13:30,146,78,68,0,0,0
2019-03-25 13:45,149,96,53,0,0,0
2019-03-25 14:00,127,58,69,0,0,0
2019-03-25 14:15,129,53,76,0,0,0
2019-03-25 14:30,147,82,65,0,0,0
2019-03-25 14:45,127,75,52,0,0,0
2019-03-25 15:00,137,72,65,0,0,0
2019-03-25 15:15,117,58,59,0,0,0
2019-03-25 15:30,136,80,56,0,0,0
2019-03-25 15:45,234,111,123,0,0,0
2019-03-25 16:00,160,84,76,0,0,0
2019-03-25 16:15,181,99,82,0,0,0
2019-03-25 16:30,152,77,75,0,0,0
2019-03-25 16:45,183,106,77,0,0,0
2019-03-25 17:00,162,90,72,0,0,0
2019-03-25 17:15,230,102,128,0,0,0
2019-03-25 17:30,215,115,100,0,0,0
2019-03-25 17:45,231,124,107,0,0,0
2019-03-25 18:00,201,97,104,0,0,0
2019-03-25 18:15,208,95,113,0,0,0
2019-03-25 18:30,196,102,94,0,0,0
2019-03-25 18:45,173,83,90,0,0,0
2019-03-25 19:00,155,70,85,0,0,0
2019-03-25 19:15,159,77,82,0,0,0
2019-03-25 19:30,149,63,86,0,0,0
2019-03-25 19:45,132,56,76,0,0,0
2019-03-25 20:00,128,53,75,0,0,0
2019-03-25 20:15,117,39,78,0,0,0
2019-03-25 20:30,91,40,51,0,0,0
2019-03-25 20:45,106,52,54,0,0,0
2019-03-25 21:00,82,35,47,0,0,0
2019-03-25 21:15,82,42,40,0,0,0
2019-03-25 21:30,79,37,42,0,0,0
2019-03-25 21:45,93,33,60,0,0,0
2019-03-25 22:00,89,31,58,0,0,0
2019-03-25 22:15,81,34,47,0,0,0
2019-03-25 22:30,41,10,31,0,0,0
2019-03-25 22:45,40,11,29,0,0,0
2019-03-25 23:00,47,14,33,0,0,0
2019-03-25 23:15,33,12,21,0,0,0
2019-03-25 23:30,34,3,31,0,0,0
2019-03-25 23:45,31,6,25,0,0,0
2019-03-26 00:00,22,8,14,0,0,0
2019-03-26 00:15,19,3,16,0,0,0
2019-03-26 00:30,22,6,16,0,0,0
2019-03-26 00:45,18,2,16,0,0,0
2019-03-26 01:00,11,6,5,0,0,0
2019-03-26 01:15,13,4,9,0,0,0
2019-03-26 01:30,12,3,9,0,0,0
2019-03-26 01:45,9,2,7,0,0,0
2019-03-26 02:00,2,1,1,0,0,0
2019-03-26 02:15,9,2,7,0,0,0
2019-03-26 02:30,4,1,3,0,0,0
2019-03-26 02:45,2,0,2,0,0,0
2019-03-26 03:00,6,1,5,0,0,0
2019-03-26 03:15,5,1,4,0,0,0
2019-03-26 03:30,3,2,1,0,0,0
2019-03-26 03:45,5,2,3,0,0,0
2019-03-26 04:00,1,0,1,0,0,0
2019-03-26 04:15,0,0,0,0,0,0
2019-03-26 04:30,9,4,5,0,0,0
2019-03-26 04:45,5,3,2,0,0,0
2019-03-26 05:00,5,4,1,0,0,0
2019-03-26 05:15,8,5,3,0,0,0
2019-03-26 05:30,15,8,7,0,0,0
2019-03-26 05:45,17,7,10,0,0,0
2019-03-26 06:00,16,11,5,0,0,0
2019-03-26 06:15,35,28,7,0,0,0
2019-03-26 06:30,74,48,26,0,0,0
2019-03-26 06:45,75,56,19,0,0,0
2019-03-26 07:00,91,61,30,0,0,0
2019-03-26 07:15,164,95,69,0,0,0
2019-03-26 07:30,232,152,80,0,0,0
2019-03-26 07:45,285,159,126,0,0,0
2019-03-26 08:00,234,109,125,0,0,0
2019-03-26 08:15,213,139,74,0,0,0
2019-03-26 08:30,188,99,89,0,0,0
2019-03-26 08:45,266,181,85,0,0,0
2019-03-26 09:00,157,101,56,0,0,0
2019-03-26 09:15,140,88,52,0,0,0
2019-03-26 09:30,177,109,68,0,0,0
2019-03-26 09:45,198,122,76,0,0,0
2019-03-26 10:00,122,81,41,0,0,0
2019-03-26 10:15,109,63,46,0,0,0
2019-03-26 10:30,113,54,59,0,0,0
2019-03-26 10:45,135,78,57,0,0,0
2019-03-26 11:00,126,66,60,0,0,0
2019-03-26 11:15,230,67,163,0,0,0
2019-03-26 11:30,134,63,71,0,0,0
2019-03-26 11:45,169,101,68,0,0,0
2019-03-26 12:00,147,74,73,0,0,0
2019-03-26 12:15,142,79,63,0,0,0
2019-03-26 12:30,154,67,87,0,0,0
2019-03-26 12:45,148,75,73,0,0,0
2019-03-26 13:00,176,69,107,0,0,0
2019-03-26 13:15,151,74,77,0,0,0
2019-03-26 13:30,172,98,74,0,0,0
2019-03-26 13:45,224,125,99,0,0,0
2019-03-26 14:00,155,90,65,0,0,0
2019-03-26 14:15,178,111,67,0,0,0
2019-03-26 14:30,144,86,58,0,0,0
2019-03-26 14:45,157,76,81,0,0,0
2019-03-26 15:00,137,58,79,0,0,0
2019-03-26 15:15,133,71,62,0,0,0
2019-03-26 15:30,200,94,106,0,0,0
2019-03-26 15:45,228,135,93,0,0,0
2019-03-26 16:00,200,114,86,0,0,0
2019-03-26 16:15,194,108,86,0,0,0
2019-03-26 16:30,209,112,97,0,0,0
2019-03-26 16:45,224,139,85,0,0,0
2019-03-26 17:00,284,120,164,0,0,0
2019-03-26 17:15,260,124,136,0,0,0
2019-03-26 17:30,268,135,133,0,0,0
2019-03-26 17:45,266,149,117,0,0,0
2019-03-26 18:00,264,122,142,0,0,0
2019-03-26 18:15,214,106,108,0,0,0
2019-03-26 18:30,182,70,112,0,0,0
2019-03-26 18:45,205,110,95,0,0,0
2019-03-26 19:00,191,89,102,0,0,0
2019-03-26 19:15,181,89,92,0,0,0
2019-03-26 19:30,205,94,111,0,0,0
2019-03-26 19:45,193,101,92,0,0,0
2019-03-26 20:00,135,53,82,0,0,0
2019-03-26 20:15,116,47,69,0,0,0
2019-03-26 20:30,81,33,48,0,0,0
2019-03-26 20:45,62,26,36,0,0,0
2019-03-26 21:00,91,41,50,0,0,0
2019-03-26 21:15,112,42,70,0,0,0
2019-03-26 21:30,89,31,58,0,0,0
2019-03-26 21:45,81,28,53,0,0,0
2019-03-26 22:00,59,22,37,0,0,0
2019-03-26 22:15,94,40,54,0,0,0
2019-03-26 22:30,60,22,38,0,0,0
2019-03-26 22:45,81,29,52,0,0,0
2019-03-26 23:00,62,23,39,0,0,0
2019-03-26 23:15,28,8,20,0,0,0
2019-03-26 23:30,33,10,23,0,0,0
2019-03-26 23:45,31,5,26,0,0,0
2019-03-27 00:00,29,12,17,0,0,0
2019-03-27 00:15,29,6,23,0,0,0
2019-03-27 00:30,13,6,7,0,0,0
2019-03-27 00:45,38,4,34,0,0,0
2019-03-27 01:00,21,7,14,0,0,0
2019-03-27 01:15,13,4,9,0,0,0
2019-03-27 01:30,19,2,17,0,0,0
2019-03-27 01:45,16,5,11,0,0,0
2019-03-27 02:00,7,0,7,0,0,0
2019-03-27 02:15,4,2,2,0,0,0
2019-03-27 02:30,4,0,4,0,0,0
2019-03-27 02:45,4,1,3,0,0,0
2019-03-27 03:00,1,0,1,0,0,0
2019-03-27 03:15,3,3,0,0,0,0
2019-03-27 03:30,2,1,1,0,0,0
2019-03-27 03:45,4,2,2,0,0,0
2019-03-27 04:00,1,1,0,0,0,0
2019-03-27 04:15,5,1,4,0,0,0
2019-03-27 04:30,4,2,2,0,0,0
2019-03-27 04:45,3,1,2,0,0,0
2019-03-27 05:00,9,7,2,0,0,0
2019-03-27 05:15,8,3,5,0,0,0
2019-03-27 05:30,19,13,6,0,0,0
2019-03-27 05:45,13,9,4,0,0,0
2019-03-27 06:00,21,17,4,0,0,0
2019-03-27 06:15,57,41,16,0,0,0
2019-03-27 06:30,70,53,17,0,0,0
2019-03-27 06:45,79,59,20,0,0,0
2019-03-27 07:00,92,57,35,0,0,0
2019-03-27 07:15,174,120,54,0,0,0
2019-03-27 07:30,269,184,85,0,0,0
2019-03-27 07:45,320,167,153,0,0,0
2019-03-27 08:00,295,149,146,0,0,0
2019-03-27 08:15,239,145,94,0,0,0
2019-03-27 08:30,239,129,110,0,0,0
2019-03-27 08:45,266,159,107,0,0,0
2019-03-27 09:00,205,121,84,0,0,0
2019-03-27 09:15,158,79,79,0,0,0
2019-03-27 09:30,186,113,73,0,0,0
2019-03-27 09:45,179,98,81,0,0,0
2019-03-27 10:00,150,93,57,0,0,0
2019-03-27 10:15,132,83,49,0,0,0
2019-03-27 10:30,117,80,37,0,0,0
2019-03-27 10:45,154,89,65,0,0,0
2019-03-27 11:00,123,74,49,0,0,0
2019-03-27 11:15,146,80,66,0,0,0
2019-03-27 11:30,146,83,63,0,0,0
2019-03-27 11:45,199,121,78,0,0,0
2019-03-27 12:00,145,79,66,0,0,0
2019-03-27 12:15,134,64,70,0,0,0
2019-03-27 12:30,158,89,69,0,0,0
2019-03-27 12:45,156,85,71,0,0,0
2019-03-27 13:00,184,72,112,0,0,0
2019-03-27 13:15,152,79,73,0,0,0
2019-03-27 13:30,203,93,110,0,0,0
2019-03-27 13:45,197,97,100,0,0,0
2019-03-27 14:00,203,103,100,0,0,0
2019-03-27 14:15,166,84,82,0,0,0
2019-03-27 14:30,193,96,97,0,0,0
2019-03-27 14:45,204,93,111,0,0,0
2019-03-27 15:00,179,83,96,0,0,0
2019-03-27 15:15,187,82,105,0,0,0
2019-03-27 15:30,254,100,154,0,0,0
2019-03-27 15:45,276,144,132,0,0,0
2019-03-27 16:00,260,133,127,0,0,0
2019-03-27 16:15,198,87,111,0,0,0
2019-03-27 16:30,242,127,115,0,0,0
2019-03-27 16:45,272,151,121,0,0,0
2019-03-27 17:00,233,113,120,0,0,0
2019-03-27 17:15,267,129,138,0,0,0
2019-03-27 17:30,322,165,157,0,0,0
2019-03-27 17:45,276,112,164,0,0,0
2019-03-27 18:00,276,126,150,0,0,0
2019-03-27 18:15,287,130,157,0,0,0
2019-03-27 18:30,271,100,171,0,0,0
2019-03-27 18:45,275,157,118,0,0,0
2019-03-27 19:00,193,101,92,0,0,0
2019-03-27 19:15,201,107,94,0,0,0
2019-03-27 19:30,193,98,95,0,0,0
2019-03-27 19:45,255,129,126,0,0,0
2019-03-27 20:00,177,96,81,0,0,0
2019-03-27 20:15,144,61,83,0,0,0
2019-03-27 20:30,130,62,68,0,0,0
2019-03-27 20:45,207,137,70,0,0,0
2019-03-27 21:00,133,67,66,0,0,0
2019-03-27 21:15,143,49,94,0,0,0
2019-03-27 21:30,118,38,80,0,0,0
2019-03-27 21:45,124,54,70,0,0,0
2019-03-27 22:00,127,49,78,0,0,0
2019-03-27 22:15,129,70,59,0,0,0
2019-03-27 22:30,95,41,54,0,0,0
2019-03-27 22:45,76,23,53,0,0,0
2019-03-27 23:00,101,32,69,0,0,0
2019-03-27 23:15,62,25,37,0,0,0
2019-03-27 23:30,55,21,34,0,0,0
2019-03-27 23:45,62,26,36,0,0,0
2019-03-28 00:00,70,26,44,0,0,0
2019-03-28 00:15,62,14,48,0,0,0
2019-03-28 00:30,44,10,34,0,0,0
2019-03-28 00:45,39,11,28,0,0,0
2019-03-28 01:00,35,11,24,0,0,0
2019-03-28 01:15,35,15,20,0,0,0
2019-03-28 01:30,27,5,22,0,0,0
2019-03-28 01:45,35,1,34,0,0,0
2019-03-28 02:00,44,2,42,0,0,0
2019-03-28 02:15,28,4,24,0,0,0
2019-03-28 02:30,12,2,10,0,0,0
2019-03-28 02:45,20,1,19,0,0,0
2019-03-28 03:00,37,2,35,0,0,0
2019-03-28 03:15,12,1,11,0,0,0
2019-03-28 03:30,15,1,14,0,0,0
2019-03-28 03:45,15,1,14,0,0,0
2019-03-28 04:00,7,1,6,0,0,0
2019-03-28 04:15,10,0,10,0,0,0
2019-03-28 04:30,18,4,14,0,0,0
2019-03-28 04:45,6,3,3,0,0,0
2019-03-28 05:00,19,9,10,0,0,0
2019-03-28 05:15,17,6,11,0,0,0
2019-03-28 05:30,20,9,11,0,0,0
2019-03-28 05:45,17,12,5,0,0,0
2019-03-28 06:00,32,19,13,0,0,0
2019-03-28 06:15,44,35,9,0,0,0
2019-03-28 06:30,61,42,19,0,0,0
2019-03-28 06:45,95,68,27,0,0,0
2019-03-28 07:00,104,63,41,0,0,0
2019-03-28 07:15,166,100,66,0,0,0
2019-03-28 07:30,222,151,71,0,0,0
2019-03-28 07:45,292,166,126,0,0,0
2019-03-28 08:00,224,110,114,0,0,0
2019-03-28 08:15,205,128,77,0,0,0
2019-03-28 08:30,245,127,118,0,0,0
2019-03-28 08:45,242,161,81,0,0,0
2019-03-28 09:00,181,128,53,0,0,0
2019-03-28 09:15,135,83,52,0,0,0
2019-03-28 09:30,195,100,95,0,0,0
2019-03-28 09:45,167,93,74,0,0,0
2019-03-28 10:00,139,73,66,0,0,0
2019-03-28 10:15,145,88,57,0,0,0
2019-03-28 10:30,109,49,60,0,0,0
2019-03-28 10:45,137,73,64,0,0,0
2019-03-28 11:00,121,75,46,0,0,0
2019-03-28 11:15,138,79,59,0,0,0
2019-03-28 11:30,145,78,67,0,0,0
2019-03-28 11:45,166,99,67,0,0,0
2019-03-28 12:00,154,72,82,0,0,0
2019-03-28 12:15,143,81,62,0,0,0
2019-03-28 12:30,198,117,81,0,0,0
2019-03-28 12:45,153,87,66,0,0,0
2019-03-28 13:00,209,98,111,0,0,0
2019-03-28 13:15,190,85,105,0,0,0
2019-03-28 13:30,197,91,106,0,0,0
2019-03-28 13:45,190,111,79,0,0,0
2019-03-28 14:00,201,108,93,0,0,0
2019-03-28 14:15,214,127,87,0,0,0
2019-03-28 14:30,159,83,76,0,0,0
2019-03-28 14:45,192,92,100,0,0,0
2019-03-28 15:00,193,114,79,0,0,0
2019-03-28 15:15,195,84,111,0,0,0
2019-03-28 15:30,226,109,117,0,0,0
2019-03-28 15:45,270,143,127,0,0,0
2019-03-28 16:00,276,150,126,0,0,0
2019-03-28 16:15,237,131,106,0,0,0
2019-03-28 16:30,231,127,104,0,0,0
2019-03-28 16:45,231,122,109,0,0,0
2019-03-28 17:00,241,121,120,0,0,0
2019-03-28 17:15,284,131,153,0,0,0
2019-03-28 17:30,278,131,147,0,0,0
2019-03-28 17:45,299,124,175,0,0,0
2019-03-28 18:00,253,105,148,0,0,0
2019-03-28 18:15,259,95,164,0,0,0
2019-03-28 18:30,231,99,132,0,0,0
2019-03-28 18:45,273,120,153,0,0,0
2019-03-28 19:00,205,94,111,0,0,0
2019-03-28 19:15,169,77,92,0,0,0
2019-03-28 19:30,174,78,96,0,0,0
2019-03-28 19:45,187,73,114,0,0,0
2019-03-28 20:00,161,63,98,0,0,0
2019-03-28 20:15,154,70,84,0,0,0
2019-03-28 20:30,161,70,91,0,0,0
2019-03-28 20:45,99,48,51,0,0,0
2019-03-28 21:00,94,41,53,0,0,0
2019-03-28 21:15,99,47,52,0,0,0
2019-03-28 21:30,96,34,62,0,0,0
2019-03-28 21:45,111,36,75,0,0,0
2019-03-28 22:00,81,22,59,0,0,0
2019-03-28 22:15,86,44,42,0,0,0
2019-03-28 22:30,77,25,52,0,0,0
2019-03-28 22:45,110,56,54,0,0,0
2019-03-28 23:00,65,32,33,0,0,0
2019-03-28 23:15,47,15,32,0,0,0
2019-03-28 23:30,75,31,44,0,0,0
2019-03-28 23:45,43,20,23,0,0,0
2019-03-29 00:00,42,18,24,0,0,0
2019-03-29 00:15,28,11,17,0,0,0
2019-03-29 00:30,19,6,13,0,0,0
2019-03-29 00:45,37,17,20,0,0,0
2019-03-29 01:00,23,7,16,0,0,0
2019-03-29 01:15,12,1,11,0,0,0
2019-03-29 01:30,25,9,16,0,0,0
2019-03-29 01:45,19,2,17,0,0,0
2019-03-29 02:00,9,3,6,0,0,0
2019-03-29 02:15,18,6,12,0,0,0
2019-03-29 02:30,17,1,16,0,0,0
2019-03-29 02:45,12,7,5,0,0,0
2019-03-29 03:00,11,1,10,0,0,0
2019-03-29 03:15,5,1,4,0,0,0
2019-03-29 03:30,9,2,7,0,0,0
2019-03-29 03:45,17,3,14,0,0,0
2019-03-29 04:00,3,0,3,0,0,0
2019-03-29 04:15,5,1,4,0,0,0
2019-03-29 04:30,9,4,5,0,0,0
2019-03-29 04:45,7,4,3,0,0,0
2019-03-29 05:00,15,10,5,0,0,0
2019-03-29 05:15,18,9,9,0,0,0
2019-03-29 05:30,14,8,6,0,0,0
2019-03-29 05:45,21,13,8,0,0,0
2019-03-29 06:00,29,19,10,0,0,0
2019-03-29 06:15,39,25,14,0,0,0
2019-03-29 06:30,60,32,28,0,0,0
2019-03-29 06:45,78,52,26,0,0,0
2019-03-29 07:00,87,58,29,0,0,0
2019-03-29 07:15,132,86,46,0,0,0
2019-03-29 07:30,280,208,72,0,0,0
2019-03-29 07:45,237,139,98,0,0,0
2019-03-29 08:00,204,102,102,0,0,0
2019-03-29 08:15,186,110,76,0,0,0
2019-03-29 08:30,228,121,107,0,0,0
2019-03-29 08:45,207,134,73,0,0,0
2019-03-29 09:00,165,93,72,0,0,0
2019-03-29 09:15,143,98,45,0,0,0
2019-03-29 09:30,193,110,83,0,0,0
2019-03-29 09:45,198,112,86,0,0,0
2019-03-29 10:00,154,99,55,0,0,0
2019-03-29 10:15,111,64,47,0,0,0
2019-03-29 10:30,114,52,62,0,0,0
2019-03-29 10:45,146,90,56,0,0,0
2019-03-29 11:00,127,73,54,0,0,0
2019-03-29 11:15,143,79,64,0,0,0
2019-03-29 11:30,141,79,62,0,0,0
2019-03-29 11:45,191,113,78,0,0,0
2019-03-29 12:00,148,77,71,0,0,0
2019-03-29 12:15,192,116,76,0,0,0
2019-03-29 12:30,210,111,99,0,0,0
2019-03-29 12:45,199,114,85,0,0,0
2019-03-29 13:00,224,93,131,0,0,0
2019-03-29 13:15,216,103,113,0,0,0
2019-03-29 13:30,243,123,120,0,0,0
2019-03-29 13:45,236,118,118,0,0,0
2019-03-29 14:00,276,143,133,0,0,0
2019-03-29 14:15,230,121,109,0,0,0
2019-03-29 14:30,233,132,101,0,0,0
2019-03-29 14:45,217,121,96,0,0,0
2019-03-29 15:00,231,110,121,0,0,0
2019-03-29 15:15,257,134,123,0,0,0
2019-03-29 15:30,242,115,127,0,0,0
2019-03-29 15:45,244,132,112,0,0,0
2019-03-29 16:00,247,144,103,0,0,0
2019-03-29 16:15,249,133,116,0,0,0
2019-03-29 16:30,274,136,138,0,0,0
2019-03-29 16:45,240,131,109,0,0,0
2019-03-29 17:00,237,120,117,0,0,0
2019-03-29 17:15,217,113,104,0,0,0
2019-03-29 17:30,229,112,117,0,0,0
2019-03-29 17:45,287,125,162,0,0,0
2019-03-29 18:00,252,122,130,0,0,0
2019-03-29 18:15,251,128,123,0,0,0
2019-03-29 18:30,249,110,139,0,0,0
2019-03-29 18:45,266,129,137,0,0,0
2019-03-29 19:00,241,140,101,0,0,0
2019-03-29 19:15,244,112,132,0,0,0
2019-03-29 19:30,220,123,97,0,0,0
2019-03-29 19:45,225,108,117,0,0,0
2019-03-29 20:00,239,123,116,0,0,0
2019-03-29 20:15,182,105,77,0,0,0
2019-03-29 20:30,166,97,69,0,0,0
2019-03-29 20:45,138,96,42,0,0,0
2019-03-29 21:00,187,85,102,0,0,0
2019-03-29 21:15,210,70,140,0,0,0
2019-03-29 21:30,173,45,128,0,0,0
2019-03-29 21:45,126,39,87,0,0,0
2019-03-29 22:00,114,44,70,0,0,0
2019-03-29 22:15,97,31,66,0,0,0
2019-03-29 22:30,136,46,90,0,0,0
2019-03-29 22:45,121,52,69,0,0,0
2019-03-29 23:00,122,53,69,0,0,0
2019-03-29 23:15,72,32,40,0,0,0
2019-03-29 23:30,84,28,56,0,0,0
2019-03-29 23:45,79,27,52,0,0,0
2019-03-30 00:00,77,30,47,0,0,0
2019-03-30 00:15,50,17,33,0,0,0
2019-03-30 00:30,61,18,43,0,0,0
2019-03-30 00:45,71,27,44,0,0,0
2019-03-30 01:00,59,22,37,0,0,0
2019-03-30 01:15,64,20,44,0,0,0
2019-03-30 01:30,46,11,35,0,0,0
2019-03-30 01:45,35,13,22,0,0,0
2019-03-30 02:00,45,11,34,0,0,0
2019-03-30 02:15,36,11,25,0,0,0
2019-03-30 02:30,35,5,30,0,0,0
2019-03-30 02:45,40,9,31,0,0,0
2019-03-30 03:00,32,5,27,0,0,0
2019-03-30 03:15,18,6,12,0,0,0
2019-03-30 03:30,35,9,26,0,0,0
2019-03-30 03:45,28,2,26,0,0,0
2019-03-30 04:00,22,6,16,0,0,0
2019-03-30 04:15,30,3,27,0,0,0
2019-03-30 04:30,9,2,7,0,0,0
2019-03-30 04:45,8,2,6,0,0,0
2019-03-30 05:00,19,6,13,0,0,0
2019-03-30 05:15,7,5,2,0,0,0
2019-03-30 05:30,15,7,8,0,0,0
2019-03-30 05:45,12,5,7,0,0,0
2019-03-30 06:00,12,7,5,0,0,0
2019-03-30 06:15,6,2,4,0,0,0
2019-03-30 06:30,15,5,10,0,0,0
2019-03-30 06:45,12,8,4,0,0,0
2019-03-30 07:00,12,6,6,0,0,0
2019-03-30 07:15,25,14,11,0,0,0
2019-03-30 07:30,21,13,8,0,0,0
2019-03-30 07:45,54,46,8,0,0,0
2019-03-30 08:00,43,29,14,0,0,0
2019-03-30 08:15,48,28,20,0,0,0
2019-03-30 08:30,83,44,39,0,0,0
2019-03-30 08:45,99,73,26,0,0,0
2019-03-30 09:00,77,61,16,0,0,0
2019-03-30 09:15,91,76,15,0,0,0
2019-03-30 09:30,121,84,37,0,0,0
2019-03-30 09:45,156,105,51,0,0,0
2019-03-30 10:00,103,69,34,0,0,0
2019-03-30 10:15,113,80,33,0,0,0
2019-03-30 10:30,131,79,52,0,0,0
2019-03-30 10:45,150,97,53,0,0,0
2019-03-30 11:00,136,87,49,0,0,0
2019-03-30 11:15,166,109,57,0,0,0
2019-03-30 11:30,161,88,73,0,0,0
2019-03-30 11:45,159,101,58,0,0,0
2019-03-30 12:00,179,113,66,0,0,0
2019-03-30 12:15,185,115,70,0,0,0
2019-03-30 12:30,210,117,93,0,0,0
2019-03-30 12:45,199,109,90,0,0,0
2019-03-30 13:00,164,91,73,0,0,0
2019-03-30 13:15,178,88,90,0,0,0
2019-03-30 13:30,202,104,98,0,0,0
2019-03-30 13:45,211,131,80,0,0,0
2019-03-30 14:00,217,128,89,0,0,0
2019-03-30 14:15,227,120,107,0,0,0
2019-03-30 14:30,204,97,107,0,0,0
2019-03-30 14:45,247,117,130,0,0,0
2019-03-30 15:00,208,106,102,0,0,0
2019-03-30 15:15,206,98,108,0,0,0
2019-03-30 15:30,167,84,83,0,0,0
2019-03-30 15:45,198,99,99,0,0,0
2019-03-30 16:00,174,69,105,0,0,0
2019-03-30 16:15,167,80,87,0,0,0
2019-03-30 16:30,178,90,88,0,0,0
2019-03-30 16:45,180,72,108,0,0,0
2019-03-30 17:00,171,80,91,0,0,0
2019-03-30 17:15,159,69,90,0,0,0
2019-03-30 17:30,171,71,100,0,0,0
2019-03-30 17:45,195,90,105,0,0,0
2019-03-30 18:00,195,87,108,0,0,0
2019-03-30 18:15,162,70,92,0,0,0
2019-03-30 18:30,184,90,94,0,0,0
2019-03-30 18:45,173,100,73,0,0,0
2019-03-30 19:00,175,82,93,0,0,0
2019-03-30 19:15,182,75,107,0,0,0
2019-03-30 19:30,155,57,98,0,0,0
2019-03-30 19:45,197,91,106,0,0,0
2019-03-30 20:00,147,57,90,0,0,0
2019-03-30 20:15,141,64,77,0,0,0
2019-03-30 20:30,122,58,64,0,0,0
2019-03-30 20:45,124,49,75,0,0,0
2019-03-30 21:00,94,32,62,0,0,0
2019-03-30 21:15,95,31,64,0,0,0
2019-03-30 21:30,106,47,59,0,0,0
2019-03-30 21:45,67,31,36,0,0,0
2019-03-30 22:00,111,42,69,0,0,0
2019-03-30 22:15,96,31,65,0,0,0
2019-03-30 22:30,90,36,54,0,0,0
2019-03-30 22:45,81,24,57,0,0,0
2019-03-30 23:00,78,16,62,0,0,0
2019-03-30 23:15,75,33,42,0,0,0
2019-03-30 23:30,71,28,43,0,0,0
2019-03-30 23:45,66,27,39,0,0,0
2019-03-31 00:00,74,23,51,0,0,0
2019-03-31 00:15,73,29,44,0,0,0
2019-03-31 00:30,65,21,44,0,0,0
2019-03-31 00:45,53,15,38,0,0,0
2019-03-31 01:00,67,23,44,0,0,0
2019-03-31 01:15,43,20,23,0,0,0
2019-03-31 01:30,47,15,32,0,0,0
2019-03-31 01:45,47,20,27,0,0,0
2019-03-31 03:00,60,11,49,0,0,0
2019-03-31 03:15,51,11,40,0,0,0
2019-03-31 03:30,40,13,27,0,0,0
2019-03-31 03:45,28,9,19,0,0,0
2019-03-31 04:00,39,14,25,0,0,0
2019-03-31 04:15,24,5,19,0,0,0
2019-03-31 04:30,35,14,21,0,0,0
2019-03-31 04:45,30,7,23,0,0,0
2019-03-31 05:00,17,7,10,0,0,0
2019-03-31 05:15,9,4,5,0,0,0
2019-03-31 05:30,17,5,12,0,0,0
2019-03-31 05:45,12,3,9,0,0,0
2019-03-31 06:00,14,2,12,0,0,0
2019-03-31 06:15,13,5,8,0,0,0
2019-03-31 06:30,10,5,5,0,0,0
2019-03-31 06:45,9,1,8,0,0,0
2019-03-31 07:00,6,3,3,0,0,0
2019-03-31 07:15,14,8,6,0,0,0
2019-03-31 07:30,11,4,7,0,0,0
2019-03-31 07:45,18,12,6,0,0,0
2019-03-31 08:00,12,8,4,0,0,0
2019-03-31 08:15,17,7,10,0,0,0
2019-03-31 08:30,13,8,5,0,0,0
2019-03-31 08:45,26,19,7,0,0,0
2019-03-31 09:00,31,26,5,0,0,0
2019-03-31 09:15,43,28,15,0,0,0
2019-03-31 09:30,38,28,10,0,0,0
2019-03-31 09:45,107,90,17,0,0,0
2019-03-31 10:00,51,35,16,0,0,0
2019-03-31 10:15,67,39,28,0,0,0
2019-03-31 10:30,66,44,22,0,0,0
2019-03-31 10:45,64,51,13,0,0,0
2019-03-31 11:00,49,23,26,0,0,0
2019-03-31 11:15,82,64,18,0,0,0
2019-03-31 11:30,78,41,37,0,0,0
2019-03-31 11:45,107,70,37,0,0,0
2019-03-31 12:00,85,53,32,0,0,0
2019-03-31 12:15,99,65,34,0,0,0
2019-03-31 12:30,82,45,37,0,0,0
2019-03-31 12:45,121,70,51,0,0,0
2019-03-31 13:00,131,76,55,0,0,0
2019-03-31 13:15,125,81,44,0,0,0
2019-03-31 13:30,115,62,53,0,0,0
2019-03-31 13:45,129,61,68,0,0,0
2019-03-31 14:00,85,60,25,0,0,0
2019-03-31 14:15,130,76,54,0,0,0
2019-03-31 14:30,128,82,46,0,0,0
2019-03-31 14:45,135,81,54,0,0,0
2019-03-31 15:00,115,61,54,0,0,0
2019-03-31 15:15,93,57,36,0,0,0
2019-03-31 15:30,141,69,72,0,0,0
2019-03-31 15:45,166,92,74,0,0,0
2019-03-31 16:00,113,64,49,0,0,0
2019-03-31 16:15,145,67,78,0,0,0
2019-03-31 16:30,133,68,65,0,0,0
2019-03-31 16:45,137,67,70,0,0,0
2019-03-31 17:00,133,65,68,0,0,0
2019-03-31 17:15,118,56,62,0,0,0
2019-03-31 17:30,196,105,91,0,0,0
2019-03-31 17:45,172,87,85,0,0,0
2019-03-31 18:00,145,68,77,0,0,0
2019-03-31 18:15,160,78,82,0,0,0
2019-03-31 18:30,148,73,75,0,0,0
2019-03-31 18:45,170,89,81,0,0,0
2019-03-31 19:00,114,53,61,0,0,0
2019-03-31 19:15,162,63,99,0,0,0
2019-03-31 19:30,142,57,85,0,0,0
2019-03-31 19:45,157,64,93,0,0,0
2019-03-31 20:00,141,52,89,0,0,0
2019-03-31 20:15,119,38,81,0,0,0
2019-03-31 20:30,106,30,76,0,0,0
2019-03-31 20:45,71,27,44,0,0,0
2019-03-31 21:00,69,22,47,0,0,0
2019-03-31 21:15,74,19,55,0,0,0
2019-03-31 21:30,51,13,38,0,0,0
2019-03-31 21:45,60,19,41,0,0,0
2019-03-31 22:00,79,16,63,0,0,0
2019-03-31 22:15,39,13,26,0,0,0
2019-03-31 22:30,57,14,43,0,0,0
2019-03-31 22:45,40,12,28,0,0,0
2019-03-31 23:00,40,13,27,0,0,0
2019-03-31 23:15,20,4,16,0,0,0
2019-03-31 23:30,33,14,19,0,0,0
2019-03-31 23:45,15,4,11,0,0,0
