Datetime,100035541 (Neutor),101035541 (Neutor stadteinwÃ¤rts),102035541 (Neutor stadtauswÃ¤rts),100035541-status,101035541-status,102035541-status
2022-06-01 00:00,42,16,26,0,0,0
2022-06-01 00:15,48,9,39,0,0,0
2022-06-01 00:30,28,5,23,0,0,0
2022-06-01 00:45,23,7,16,0,0,0
2022-06-01 01:00,15,8,7,0,0,0
2022-06-01 01:15,26,9,17,0,0,0
2022-06-01 01:30,18,8,10,0,0,0
2022-06-01 01:45,9,2,7,0,0,0
2022-06-01 02:00,17,4,13,0,0,0
2022-06-01 02:15,9,4,5,0,0,0
2022-06-01 02:30,5,0,5,0,0,0
2022-06-01 02:45,4,2,2,0,0,0
2022-06-01 03:00,4,1,3,0,0,0
2022-06-01 03:15,5,2,3,0,0,0
2022-06-01 03:30,1,0,1,0,0,0
2022-06-01 03:45,3,1,2,0,0,0
2022-06-01 04:00,1,1,0,0,0,0
2022-06-01 04:15,5,3,2,0,0,0
2022-06-01 04:30,8,5,3,0,0,0
2022-06-01 04:45,11,9,2,0,0,0
2022-06-01 05:00,10,8,2,0,0,0
2022-06-01 05:15,21,11,10,0,0,0
2022-06-01 05:30,25,19,6,0,0,0
2022-06-01 05:45,23,19,4,0,0,0
2022-06-01 06:00,35,25,10,0,0,0
2022-06-01 06:15,58,35,23,0,0,0
2022-06-01 06:30,83,47,36,0,0,0
2022-06-01 06:45,89,55,34,0,0,0
2022-06-01 07:00,112,71,41,0,0,0
2022-06-01 07:15,200,145,55,0,0,0
2022-06-01 07:30,301,218,83,0,0,0
2022-06-01 07:45,395,214,181,0,0,0
2022-06-01 08:00,404,210,194,0,0,0
2022-06-01 08:15,289,159,130,0,0,0
2022-06-01 08:30,224,133,91,0,0,0
2022-06-01 08:45,240,139,101,0,0,0
2022-06-01 09:00,194,104,90,0,0,0
2022-06-01 09:15,185,118,67,0,0,0
2022-06-01 09:30,187,118,69,0,0,0
2022-06-01 09:45,325,179,146,0,0,0
2022-06-01 10:00,429,252,177,0,0,0
2022-06-01 10:15,181,93,88,0,0,0
2022-06-01 10:30,141,81,60,0,0,0
2022-06-01 10:45,168,95,73,0,0,0
2022-06-01 11:00,146,74,72,0,0,0
2022-06-01 11:15,120,62,58,0,0,0
2022-06-01 11:30,197,103,94,0,0,0
2022-06-01 11:45,358,203,155,0,0,0
2022-06-01 12:00,327,197,130,0,0,0
2022-06-01 12:15,216,113,103,0,0,0
2022-06-01 12:30,211,102,109,0,0,0
2022-06-01 12:45,242,133,109,0,0,0
2022-06-01 13:00,245,98,147,0,0,0
2022-06-01 13:15,258,116,142,0,0,0
2022-06-01 13:30,237,114,123,0,0,0
2022-06-01 13:45,417,193,224,0,0,0
2022-06-01 14:00,345,165,180,0,0,0
2022-06-01 14:15,250,127,123,0,0,0
2022-06-01 14:30,219,88,131,0,0,0
2022-06-01 14:45,238,98,140,0,0,0
2022-06-01 15:00,187,85,102,0,0,0
2022-06-01 15:15,120,38,82,0,0,0
2022-06-01 15:30,267,97,170,0,0,0
2022-06-01 15:45,423,189,234,0,0,0
2022-06-01 16:00,370,211,159,0,0,0
2022-06-01 16:15,259,136,123,0,0,0
2022-06-01 16:30,249,121,128,0,0,0
2022-06-01 16:45,294,121,173,0,0,0
2022-06-01 17:00,273,116,157,0,0,0
2022-06-01 17:15,288,136,152,0,0,0
2022-06-01 17:30,298,123,175,0,0,0
2022-06-01 17:45,489,210,279,0,0,0
2022-06-01 18:00,386,181,205,0,0,0
2022-06-01 18:15,228,115,113,0,0,0
2022-06-01 18:30,143,54,89,0,0,0
2022-06-01 18:45,216,107,109,0,0,0
2022-06-01 19:00,235,115,120,0,0,0
2022-06-01 19:15,177,104,73,0,0,0
2022-06-01 19:30,198,90,108,0,0,0
2022-06-01 19:45,238,133,105,0,0,0
2022-06-01 20:00,246,117,129,0,0,0
2022-06-01 20:15,199,98,101,0,0,0
2022-06-01 20:30,150,60,90,0,0,0
2022-06-01 20:45,147,64,83,0,0,0
2022-06-01 21:00,130,75,55,0,0,0
2022-06-01 21:15,113,56,57,0,0,0
2022-06-01 21:30,112,47,65,0,0,0
2022-06-01 21:45,139,50,89,0,0,0
2022-06-01 22:00,114,47,67,0,0,0
2022-06-01 22:15,136,56,80,0,0,0
2022-06-01 22:30,109,40,69,0,0,0
2022-06-01 22:45,99,40,59,0,0,0
2022-06-01 23:00,82,40,42,0,0,0
2022-06-01 23:15,98,55,43,0,0,0
2022-06-01 23:30,78,47,31,0,0,0
2022-06-01 23:45,114,53,61,0,0,0
2022-06-02 00:00,72,33,39,0,0,0
2022-06-02 00:15,42,16,26,0,0,0
2022-06-02 00:30,73,41,32,0,0,0
2022-06-02 00:45,35,6,29,0,0,0
2022-06-02 01:00,41,8,33,0,0,0
2022-06-02 01:15,46,14,32,0,0,0
2022-06-02 01:30,32,4,28,0,0,0
2022-06-02 01:45,30,6,24,0,0,0
2022-06-02 02:00,31,4,27,0,0,0
2022-06-02 02:15,35,4,31,0,0,0
2022-06-02 02:30,17,3,14,0,0,0
2022-06-02 02:45,33,10,23,0,0,0
2022-06-02 03:00,23,1,22,0,0,0
2022-06-02 03:15,30,2,28,0,0,0
2022-06-02 03:30,22,1,21,0,0,0
2022-06-02 03:45,23,1,22,0,0,0
2022-06-02 04:00,22,7,15,0,0,0
2022-06-02 04:15,23,6,17,0,0,0
2022-06-02 04:30,16,5,11,0,0,0
2022-06-02 04:45,16,6,10,0,0,0
2022-06-02 05:00,19,8,11,0,0,0
2022-06-02 05:15,22,13,9,0,0,0
2022-06-02 05:30,41,17,24,0,0,0
2022-06-02 05:45,30,20,10,0,0,0
2022-06-02 06:00,41,21,20,0,0,0
2022-06-02 06:15,43,27,16,0,0,0
2022-06-02 06:30,76,49,27,0,0,0
2022-06-02 06:45,92,65,27,0,0,0
2022-06-02 07:00,124,74,50,0,0,0
2022-06-02 07:15,178,140,38,0,0,0
2022-06-02 07:30,309,226,83,0,0,0
2022-06-02 07:45,387,248,139,0,0,0
2022-06-02 08:00,339,191,148,0,0,0
2022-06-02 08:15,267,148,119,0,0,0
2022-06-02 08:30,215,131,84,0,0,0
2022-06-02 08:45,259,130,129,0,0,0
2022-06-02 09:00,156,91,65,0,0,0
2022-06-02 09:15,159,91,68,0,0,0
2022-06-02 09:30,191,104,87,0,0,0
2022-06-02 09:45,343,188,155,0,0,0
2022-06-02 10:00,399,244,155,0,0,0
2022-06-02 10:15,153,88,65,0,0,0
2022-06-02 10:30,134,77,57,0,0,0
2022-06-02 10:45,141,79,62,0,0,0
2022-06-02 11:00,143,85,58,0,0,0
2022-06-02 11:15,157,95,62,0,0,0
2022-06-02 11:30,193,99,94,0,0,0
2022-06-02 11:45,373,171,202,0,0,0
2022-06-02 12:00,357,198,159,0,0,0
2022-06-02 12:15,230,110,120,0,0,0
2022-06-02 12:30,165,82,83,0,0,0
2022-06-02 12:45,226,120,106,0,0,0
2022-06-02 13:00,187,65,122,0,0,0
2022-06-02 13:15,241,113,128,0,0,0
2022-06-02 13:30,247,116,131,0,0,0
2022-06-02 13:45,416,208,208,0,0,0
2022-06-02 14:00,404,180,224,0,0,0
2022-06-02 14:15,242,125,117,0,0,0
2022-06-02 14:30,218,111,107,0,0,0
2022-06-02 14:45,211,98,113,0,0,0
2022-06-02 15:00,229,113,116,0,0,0
2022-06-02 15:15,219,110,109,0,0,0
2022-06-02 15:30,277,128,149,0,0,0
2022-06-02 15:45,441,195,246,0,0,0
2022-06-02 16:00,394,203,191,0,0,0
2022-06-02 16:15,267,126,141,0,0,0
2022-06-02 16:30,279,133,146,0,0,0
2022-06-02 16:45,291,141,150,0,0,0
2022-06-02 17:00,284,126,158,0,0,0
2022-06-02 17:15,332,153,179,0,0,0
2022-06-02 17:30,324,153,171,0,0,0
2022-06-02 17:45,443,211,232,0,0,0
2022-06-02 18:00,357,180,177,0,0,0
2022-06-02 18:15,322,137,185,0,0,0
2022-06-02 18:30,267,123,144,0,0,0
2022-06-02 18:45,274,134,140,0,0,0
2022-06-02 19:00,240,120,120,0,0,0
2022-06-02 19:15,243,125,118,0,0,0
2022-06-02 19:30,229,110,119,0,0,0
2022-06-02 19:45,299,124,175,0,0,0
2022-06-02 20:00,229,121,108,0,0,0
2022-06-02 20:15,203,101,102,0,0,0
2022-06-02 20:30,159,73,86,0,0,0
2022-06-02 20:45,120,51,69,0,0,0
2022-06-02 21:00,148,76,72,0,0,0
2022-06-02 21:15,130,61,69,0,0,0
2022-06-02 21:30,123,57,66,0,0,0
2022-06-02 21:45,128,44,84,0,0,0
2022-06-02 22:00,122,43,79,0,0,0
2022-06-02 22:15,122,50,72,0,0,0
2022-06-02 22:30,97,31,66,0,0,0
2022-06-02 22:45,96,34,62,0,0,0
2022-06-02 23:00,83,19,64,0,0,0
2022-06-02 23:15,99,41,58,0,0,0
2022-06-02 23:30,62,23,39,0,0,0
2022-06-02 23:45,85,40,45,0,0,0
2022-06-03 00:00,39,13,26,0,0,0
2022-06-03 00:15,39,16,23,0,0,0
2022-06-03 00:30,36,10,26,0,0,0
2022-06-03 00:45,23,6,17,0,0,0
2022-06-03 01:00,20,8,12,0,0,0
2022-06-03 01:15,27,7,20,0,0,0
2022-06-03 01:30,24,1,23,0,0,0
2022-06-03 01:45,21,7,14,0,0,0
2022-06-03 02:00,13,2,11,0,0,0
2022-06-03 02:15,28,1,27,0,0,0
2022-06-03 02:30,18,4,14,0,0,0
2022-06-03 02:45,17,3,14,0,0,0
2022-06-03 03:00,12,0,12,0,0,0
2022-06-03 03:15,14,6,8,0,0,0
2022-06-03 03:30,15,1,14,0,0,0
2022-06-03 03:45,20,2,18,0,0,0
2022-06-03 04:00,4,0,4,0,0,0
2022-06-03 04:15,8,3,5,0,0,0
2022-06-03 04:30,7,3,4,0,0,0
2022-06-03 04:45,11,6,5,0,0,0
2022-06-03 05:00,10,8,2,0,0,0
2022-06-03 05:15,15,12,3,0,0,0
2022-06-03 05:30,21,13,8,0,0,0
2022-06-03 05:45,24,20,4,0,0,0
2022-06-03 06:00,28,21,7,0,0,0
2022-06-03 06:15,43,25,18,0,0,0
2022-06-03 06:30,50,30,20,0,0,0
2022-06-03 06:45,83,47,36,0,0,0
2022-06-03 07:00,98,61,37,0,0,0
2022-06-03 07:15,135,95,40,0,0,0
2022-06-03 07:30,260,182,78,0,0,0
2022-06-03 07:45,296,169,127,0,0,0
2022-06-03 08:00,259,132,127,0,0,0
2022-06-03 08:15,212,126,86,0,0,0
2022-06-03 08:30,203,121,82,0,0,0
2022-06-03 08:45,238,124,114,0,0,0
2022-06-03 09:00,163,107,56,0,0,0
2022-06-03 09:15,154,92,62,0,0,0
2022-06-03 09:30,178,99,79,0,0,0
2022-06-03 09:45,290,157,133,0,0,0
2022-06-03 10:00,282,164,118,0,0,0
2022-06-03 10:15,147,88,59,0,0,0
2022-06-03 10:30,162,88,74,0,0,0
2022-06-03 10:45,145,67,78,0,0,0
2022-06-03 11:00,120,72,48,0,0,0
2022-06-03 11:15,146,73,73,0,0,0
2022-06-03 11:30,201,108,93,0,0,0
2022-06-03 11:45,270,136,134,0,0,0
2022-06-03 12:00,282,177,105,0,0,0
2022-06-03 12:15,212,102,110,0,0,0
2022-06-03 12:30,217,116,101,0,0,0
2022-06-03 12:45,202,113,89,0,0,0
2022-06-03 13:00,282,130,152,0,0,0
2022-06-03 13:15,244,115,129,0,0,0
2022-06-03 13:30,222,113,109,0,0,0
2022-06-03 13:45,241,124,117,0,0,0
2022-06-03 14:00,278,140,138,0,0,0
2022-06-03 14:15,249,122,127,0,0,0
2022-06-03 14:30,229,124,105,0,0,0
2022-06-03 14:45,201,92,109,0,0,0
2022-06-03 15:00,248,136,112,0,0,0
2022-06-03 15:15,215,106,109,0,0,0
2022-06-03 15:30,223,96,127,0,0,0
2022-06-03 15:45,269,129,140,0,0,0
2022-06-03 16:00,230,125,105,0,0,0
2022-06-03 16:15,240,116,124,0,0,0
2022-06-03 16:30,226,124,102,0,0,0
2022-06-03 16:45,233,124,109,0,0,0
2022-06-03 17:00,236,136,100,0,0,0
2022-06-03 17:15,230,121,109,0,0,0
2022-06-03 17:30,236,111,125,0,0,0
2022-06-03 17:45,267,140,127,0,0,0
2022-06-03 18:00,254,135,119,0,0,0
2022-06-03 18:15,275,155,120,0,0,0
2022-06-03 18:30,216,116,100,0,0,0
2022-06-03 18:45,232,117,115,0,0,0
2022-06-03 19:00,197,94,103,0,0,0
2022-06-03 19:15,181,95,86,0,0,0
2022-06-03 19:30,173,88,85,0,0,0
2022-06-03 19:45,158,94,64,0,0,0
2022-06-03 20:00,150,90,60,0,0,0
2022-06-03 20:15,157,74,83,0,0,0
2022-06-03 20:30,105,55,50,0,0,0
2022-06-03 20:45,117,56,61,0,0,0
2022-06-03 21:00,112,55,57,0,0,0
2022-06-03 21:15,110,53,57,0,0,0
2022-06-03 21:30,129,39,90,0,0,0
2022-06-03 21:45,90,23,67,0,0,0
2022-06-03 22:00,80,32,48,0,0,0
2022-06-03 22:15,107,38,69,0,0,0
2022-06-03 22:30,89,41,48,0,0,0
2022-06-03 22:45,86,40,46,0,0,0
2022-06-03 23:00,81,36,45,0,0,0
2022-06-03 23:15,72,32,40,0,0,0
2022-06-03 23:30,67,20,47,0,0,0
2022-06-03 23:45,57,19,38,0,0,0
2022-06-04 00:00,79,31,48,0,0,0
2022-06-04 00:15,72,25,47,0,0,0
2022-06-04 00:30,61,24,37,0,0,0
2022-06-04 00:45,53,15,38,0,0,0
2022-06-04 01:00,65,28,37,0,0,0
2022-06-04 01:15,73,24,49,0,0,0
2022-06-04 01:30,60,15,45,0,0,0
2022-06-04 01:45,46,10,36,0,0,0
2022-06-04 02:00,50,8,42,0,0,0
2022-06-04 02:15,43,6,37,0,0,0
2022-06-04 02:30,30,4,26,0,0,0
2022-06-04 02:45,46,4,42,0,0,0
2022-06-04 03:00,33,5,28,0,0,0
2022-06-04 03:15,24,0,24,0,0,0
2022-06-04 03:30,24,3,21,0,0,0
2022-06-04 03:45,21,0,21,0,0,0
2022-06-04 04:00,28,2,26,0,0,0
2022-06-04 04:15,14,1,13,0,0,0
2022-06-04 04:30,18,1,17,0,0,0
2022-06-04 04:45,7,0,7,0,0,0
2022-06-04 05:00,17,3,14,0,0,0
2022-06-04 05:15,15,5,10,0,0,0
2022-06-04 05:30,18,4,14,0,0,0
2022-06-04 05:45,18,6,12,0,0,0
2022-06-04 06:00,15,7,8,0,0,0
2022-06-04 06:15,13,8,5,0,0,0
2022-06-04 06:30,20,13,7,0,0,0
2022-06-04 06:45,15,7,8,0,0,0
2022-06-04 07:00,23,17,6,0,0,0
2022-06-04 07:15,17,11,6,0,0,0
2022-06-04 07:30,30,18,12,0,0,0
2022-06-04 07:45,39,30,9,0,0,0
2022-06-04 08:00,44,38,6,0,0,0
2022-06-04 08:15,45,34,11,0,0,0
2022-06-04 08:30,62,36,26,0,0,0
2022-06-04 08:45,60,34,26,0,0,0
2022-06-04 09:00,62,43,19,0,0,0
2022-06-04 09:15,73,55,18,0,0,0
2022-06-04 09:30,71,41,30,0,0,0
2022-06-04 09:45,138,97,41,0,0,0
2022-06-04 10:00,118,81,37,0,0,0
2022-06-04 10:15,111,71,40,0,0,0
2022-06-04 10:30,129,83,46,0,0,0
2022-06-04 10:45,114,71,43,0,0,0
2022-06-04 11:00,138,98,40,0,0,0
2022-06-04 11:15,158,118,40,0,0,0
2022-06-04 11:30,128,81,47,0,0,0
2022-06-04 11:45,152,91,61,0,0,0
2022-06-04 12:00,163,103,60,0,0,0
2022-06-04 12:15,151,92,59,0,0,0
2022-06-04 12:30,173,108,65,0,0,0
2022-06-04 12:45,134,70,64,0,0,0
2022-06-04 13:00,162,92,70,0,0,0
2022-06-04 13:15,192,98,94,0,0,0
2022-06-04 13:30,176,86,90,0,0,0
2022-06-04 13:45,181,113,68,0,0,0
2022-06-04 14:00,160,73,87,0,0,0
2022-06-04 14:15,160,65,95,0,0,0
2022-06-04 14:30,206,90,116,0,0,0
2022-06-04 14:45,170,77,93,0,0,0
2022-06-04 15:00,169,81,88,0,0,0
2022-06-04 15:15,151,70,81,0,0,0
2022-06-04 15:30,161,84,77,0,0,0
2022-06-04 15:45,141,71,70,0,0,0
2022-06-04 16:00,157,73,84,0,0,0
2022-06-04 16:15,152,73,79,0,0,0
2022-06-04 16:30,163,84,79,0,0,0
2022-06-04 16:45,141,65,76,0,0,0
2022-06-04 17:00,145,61,84,0,0,0
2022-06-04 17:15,130,61,69,0,0,0
2022-06-04 17:30,137,74,63,0,0,0
2022-06-04 17:45,169,83,86,0,0,0
2022-06-04 18:00,148,58,90,0,0,0
2022-06-04 18:15,159,71,88,0,0,0
2022-06-04 18:30,166,66,100,0,0,0
2022-06-04 18:45,145,60,85,0,0,0
2022-06-04 19:00,127,48,79,0,0,0
2022-06-04 19:15,130,54,76,0,0,0
2022-06-04 19:30,101,49,52,0,0,0
2022-06-04 19:45,108,51,57,0,0,0
2022-06-04 20:00,132,76,56,0,0,0
2022-06-04 20:15,112,60,52,0,0,0
2022-06-04 20:30,87,40,47,0,0,0
2022-06-04 20:45,86,44,42,0,0,0
2022-06-04 21:00,99,44,55,0,0,0
2022-06-04 21:15,110,56,54,0,0,0
2022-06-04 21:30,79,38,41,0,0,0
2022-06-04 21:45,84,30,54,0,0,0
2022-06-04 22:00,65,30,35,0,0,0
2022-06-04 22:15,62,27,35,0,0,0
2022-06-04 22:30,64,24,40,0,0,0
2022-06-04 22:45,61,32,29,0,0,0
2022-06-04 23:00,88,30,58,0,0,0
2022-06-04 23:15,64,18,46,0,0,0
2022-06-04 23:30,56,22,34,0,0,0
2022-06-04 23:45,77,37,40,0,0,0
2022-06-05 00:00,66,21,45,0,0,0
2022-06-05 00:15,45,6,39,0,0,0
2022-06-05 00:30,51,21,30,0,0,0
2022-06-05 00:45,56,21,35,0,0,0
2022-06-05 01:00,48,15,33,0,0,0
2022-06-05 01:15,43,11,32,0,0,0
2022-06-05 01:30,41,13,28,0,0,0
2022-06-05 01:45,49,20,29,0,0,0
2022-06-05 02:00,29,7,22,0,0,0
2022-06-05 02:15,41,10,31,0,0,0
2022-06-05 02:30,17,3,14,0,0,0
2022-06-05 02:45,21,4,17,0,0,0
2022-06-05 03:00,36,3,33,0,0,0
2022-06-05 03:15,25,7,18,0,0,0
2022-06-05 03:30,25,4,21,0,0,0
2022-06-05 03:45,20,3,17,0,0,0
2022-06-05 04:00,18,3,15,0,0,0
2022-06-05 04:15,16,3,13,0,0,0
2022-06-05 04:30,11,7,4,0,0,0
2022-06-05 04:45,9,1,8,0,0,0
2022-06-05 05:00,11,2,9,0,0,0
2022-06-05 05:15,12,3,9,0,0,0
2022-06-05 05:30,12,6,6,0,0,0
2022-06-05 05:45,8,1,7,0,0,0
2022-06-05 06:00,13,6,7,0,0,0
2022-06-05 06:15,14,4,10,0,0,0
2022-06-05 06:30,15,6,9,0,0,0
2022-06-05 06:45,12,4,8,0,0,0
2022-06-05 07:00,7,3,4,0,0,0
2022-06-05 07:15,13,10,3,0,0,0
2022-06-05 07:30,16,8,8,0,0,0
2022-06-05 07:45,11,5,6,0,0,0
2022-06-05 08:00,16,10,6,0,0,0
2022-06-05 08:15,21,13,8,0,0,0
2022-06-05 08:30,17,9,8,0,0,0
2022-06-05 08:45,28,18,10,0,0,0
2022-06-05 09:00,20,12,8,0,0,0
2022-06-05 09:15,34,22,12,0,0,0
2022-06-05 09:30,54,40,14,0,0,0
2022-06-05 09:45,71,45,26,0,0,0
2022-06-05 10:00,60,36,24,0,0,0
2022-06-05 10:15,57,25,32,0,0,0
2022-06-05 10:30,46,31,15,0,0,0
2022-06-05 10:45,69,45,24,0,0,0
2022-06-05 11:00,51,32,19,0,0,0
2022-06-05 11:15,53,27,26,0,0,0
2022-06-05 11:30,72,53,19,0,0,0
2022-06-05 11:45,76,50,26,0,0,0
2022-06-05 12:00,84,46,38,0,0,0
2022-06-05 12:15,75,38,37,0,0,0
2022-06-05 12:30,100,49,51,0,0,0
2022-06-05 12:45,103,43,60,0,0,0
2022-06-05 13:00,85,33,52,0,0,0
2022-06-05 13:15,68,24,44,0,0,0
2022-06-05 13:30,98,47,51,0,0,0
2022-06-05 13:45,72,38,34,0,0,0
2022-06-05 14:00,57,33,24,0,0,0
2022-06-05 14:15,48,18,30,0,0,0
2022-06-05 14:30,47,26,21,0,0,0
2022-06-05 14:45,58,35,23,0,0,0
2022-06-05 15:00,46,21,25,0,0,0
2022-06-05 15:15,58,29,29,0,0,0
2022-06-05 15:30,54,24,30,0,0,0
2022-06-05 15:45,66,40,26,0,0,0
2022-06-05 16:00,39,18,21,0,0,0
2022-06-05 16:15,59,24,35,0,0,0
2022-06-05 16:30,59,24,35,0,0,0
2022-06-05 16:45,44,26,18,0,0,0
2022-06-05 17:00,67,40,27,0,0,0
2022-06-05 17:15,52,26,26,0,0,0
2022-06-05 17:30,58,33,25,0,0,0
2022-06-05 17:45,74,27,47,0,0,0
2022-06-05 18:00,49,26,23,0,0,0
2022-06-05 18:15,61,24,37,0,0,0
2022-06-05 18:30,48,19,29,0,0,0
2022-06-05 18:45,64,35,29,0,0,0
2022-06-05 19:00,54,29,25,0,0,0
2022-06-05 19:15,72,35,37,0,0,0
2022-06-05 19:30,67,35,32,0,0,0
2022-06-05 19:45,64,32,32,0,0,0
2022-06-05 20:00,75,26,49,0,0,0
2022-06-05 20:15,32,11,21,0,0,0
2022-06-05 20:30,43,19,24,0,0,0
2022-06-05 20:45,48,21,27,0,0,0
2022-06-05 21:00,38,16,22,0,0,0
2022-06-05 21:15,43,10,33,0,0,0
2022-06-05 21:30,56,27,29,0,0,0
2022-06-05 21:45,36,12,24,0,0,0
2022-06-05 22:00,49,30,19,0,0,0
2022-06-05 22:15,23,11,12,0,0,0
2022-06-05 22:30,24,10,14,0,0,0
2022-06-05 22:45,30,15,15,0,0,0
2022-06-05 23:00,37,8,29,0,0,0
2022-06-05 23:15,29,16,13,0,0,0
2022-06-05 23:30,20,9,11,0,0,0
2022-06-05 23:45,16,4,12,0,0,0
2022-06-06 00:00,14,5,9,0,0,0
2022-06-06 00:15,23,10,13,0,0,0
2022-06-06 00:30,14,4,10,0,0,0
2022-06-06 00:45,14,7,7,0,0,0
2022-06-06 01:00,20,4,16,0,0,0
2022-06-06 01:15,28,10,18,0,0,0
2022-06-06 01:30,8,2,6,0,0,0
2022-06-06 01:45,14,4,10,0,0,0
2022-06-06 02:00,18,4,14,0,0,0
2022-06-06 02:15,12,4,8,0,0,0
2022-06-06 02:30,10,2,8,0,0,0
2022-06-06 02:45,9,4,5,0,0,0
2022-06-06 03:00,13,4,9,0,0,0
2022-06-06 03:15,7,5,2,0,0,0
2022-06-06 03:30,6,1,5,0,0,0
2022-06-06 03:45,17,1,16,0,0,0
2022-06-06 04:00,8,0,8,0,0,0
2022-06-06 04:15,3,0,3,0,0,0
2022-06-06 04:30,11,1,10,0,0,0
2022-06-06 04:45,4,0,4,0,0,0
2022-06-06 05:00,6,2,4,0,0,0
2022-06-06 05:15,8,6,2,0,0,0
2022-06-06 05:30,7,4,3,0,0,0
2022-06-06 05:45,4,4,0,0,0,0
2022-06-06 06:00,9,8,1,0,0,0
2022-06-06 06:15,8,5,3,0,0,0
2022-06-06 06:30,9,5,4,0,0,0
2022-06-06 06:45,9,7,2,0,0,0
2022-06-06 07:00,5,2,3,0,0,0
2022-06-06 07:15,5,2,3,0,0,0
2022-06-06 07:30,5,4,1,0,0,0
2022-06-06 07:45,13,10,3,0,0,0
2022-06-06 08:00,16,9,7,0,0,0
2022-06-06 08:15,13,10,3,0,0,0
2022-06-06 08:30,26,14,12,0,0,0
2022-06-06 08:45,26,16,10,0,0,0
2022-06-06 09:00,36,24,12,0,0,0
2022-06-06 09:15,36,30,6,0,0,0
2022-06-06 09:30,49,35,14,0,0,0
2022-06-06 09:45,59,40,19,0,0,0
2022-06-06 10:00,46,26,20,0,0,0
2022-06-06 10:15,75,37,38,0,0,0
2022-06-06 10:30,62,27,35,0,0,0
2022-06-06 10:45,82,42,40,0,0,0
2022-06-06 11:00,71,48,23,0,0,0
2022-06-06 11:15,75,45,30,0,0,0
2022-06-06 11:30,79,42,37,0,0,0
2022-06-06 11:45,72,38,34,0,0,0
2022-06-06 12:00,88,47,41,0,0,0
2022-06-06 12:15,73,33,40,0,0,0
2022-06-06 12:30,65,31,34,0,0,0
2022-06-06 12:45,87,35,52,0,0,0
2022-06-06 13:00,97,39,58,0,0,0
2022-06-06 13:15,84,41,43,0,0,0
2022-06-06 13:30,99,56,43,0,0,0
2022-06-06 13:45,122,55,67,0,0,0
2022-06-06 14:00,87,47,40,0,0,0
2022-06-06 14:15,84,40,44,0,0,0
2022-06-06 14:30,94,50,44,0,0,0
2022-06-06 14:45,91,59,32,0,0,0
2022-06-06 15:00,106,58,48,0,0,0
2022-06-06 15:15,83,57,26,0,0,0
2022-06-06 15:30,105,59,46,0,0,0
2022-06-06 15:45,144,84,60,0,0,0
2022-06-06 16:00,103,68,35,0,0,0
2022-06-06 16:15,92,49,43,0,0,0
2022-06-06 16:30,99,40,59,0,0,0
2022-06-06 16:45,122,65,57,0,0,0
2022-06-06 17:00,93,44,49,0,0,0
2022-06-06 17:15,118,45,73,0,0,0
2022-06-06 17:30,107,57,50,0,0,0
2022-06-06 17:45,116,68,48,0,0,0
2022-06-06 18:00,131,61,70,0,0,0
2022-06-06 18:15,115,50,65,0,0,0
2022-06-06 18:30,93,52,41,0,0,0
2022-06-06 18:45,127,73,54,0,0,0
2022-06-06 19:00,116,63,53,0,0,0
2022-06-06 19:15,91,43,48,0,0,0
2022-06-06 19:30,70,36,34,0,0,0
2022-06-06 19:45,89,48,41,0,0,0
2022-06-06 20:00,101,51,50,0,0,0
2022-06-06 20:15,74,33,41,0,0,0
2022-06-06 20:30,76,30,46,0,0,0
2022-06-06 20:45,72,27,45,0,0,0
2022-06-06 21:00,52,16,36,0,0,0
2022-06-06 21:15,34,12,22,0,0,0
2022-06-06 21:30,40,17,23,0,0,0
2022-06-06 21:45,34,10,24,0,0,0
2022-06-06 22:00,39,15,24,0,0,0
2022-06-06 22:15,38,9,29,0,0,0
2022-06-06 22:30,29,10,19,0,0,0
2022-06-06 22:45,37,8,29,0,0,0
2022-06-06 23:00,28,9,19,0,0,0
2022-06-06 23:15,33,3,30,0,0,0
2022-06-06 23:30,28,5,23,0,0,0
2022-06-06 23:45,20,1,19,0,0,0
2022-06-07 00:00,16,10,6,0,0,0
2022-06-07 00:15,8,2,6,0,0,0
2022-06-07 00:30,13,3,10,0,0,0
2022-06-07 00:45,7,1,6,0,0,0
2022-06-07 01:00,6,0,6,0,0,0
2022-06-07 01:15,3,0,3,0,0,0
2022-06-07 01:30,8,5,3,0,0,0
2022-06-07 01:45,5,0,5,0,0,0
2022-06-07 02:00,4,1,3,0,0,0
2022-06-07 02:15,3,1,2,0,0,0
2022-06-07 02:30,1,1,0,0,0,0
2022-06-07 02:45,2,1,1,0,0,0
2022-06-07 03:00,1,0,1,0,0,0
2022-06-07 03:15,2,0,2,0,0,0
2022-06-07 03:30,1,1,0,0,0,0
2022-06-07 03:45,2,0,2,0,0,0
2022-06-07 04:00,3,1,2,0,0,0
2022-06-07 04:15,5,2,3,0,0,0
2022-06-07 04:30,5,4,1,0,0,0
2022-06-07 04:45,10,6,4,0,0,0
2022-06-07 05:00,5,4,1,0,0,0
2022-06-07 05:15,11,9,2,0,0,0
2022-06-07 05:30,28,21,7,0,0,0
2022-06-07 05:45,20,15,5,0,0,0
2022-06-07 06:00,39,27,12,0,0,0
2022-06-07 06:15,45,28,17,0,0,0
2022-06-07 06:30,67,43,24,0,0,0
2022-06-07 06:45,86,55,31,0,0,0
2022-06-07 07:00,89,49,40,0,0,0
2022-06-07 07:15,153,107,46,0,0,0
2022-06-07 07:30,248,173,75,0,0,0
2022-06-07 07:45,264,151,113,0,0,0
2022-06-07 08:00,214,106,108,0,0,0
2022-06-07 08:15,218,120,98,0,0,0
2022-06-07 08:30,181,100,81,0,0,0
2022-06-07 08:45,192,111,81,0,0,0
2022-06-07 09:00,147,78,69,0,0,0
2022-06-07 09:15,126,66,60,0,0,0
2022-06-07 09:30,131,81,50,0,0,0
2022-06-07 09:45,150,85,65,0,0,0
2022-06-07 10:00,139,74,65,0,0,0
2022-06-07 10:15,96,62,34,0,0,0
2022-06-07 10:30,154,86,68,0,0,0
2022-06-07 10:45,138,75,63,0,0,0
2022-06-07 11:00,122,60,62,0,0,0
2022-06-07 11:15,130,57,73,0,0,0
2022-06-07 11:30,139,66,73,0,0,0
2022-06-07 11:45,155,78,77,0,0,0
2022-06-07 12:00,149,67,82,0,0,0
2022-06-07 12:15,158,74,84,0,0,0
2022-06-07 12:30,177,94,83,0,0,0
2022-06-07 12:45,203,124,79,0,0,0
2022-06-07 13:00,214,85,129,0,0,0
2022-06-07 13:15,166,68,98,0,0,0
2022-06-07 13:30,172,66,106,0,0,0
2022-06-07 13:45,196,97,99,0,0,0
2022-06-07 14:00,180,88,92,0,0,0
2022-06-07 14:15,171,83,88,0,0,0
2022-06-07 14:30,137,59,78,0,0,0
2022-06-07 14:45,203,89,114,0,0,0
2022-06-07 15:00,164,67,97,0,0,0
2022-06-07 15:15,172,88,84,0,0,0
2022-06-07 15:30,226,118,108,0,0,0
2022-06-07 15:45,263,129,134,0,0,0
2022-06-07 16:00,241,123,118,0,0,0
2022-06-07 16:15,232,107,125,0,0,0
2022-06-07 16:30,213,94,119,0,0,0
2022-06-07 16:45,240,110,130,0,0,0
2022-06-07 17:00,232,109,123,0,0,0
2022-06-07 17:15,264,134,130,0,0,0
2022-06-07 17:30,242,119,123,0,0,0
2022-06-07 17:45,291,149,142,0,0,0
2022-06-07 18:00,259,131,128,0,0,0
2022-06-07 18:15,242,111,131,0,0,0
2022-06-07 18:30,224,114,110,0,0,0
2022-06-07 18:45,227,113,114,0,0,0
2022-06-07 19:00,193,91,102,0,0,0
2022-06-07 19:15,182,91,91,0,0,0
2022-06-07 19:30,171,83,88,0,0,0
2022-06-07 19:45,181,77,104,0,0,0
2022-06-07 20:00,186,94,92,0,0,0
2022-06-07 20:15,161,81,80,0,0,0
2022-06-07 20:30,110,44,66,0,0,0
2022-06-07 20:45,103,51,52,0,0,0
2022-06-07 21:00,78,37,41,0,0,0
2022-06-07 21:15,89,43,46,0,0,0
2022-06-07 21:30,93,39,54,0,0,0
2022-06-07 21:45,112,36,76,0,0,0
2022-06-07 22:00,94,31,63,0,0,0
2022-06-07 22:15,84,30,54,0,0,0
2022-06-07 22:30,94,32,62,0,0,0
2022-06-07 22:45,70,27,43,0,0,0
2022-06-07 23:00,70,20,50,0,0,0
2022-06-07 23:15,48,11,37,0,0,0
2022-06-07 23:30,55,13,42,0,0,0
2022-06-07 23:45,41,11,30,0,0,0
2022-06-08 00:00,28,9,19,0,0,0
2022-06-08 00:15,28,8,20,0,0,0
2022-06-08 00:30,39,9,30,0,0,0
2022-06-08 00:45,16,4,12,0,0,0
2022-06-08 01:00,21,7,14,0,0,0
2022-06-08 01:15,12,1,11,0,0,0
2022-06-08 01:30,12,2,10,0,0,0
2022-06-08 01:45,16,3,13,0,0,0
2022-06-08 02:00,4,2,2,0,0,0
2022-06-08 02:15,4,2,2,0,0,0
2022-06-08 02:30,4,1,3,0,0,0
2022-06-08 02:45,6,2,4,0,0,0
2022-06-08 03:00,5,1,4,0,0,0
2022-06-08 03:15,8,1,7,0,0,0
2022-06-08 03:30,3,0,3,0,0,0
2022-06-08 03:45,3,3,0,0,0,0
2022-06-08 04:00,4,2,2,0,0,0
2022-06-08 04:15,7,1,6,0,0,0
2022-06-08 04:30,7,4,3,0,0,0
2022-06-08 04:45,9,7,2,0,0,0
2022-06-08 05:00,9,6,3,0,0,0
2022-06-08 05:15,21,16,5,0,0,0
2022-06-08 05:30,16,13,3,0,0,0
2022-06-08 05:45,13,10,3,0,0,0
2022-06-08 06:00,31,23,8,0,0,0
2022-06-08 06:15,44,26,18,0,0,0
2022-06-08 06:30,64,36,28,0,0,0
2022-06-08 06:45,73,46,27,0,0,0
2022-06-08 07:00,97,68,29,0,0,0
2022-06-08 07:15,184,130,54,0,0,0
2022-06-08 07:30,281,211,70,0,0,0
2022-06-08 07:45,276,172,104,0,0,0
2022-06-08 08:00,236,132,104,0,0,0
2022-06-08 08:15,232,136,96,0,0,0
2022-06-08 08:30,170,93,77,0,0,0
2022-06-08 08:45,236,159,77,0,0,0
2022-06-08 09:00,154,85,69,0,0,0
2022-06-08 09:15,171,105,66,0,0,0
2022-06-08 09:30,169,105,64,0,0,0
2022-06-08 09:45,181,120,61,0,0,0
2022-06-08 10:00,172,98,74,0,0,0
2022-06-08 10:15,167,100,67,0,0,0
2022-06-08 10:30,139,84,55,0,0,0
2022-06-08 10:45,142,91,51,0,0,0
2022-06-08 11:00,134,78,56,0,0,0
2022-06-08 11:15,149,63,86,0,0,0
2022-06-08 11:30,172,84,88,0,0,0
2022-06-08 11:45,210,123,87,0,0,0
2022-06-08 12:00,171,88,83,0,0,0
2022-06-08 12:15,169,94,75,0,0,0
2022-06-08 12:30,168,74,94,0,0,0
2022-06-08 12:45,181,84,97,0,0,0
2022-06-08 13:00,202,81,121,0,0,0
2022-06-08 13:15,192,84,108,0,0,0
2022-06-08 13:30,175,89,86,0,0,0
2022-06-08 13:45,195,98,97,0,0,0
2022-06-08 14:00,196,77,119,0,0,0
2022-06-08 14:15,167,75,92,0,0,0
2022-06-08 14:30,166,80,86,0,0,0
2022-06-08 14:45,229,87,142,0,0,0
2022-06-08 15:00,144,65,79,0,0,0
2022-06-08 15:15,103,48,55,0,0,0
2022-06-08 15:30,165,58,107,0,0,0
2022-06-08 15:45,208,81,127,0,0,0
2022-06-08 16:00,182,77,105,0,0,0
2022-06-08 16:15,213,80,133,0,0,0
2022-06-08 16:30,189,82,107,0,0,0
2022-06-08 16:45,238,112,126,0,0,0
2022-06-08 17:00,178,82,96,0,0,0
2022-06-08 17:15,206,101,105,0,0,0
2022-06-08 17:30,210,102,108,0,0,0
2022-06-08 17:45,226,111,115,0,0,0
2022-06-08 18:00,195,86,109,0,0,0
2022-06-08 18:15,160,78,82,0,0,0
2022-06-08 18:30,173,65,108,0,0,0
2022-06-08 18:45,176,84,92,0,0,0
2022-06-08 19:00,151,78,73,0,0,0
2022-06-08 19:15,111,56,55,0,0,0
2022-06-08 19:30,136,68,68,0,0,0
2022-06-08 19:45,144,69,75,0,0,0
2022-06-08 20:00,121,61,60,0,0,0
2022-06-08 20:15,100,57,43,0,0,0
2022-06-08 20:30,77,41,36,0,0,0
2022-06-08 20:45,81,36,45,0,0,0
2022-06-08 21:00,94,49,45,0,0,0
2022-06-08 21:15,76,38,38,0,0,0
2022-06-08 21:30,67,29,38,0,0,0
2022-06-08 21:45,63,24,39,0,0,0
2022-06-08 22:00,69,15,54,0,0,0
2022-06-08 22:15,76,30,46,0,0,0
2022-06-08 22:30,56,13,43,0,0,0
2022-06-08 22:45,65,20,45,0,0,0
2022-06-08 23:00,57,27,30,0,0,0
2022-06-08 23:15,68,27,41,0,0,0
2022-06-08 23:30,34,10,24,0,0,0
2022-06-08 23:45,38,8,30,0,0,0
2022-06-09 00:00,44,8,36,0,0,0
2022-06-09 00:15,19,8,11,0,0,0
2022-06-09 00:30,28,14,14,0,0,0
2022-06-09 00:45,23,5,18,0,0,0
2022-06-09 01:00,20,4,16,0,0,0
2022-06-09 01:15,17,4,13,0,0,0
2022-06-09 01:30,8,1,7,0,0,0
2022-06-09 01:45,17,3,14,0,0,0
2022-06-09 02:00,12,0,12,0,0,0
2022-06-09 02:15,23,3,20,0,0,0
2022-06-09 02:30,10,3,7,0,0,0
2022-06-09 02:45,17,3,14,0,0,0
2022-06-09 03:00,7,1,6,0,0,0
2022-06-09 03:15,8,1,7,0,0,0
2022-06-09 03:30,8,2,6,0,0,0
2022-06-09 03:45,8,1,7,0,0,0
2022-06-09 04:00,1,1,0,0,0,0
2022-06-09 04:15,9,2,7,0,0,0
2022-06-09 04:30,5,2,3,0,0,0
2022-06-09 04:45,12,8,4,0,0,0
2022-06-09 05:00,11,9,2,0,0,0
2022-06-09 05:15,13,11,2,0,0,0
2022-06-09 05:30,20,15,5,0,0,0
2022-06-09 05:45,23,16,7,0,0,0
2022-06-09 06:00,41,27,14,0,0,0
2022-06-09 06:15,40,26,14,0,0,0
2022-06-09 06:30,62,39,23,0,0,0
2022-06-09 06:45,72,47,25,0,0,0
2022-06-09 07:00,90,57,33,0,0,0
2022-06-09 07:15,164,114,50,0,0,0
2022-06-09 07:30,253,188,65,0,0,0
2022-06-09 07:45,263,159,104,0,0,0
2022-06-09 08:00,219,118,101,0,0,0
2022-06-09 08:15,222,116,106,0,0,0
2022-06-09 08:30,171,104,67,0,0,0
2022-06-09 08:45,223,136,87,0,0,0
2022-06-09 09:00,157,94,63,0,0,0
2022-06-09 09:15,140,84,56,0,0,0
2022-06-09 09:30,141,90,51,0,0,0
2022-06-09 09:45,201,96,105,0,0,0
2022-06-09 10:00,140,72,68,0,0,0
2022-06-09 10:15,189,93,96,0,0,0
2022-06-09 10:30,134,68,66,0,0,0
2022-06-09 10:45,146,77,69,0,0,0
2022-06-09 11:00,131,69,62,0,0,0
2022-06-09 11:15,108,66,42,0,0,0
2022-06-09 11:30,130,57,73,0,0,0
2022-06-09 11:45,155,82,73,0,0,0
2022-06-09 12:00,144,66,78,0,0,0
2022-06-09 12:15,149,85,64,0,0,0
2022-06-09 12:30,154,78,76,0,0,0
2022-06-09 12:45,179,79,100,0,0,0
2022-06-09 13:00,152,75,77,0,0,0
2022-06-09 13:15,147,69,78,0,0,0
2022-06-09 13:30,165,76,89,0,0,0
2022-06-09 13:45,207,100,107,0,0,0
2022-06-09 14:00,220,103,117,0,0,0
2022-06-09 14:15,170,78,92,0,0,0
2022-06-09 14:30,159,79,80,0,0,0
2022-06-09 14:45,181,77,104,0,0,0
2022-06-09 15:00,183,83,100,0,0,0
2022-06-09 15:15,192,91,101,0,0,0
2022-06-09 15:30,249,110,139,0,0,0
2022-06-09 15:45,257,113,144,0,0,0
2022-06-09 16:00,267,137,130,0,0,0
2022-06-09 16:15,221,110,111,0,0,0
2022-06-09 16:30,235,112,123,0,0,0
2022-06-09 16:45,220,99,121,0,0,0
2022-06-09 17:00,237,125,112,0,0,0
2022-06-09 17:15,250,142,108,0,0,0
2022-06-09 17:30,248,124,124,0,0,0
2022-06-09 17:45,308,131,177,0,0,0
2022-06-09 18:00,261,100,161,0,0,0
2022-06-09 18:15,283,113,170,0,0,0
2022-06-09 18:30,228,116,112,0,0,0
2022-06-09 18:45,202,107,95,0,0,0
2022-06-09 19:00,181,86,95,0,0,0
2022-06-09 19:15,175,85,90,0,0,0
2022-06-09 19:30,179,101,78,0,0,0
2022-06-09 19:45,212,114,98,0,0,0
2022-06-09 20:00,171,92,79,0,0,0
2022-06-09 20:15,129,69,60,0,0,0
2022-06-09 20:30,127,63,64,0,0,0
2022-06-09 20:45,131,70,61,0,0,0
2022-06-09 21:00,137,65,72,0,0,0
2022-06-09 21:15,97,49,48,0,0,0
2022-06-09 21:30,80,39,41,0,0,0
2022-06-09 21:45,101,21,80,0,0,0
2022-06-09 22:00,98,33,65,0,0,0
2022-06-09 22:15,94,38,56,0,0,0
2022-06-09 22:30,113,35,78,0,0,0
2022-06-09 22:45,73,17,56,0,0,0
2022-06-09 23:00,67,20,47,0,0,0
2022-06-09 23:15,57,19,38,0,0,0
2022-06-09 23:30,54,17,37,0,0,0
2022-06-09 23:45,41,10,31,0,0,0
2022-06-10 00:00,31,10,21,0,0,0
2022-06-10 00:15,33,13,20,0,0,0
2022-06-10 00:30,26,5,21,0,0,0
2022-06-10 00:45,18,9,9,0,0,0
2022-06-10 01:00,17,5,12,0,0,0
2022-06-10 01:15,25,8,17,0,0,0
2022-06-10 01:30,16,2,14,0,0,0
2022-06-10 01:45,18,5,13,0,0,0
2022-06-10 02:00,11,3,8,0,0,0
2022-06-10 02:15,11,4,7,0,0,0
2022-06-10 02:30,4,0,4,0,0,0
2022-06-10 02:45,4,3,1,0,0,0
2022-06-10 03:00,4,2,2,0,0,0
2022-06-10 03:15,9,3,6,0,0,0
2022-06-10 03:30,2,0,2,0,0,0
2022-06-10 03:45,5,2,3,0,0,0
2022-06-10 04:00,3,0,3,0,0,0
2022-06-10 04:15,3,0,3,0,0,0
2022-06-10 04:30,3,1,2,0,0,0
2022-06-10 04:45,10,7,3,0,0,0
2022-06-10 05:00,14,9,5,0,0,0
2022-06-10 05:15,10,7,3,0,0,0
2022-06-10 05:30,25,18,7,0,0,0
2022-06-10 05:45,17,14,3,0,0,0
2022-06-10 06:00,29,19,10,0,0,0
2022-06-10 06:15,34,21,13,0,0,0
2022-06-10 06:30,60,34,26,0,0,0
2022-06-10 06:45,89,60,29,0,0,0
2022-06-10 07:00,93,58,35,0,0,0
2022-06-10 07:15,162,121,41,0,0,0
2022-06-10 07:30,308,233,75,0,0,0
2022-06-10 07:45,237,167,70,0,0,0
2022-06-10 08:00,193,103,90,0,0,0
2022-06-10 08:15,183,117,66,0,0,0
2022-06-10 08:30,202,109,93,0,0,0
2022-06-10 08:45,209,122,87,0,0,0
2022-06-10 09:00,163,91,72,0,0,0
2022-06-10 09:15,173,84,89,0,0,0
2022-06-10 09:30,150,94,56,0,0,0
2022-06-10 09:45,196,86,110,0,0,0
2022-06-10 10:00,139,68,71,0,0,0
2022-06-10 10:15,109,59,50,0,0,0
2022-06-10 10:30,136,77,59,0,0,0
2022-06-10 10:45,131,63,68,0,0,0
2022-06-10 11:00,146,81,65,0,0,0
2022-06-10 11:15,129,68,61,0,0,0
2022-06-10 11:30,160,94,66,0,0,0
2022-06-10 11:45,155,83,72,0,0,0
2022-06-10 12:00,162,89,73,0,0,0
2022-06-10 12:15,192,98,94,0,0,0
2022-06-10 12:30,166,79,87,0,0,0
2022-06-10 12:45,202,114,88,0,0,0
2022-06-10 13:00,242,83,159,0,0,0
2022-06-10 13:15,220,89,131,0,0,0
2022-06-10 13:30,247,111,136,0,0,0
2022-06-10 13:45,217,94,123,0,0,0
2022-06-10 14:00,205,94,111,0,0,0
2022-06-10 14:15,190,88,102,0,0,0
2022-06-10 14:30,170,81,89,0,0,0
2022-06-10 14:45,261,125,136,0,0,0
2022-06-10 15:00,203,99,104,0,0,0
2022-06-10 15:15,208,115,93,0,0,0
2022-06-10 15:30,214,121,93,0,0,0
2022-06-10 15:45,251,141,110,0,0,0
2022-06-10 16:00,238,102,136,0,0,0
2022-06-10 16:15,222,125,97,0,0,0
2022-06-10 16:30,218,113,105,0,0,0
2022-06-10 16:45,232,134,98,0,0,0
2022-06-10 17:00,214,119,95,0,0,0
2022-06-10 17:15,203,113,90,0,0,0
2022-06-10 17:30,201,108,93,0,0,0
2022-06-10 17:45,246,130,116,0,0,0
2022-06-10 18:00,259,127,132,0,0,0
2022-06-10 18:15,201,99,102,0,0,0
2022-06-10 18:30,212,94,118,0,0,0
2022-06-10 18:45,197,107,90,0,0,0
2022-06-10 19:00,172,80,92,0,0,0
2022-06-10 19:15,217,107,110,0,0,0
2022-06-10 19:30,172,90,82,0,0,0
2022-06-10 19:45,163,87,76,0,0,0
2022-06-10 20:00,155,79,76,0,0,0
2022-06-10 20:15,160,78,82,0,0,0
2022-06-10 20:30,119,58,61,0,0,0
2022-06-10 20:45,122,57,65,0,0,0
2022-06-10 21:00,103,50,53,0,0,0
2022-06-10 21:15,109,51,58,0,0,0
2022-06-10 21:30,92,38,54,0,0,0
2022-06-10 21:45,89,34,55,0,0,0
2022-06-10 22:00,94,34,60,0,0,0
2022-06-10 22:15,91,32,59,0,0,0
2022-06-10 22:30,83,32,51,0,0,0
2022-06-10 22:45,75,25,50,0,0,0
2022-06-10 23:00,90,35,55,0,0,0
2022-06-10 23:15,67,25,42,0,0,0
2022-06-10 23:30,57,24,33,0,0,0
2022-06-10 23:45,69,33,36,0,0,0
2022-06-11 00:00,75,28,47,0,0,0
2022-06-11 00:15,51,19,32,0,0,0
2022-06-11 00:30,68,30,38,0,0,0
2022-06-11 00:45,81,20,61,0,0,0
2022-06-11 01:00,59,21,38,0,0,0
2022-06-11 01:15,62,14,48,0,0,0
2022-06-11 01:30,44,15,29,0,0,0
2022-06-11 01:45,49,11,38,0,0,0
2022-06-11 02:00,37,11,26,0,0,0
2022-06-11 02:15,45,14,31,0,0,0
2022-06-11 02:30,22,11,11,0,0,0
2022-06-11 02:45,34,4,30,0,0,0
2022-06-11 03:00,33,8,25,0,0,0
2022-06-11 03:15,34,7,27,0,0,0
2022-06-11 03:30,28,3,25,0,0,0
2022-06-11 03:45,18,1,17,0,0,0
2022-06-11 04:00,28,6,22,0,0,0
2022-06-11 04:15,7,2,5,0,0,0
2022-06-11 04:30,14,4,10,0,0,0
2022-06-11 04:45,14,6,8,0,0,0
2022-06-11 05:00,11,2,9,0,0,0
2022-06-11 05:15,10,5,5,0,0,0
2022-06-11 05:30,19,13,6,0,0,0
2022-06-11 05:45,20,10,10,0,0,0
2022-06-11 06:00,9,4,5,0,0,0
2022-06-11 06:15,17,12,5,0,0,0
2022-06-11 06:30,7,4,3,0,0,0
2022-06-11 06:45,21,14,7,0,0,0
2022-06-11 07:00,20,13,7,0,0,0
2022-06-11 07:15,17,12,5,0,0,0
2022-06-11 07:30,36,28,8,0,0,0
2022-06-11 07:45,43,34,9,0,0,0
2022-06-11 08:00,31,18,13,0,0,0
2022-06-11 08:15,38,22,16,0,0,0
2022-06-11 08:30,71,46,25,0,0,0
2022-06-11 08:45,91,54,37,0,0,0
2022-06-11 09:00,67,42,25,0,0,0
2022-06-11 09:15,97,68,29,0,0,0
2022-06-11 09:30,125,99,26,0,0,0
2022-06-11 09:45,137,100,37,0,0,0
2022-06-11 10:00,141,101,40,0,0,0
2022-06-11 10:15,167,127,40,0,0,0
2022-06-11 10:30,146,100,46,0,0,0
2022-06-11 10:45,168,134,34,0,0,0
2022-06-11 11:00,118,82,36,0,0,0
2022-06-11 11:15,148,97,51,0,0,0
2022-06-11 11:30,147,76,71,0,0,0
2022-06-11 11:45,182,116,66,0,0,0
2022-06-11 12:00,181,115,66,0,0,0
2022-06-11 12:15,180,127,53,0,0,0
2022-06-11 12:30,172,101,71,0,0,0
2022-06-11 12:45,194,125,69,0,0,0
2022-06-11 13:00,158,96,62,0,0,0
2022-06-11 13:15,184,88,96,0,0,0
2022-06-11 13:30,152,84,68,0,0,0
2022-06-11 13:45,213,136,77,0,0,0
2022-06-11 14:00,190,100,90,0,0,0
2022-06-11 14:15,170,95,75,0,0,0
2022-06-11 14:30,146,76,70,0,0,0
2022-06-11 14:45,214,148,66,0,0,0
2022-06-11 15:00,192,122,70,0,0,0
2022-06-11 15:15,180,126,54,0,0,0
2022-06-11 15:30,184,115,69,0,0,0
2022-06-11 15:45,183,112,71,0,0,0
2022-06-11 16:00,151,79,72,0,0,0
2022-06-11 16:15,159,89,70,0,0,0
2022-06-11 16:30,180,85,95,0,0,0
2022-06-11 16:45,179,90,89,0,0,0
2022-06-11 17:00,144,66,78,0,0,0
2022-06-11 17:15,167,88,79,0,0,0
2022-06-11 17:30,188,82,106,0,0,0
2022-06-11 17:45,138,48,90,0,0,0
2022-06-11 18:00,164,68,96,0,0,0
2022-06-11 18:15,174,71,103,0,0,0
2022-06-11 18:30,144,65,79,0,0,0
2022-06-11 18:45,170,74,96,0,0,0
2022-06-11 19:00,140,65,75,0,0,0
2022-06-11 19:15,130,62,68,0,0,0
2022-06-11 19:30,108,55,53,0,0,0
2022-06-11 19:45,154,76,78,0,0,0
2022-06-11 20:00,129,66,63,0,0,0
2022-06-11 20:15,122,58,64,0,0,0
2022-06-11 20:30,109,47,62,0,0,0
2022-06-11 20:45,103,48,55,0,0,0
2022-06-11 21:00,101,37,64,0,0,0
2022-06-11 21:15,93,42,51,0,0,0
2022-06-11 21:30,69,31,38,0,0,0
2022-06-11 21:45,100,28,72,0,0,0
2022-06-11 22:00,98,35,63,0,0,0
2022-06-11 22:15,81,34,47,0,0,0
2022-06-11 22:30,79,19,60,0,0,0
2022-06-11 22:45,69,24,45,0,0,0
2022-06-11 23:00,76,26,50,0,0,0
2022-06-11 23:15,87,34,53,0,0,0
2022-06-11 23:30,74,33,41,0,0,0
2022-06-11 23:45,68,21,47,0,0,0
2022-06-12 00:00,98,19,79,0,0,0
2022-06-12 00:15,74,17,57,0,0,0
2022-06-12 00:30,82,27,55,0,0,0
2022-06-12 00:45,83,22,61,0,0,0
2022-06-12 01:00,68,23,45,0,0,0
2022-06-12 01:15,56,10,46,0,0,0
2022-06-12 01:30,41,10,31,0,0,0
2022-06-12 01:45,51,14,37,0,0,0
2022-06-12 02:00,68,20,48,0,0,0
2022-06-12 02:15,54,9,45,0,0,0
2022-06-12 02:30,25,10,15,0,0,0
2022-06-12 02:45,42,7,35,0,0,0
2022-06-12 03:00,37,7,30,0,0,0
2022-06-12 03:15,32,7,25,0,0,0
2022-06-12 03:30,30,3,27,0,0,0
2022-06-12 03:45,34,2,32,0,0,0
2022-06-12 04:00,19,1,18,0,0,0
2022-06-12 04:15,15,3,12,0,0,0
2022-06-12 04:30,26,5,21,0,0,0
2022-06-12 04:45,17,0,17,0,0,0
2022-06-12 05:00,14,2,12,0,0,0
2022-06-12 05:15,8,1,7,0,0,0
2022-06-12 05:30,22,5,17,0,0,0
2022-06-12 05:45,20,5,15,0,0,0
2022-06-12 06:00,12,3,9,0,0,0
2022-06-12 06:15,15,7,8,0,0,0
2022-06-12 06:30,11,3,8,0,0,0
2022-06-12 06:45,9,1,8,0,0,0
2022-06-12 07:00,9,4,5,0,0,0
2022-06-12 07:15,12,8,4,0,0,0
2022-06-12 07:30,14,4,10,0,0,0
2022-06-12 07:45,19,10,9,0,0,0
2022-06-12 08:00,21,14,7,0,0,0
2022-06-12 08:15,21,14,7,0,0,0
2022-06-12 08:30,21,8,13,0,0,0
2022-06-12 08:45,31,23,8,0,0,0
2022-06-12 09:00,39,12,27,0,0,0
2022-06-12 09:15,47,32,15,0,0,0
2022-06-12 09:30,60,38,22,0,0,0
2022-06-12 09:45,89,63,26,0,0,0
2022-06-12 10:00,75,45,30,0,0,0
2022-06-12 10:15,92,55,37,0,0,0
2022-06-12 10:30,88,52,36,0,0,0
2022-06-12 10:45,81,50,31,0,0,0
2022-06-12 11:00,76,48,28,0,0,0
2022-06-12 11:15,88,45,43,0,0,0
2022-06-12 11:30,110,45,65,0,0,0
2022-06-12 11:45,125,63,62,0,0,0
2022-06-12 12:00,121,61,60,0,0,0
2022-06-12 12:15,132,77,55,0,0,0
2022-06-12 12:30,113,56,57,0,0,0
2022-06-12 12:45,134,74,60,0,0,0
2022-06-12 13:00,117,62,55,0,0,0
2022-06-12 13:15,134,60,74,0,0,0
2022-06-12 13:30,138,70,68,0,0,0
2022-06-12 13:45,150,86,64,0,0,0
2022-06-12 14:00,136,70,66,0,0,0
2022-06-12 14:15,157,87,70,0,0,0
2022-06-12 14:30,158,95,63,0,0,0
2022-06-12 14:45,177,114,63,0,0,0
2022-06-12 15:00,140,87,53,0,0,0
2022-06-12 15:15,171,115,56,0,0,0
2022-06-12 15:30,145,80,65,0,0,0
2022-06-12 15:45,176,89,87,0,0,0
2022-06-12 16:00,163,81,82,0,0,0
2022-06-12 16:15,173,82,91,0,0,0
2022-06-12 16:30,171,82,89,0,0,0
2022-06-12 16:45,177,104,73,0,0,0
2022-06-12 17:00,162,94,68,0,0,0
2022-06-12 17:15,155,89,66,0,0,0
2022-06-12 17:30,164,88,76,0,0,0
2022-06-12 17:45,138,64,74,0,0,0
2022-06-12 18:00,160,74,86,0,0,0
2022-06-12 18:15,148,70,78,0,0,0
2022-06-12 18:30,150,64,86,0,0,0
2022-06-12 18:45,153,76,77,0,0,0
2022-06-12 19:00,144,79,65,0,0,0
2022-06-12 19:15,146,68,78,0,0,0
2022-06-12 19:30,107,53,54,0,0,0
2022-06-12 19:45,103,51,52,0,0,0
2022-06-12 20:00,118,60,58,0,0,0
2022-06-12 20:15,122,66,56,0,0,0
2022-06-12 20:30,113,49,64,0,0,0
2022-06-12 20:45,113,32,81,0,0,0
2022-06-12 21:00,81,33,48,0,0,0
2022-06-12 21:15,75,19,56,0,0,0
2022-06-12 21:30,98,25,73,0,0,0
2022-06-12 21:45,68,27,41,0,0,0
2022-06-12 22:00,72,20,52,0,0,0
2022-06-12 22:15,58,20,38,0,0,0
2022-06-12 22:30,57,20,37,0,0,0
2022-06-12 22:45,56,13,43,0,0,0
2022-06-12 23:00,47,12,35,0,0,0
2022-06-12 23:15,39,14,25,0,0,0
2022-06-12 23:30,24,2,22,0,0,0
2022-06-12 23:45,15,7,8,0,0,0
2022-06-13 00:00,25,5,20,0,0,0
2022-06-13 00:15,24,8,16,0,0,0
2022-06-13 00:30,7,1,6,0,0,0
2022-06-13 00:45,6,3,3,0,0,0
2022-06-13 01:00,7,1,6,0,0,0
2022-06-13 01:15,6,3,3,0,0,0
2022-06-13 01:30,6,4,2,0,0,0
2022-06-13 01:45,9,1,8,0,0,0
2022-06-13 02:00,1,0,1,0,0,0
2022-06-13 02:15,1,1,0,0,0,0
2022-06-13 02:30,1,0,1,0,0,0
2022-06-13 02:45,6,5,1,0,0,0
2022-06-13 03:00,2,1,1,0,0,0
2022-06-13 03:15,2,1,1,0,0,0
2022-06-13 03:30,1,1,0,0,0,0
2022-06-13 03:45,4,2,2,0,0,0
2022-06-13 04:00,1,1,0,0,0,0
2022-06-13 04:15,5,1,4,0,0,0
2022-06-13 04:30,6,4,2,0,0,0
2022-06-13 04:45,12,8,4,0,0,0
2022-06-13 05:00,8,5,3,0,0,0
2022-06-13 05:15,11,9,2,0,0,0
2022-06-13 05:30,22,14,8,0,0,0
2022-06-13 05:45,22,14,8,0,0,0
2022-06-13 06:00,17,9,8,0,0,0
2022-06-13 06:15,45,31,14,0,0,0
2022-06-13 06:30,60,38,22,0,0,0
2022-06-13 06:45,82,46,36,0,0,0
2022-06-13 07:00,86,42,44,0,0,0
2022-06-13 07:15,150,100,50,0,0,0
2022-06-13 07:30,280,200,80,0,0,0
2022-06-13 07:45,314,189,125,0,0,0
2022-06-13 08:00,278,149,129,0,0,0
2022-06-13 08:15,245,124,121,0,0,0
2022-06-13 08:30,193,109,84,0,0,0
2022-06-13 08:45,229,136,93,0,0,0
2022-06-13 09:00,178,101,77,0,0,0
2022-06-13 09:15,140,83,57,0,0,0
2022-06-13 09:30,130,70,60,0,0,0
2022-06-13 09:45,321,176,145,0,0,0
2022-06-13 10:00,296,150,146,0,0,0
2022-06-13 10:15,152,77,75,0,0,0
2022-06-13 10:30,111,53,58,0,0,0
2022-06-13 10:45,130,67,63,0,0,0
2022-06-13 11:00,120,55,65,0,0,0
2022-06-13 11:15,141,65,76,0,0,0
2022-06-13 11:30,176,75,101,0,0,0
2022-06-13 11:45,317,162,155,0,0,0
2022-06-13 12:00,290,181,109,0,0,0
2022-06-13 12:15,219,97,122,0,0,0
2022-06-13 12:30,174,72,102,0,0,0
2022-06-13 12:45,203,93,110,0,0,0
2022-06-13 13:00,256,128,128,0,0,0
2022-06-13 13:15,216,107,109,0,0,0
2022-06-13 13:30,203,108,95,0,0,0
2022-06-13 13:45,346,168,178,0,0,0
2022-06-13 14:00,347,189,158,0,0,0
2022-06-13 14:15,194,101,93,0,0,0
2022-06-13 14:30,173,97,76,0,0,0
2022-06-13 14:45,240,111,129,0,0,0
2022-06-13 15:00,201,108,93,0,0,0
2022-06-13 15:15,231,101,130,0,0,0
2022-06-13 15:30,269,133,136,0,0,0
2022-06-13 15:45,397,197,200,0,0,0
2022-06-13 16:00,381,211,170,0,0,0
2022-06-13 16:15,265,139,126,0,0,0
2022-06-13 16:30,224,103,121,0,0,0
2022-06-13 16:45,295,139,156,0,0,0
2022-06-13 17:00,266,126,140,0,0,0
2022-06-13 17:15,303,148,155,0,0,0
2022-06-13 17:30,352,170,182,0,0,0
2022-06-13 17:45,509,252,257,0,0,0
2022-06-13 18:00,363,167,196,0,0,0
2022-06-13 18:15,293,133,160,0,0,0
2022-06-13 18:30,275,117,158,0,0,0
2022-06-13 18:45,279,137,142,0,0,0
2022-06-13 19:00,240,107,133,0,0,0
2022-06-13 19:15,218,99,119,0,0,0
2022-06-13 19:30,229,106,123,0,0,0
2022-06-13 19:45,274,118,156,0,0,0
2022-06-13 20:00,216,82,134,0,0,0
2022-06-13 20:15,166,65,101,0,0,0
2022-06-13 20:30,144,52,92,0,0,0
2022-06-13 20:45,124,70,54,0,0,0
2022-06-13 21:00,139,68,71,0,0,0
2022-06-13 21:15,127,64,63,0,0,0
2022-06-13 21:30,130,52,78,0,0,0
2022-06-13 21:45,140,73,67,0,0,0
2022-06-13 22:00,179,87,92,0,0,0
2022-06-13 22:15,154,65,89,0,0,0
2022-06-13 22:30,94,52,42,0,0,0
2022-06-13 22:45,93,40,53,0,0,0
2022-06-13 23:00,64,20,44,0,0,0
2022-06-13 23:15,57,18,39,0,0,0
2022-06-13 23:30,50,17,33,0,0,0
2022-06-13 23:45,35,4,31,0,0,0
2022-06-14 00:00,23,6,17,0,0,0
2022-06-14 00:15,32,8,24,0,0,0
2022-06-14 00:30,17,5,12,0,0,0
2022-06-14 00:45,18,5,13,0,0,0
2022-06-14 01:00,28,10,18,0,0,0
2022-06-14 01:15,11,3,8,0,0,0
2022-06-14 01:30,6,0,6,0,0,0
2022-06-14 01:45,8,4,4,0,0,0
2022-06-14 02:00,4,2,2,0,0,0
2022-06-14 02:15,3,1,2,0,0,0
2022-06-14 02:30,3,3,0,0,0,0
2022-06-14 02:45,1,0,1,0,0,0
2022-06-14 03:00,5,4,1,0,0,0
2022-06-14 03:15,2,0,2,0,0,0
2022-06-14 03:30,6,1,5,0,0,0
2022-06-14 03:45,3,2,1,0,0,0
2022-06-14 04:00,2,0,2,0,0,0
2022-06-14 04:15,2,0,2,0,0,0
2022-06-14 04:30,9,8,1,0,0,0
2022-06-14 04:45,11,5,6,0,0,0
2022-06-14 05:00,7,5,2,0,0,0
2022-06-14 05:15,12,10,2,0,0,0
2022-06-14 05:30,20,15,5,0,0,0
2022-06-14 05:45,27,23,4,0,0,0
2022-06-14 06:00,36,25,11,0,0,0
2022-06-14 06:15,49,30,19,0,0,0
2022-06-14 06:30,64,38,26,0,0,0
2022-06-14 06:45,100,61,39,0,0,0
2022-06-14 07:00,111,70,41,0,0,0
2022-06-14 07:15,146,96,50,0,0,0
2022-06-14 07:30,258,174,84,0,0,0
2022-06-14 07:45,347,225,122,0,0,0
2022-06-14 08:00,415,227,188,0,0,0
2022-06-14 08:15,304,157,147,0,0,0
2022-06-14 08:30,216,125,91,0,0,0
2022-06-14 08:45,257,143,114,0,0,0
2022-06-14 09:00,200,132,68,0,0,0
2022-06-14 09:15,174,103,71,0,0,0
2022-06-14 09:30,145,96,49,0,0,0
2022-06-14 09:45,348,165,183,0,0,0
2022-06-14 10:00,428,236,192,0,0,0
2022-06-14 10:15,194,110,84,0,0,0
2022-06-14 10:30,162,85,77,0,0,0
2022-06-14 10:45,160,90,70,0,0,0
2022-06-14 11:00,169,84,85,0,0,0
2022-06-14 11:15,158,77,81,0,0,0
2022-06-14 11:30,193,94,99,0,0,0
2022-06-14 11:45,328,165,163,0,0,0
2022-06-14 12:00,354,191,163,0,0,0
2022-06-14 12:15,221,95,126,0,0,0
2022-06-14 12:30,235,115,120,0,0,0
2022-06-14 12:45,213,119,94,0,0,0
2022-06-14 13:00,252,106,146,0,0,0
2022-06-14 13:15,225,101,124,0,0,0
2022-06-14 13:30,261,138,123,0,0,0
2022-06-14 13:45,410,205,205,0,0,0
2022-06-14 14:00,400,235,165,0,0,0
2022-06-14 14:15,263,112,151,0,0,0
2022-06-14 14:30,187,87,100,0,0,0
2022-06-14 14:45,225,109,116,0,0,0
2022-06-14 15:00,200,93,107,0,0,0
2022-06-14 15:15,214,104,110,0,0,0
2022-06-14 15:30,288,147,141,0,0,0
2022-06-14 15:45,498,258,240,0,0,0
2022-06-14 16:00,430,208,222,0,0,0
2022-06-14 16:15,288,144,144,0,0,0
2022-06-14 16:30,266,126,140,0,0,0
2022-06-14 16:45,300,137,163,0,0,0
2022-06-14 17:00,357,165,192,0,0,0
2022-06-14 17:15,322,155,167,0,0,0
2022-06-14 17:30,379,179,200,0,0,0
2022-06-14 17:45,496,229,267,0,0,0
2022-06-14 18:00,429,236,193,0,0,0
2022-06-14 18:15,338,165,173,0,0,0
2022-06-14 18:30,276,132,144,0,0,0
2022-06-14 18:45,301,169,132,0,0,0
2022-06-14 19:00,283,148,135,0,0,0
2022-06-14 19:15,280,146,134,0,0,0
2022-06-14 19:30,260,134,126,0,0,0
2022-06-14 19:45,344,197,147,0,0,0
2022-06-14 20:00,252,129,123,0,0,0
2022-06-14 20:15,239,114,125,0,0,0
2022-06-14 20:30,176,72,104,0,0,0
2022-06-14 20:45,138,60,78,0,0,0
2022-06-14 21:00,137,59,78,0,0,0
2022-06-14 21:15,143,55,88,0,0,0
2022-06-14 21:30,161,66,95,0,0,0
2022-06-14 21:45,168,59,109,0,0,0
2022-06-14 22:00,153,51,102,0,0,0
2022-06-14 22:15,141,50,91,0,0,0
2022-06-14 22:30,107,55,52,0,0,0
2022-06-14 22:45,115,39,76,0,0,0
2022-06-14 23:00,82,42,40,0,0,0
2022-06-14 23:15,102,32,70,0,0,0
2022-06-14 23:30,68,26,42,0,0,0
2022-06-14 23:45,51,12,39,0,0,0
2022-06-15 00:00,62,21,41,0,0,0
2022-06-15 00:15,25,9,16,0,0,0
2022-06-15 00:30,11,2,9,0,0,0
2022-06-15 00:45,26,8,18,0,0,0
2022-06-15 01:00,18,9,9,0,0,0
2022-06-15 01:15,11,5,6,0,0,0
2022-06-15 01:30,5,1,4,0,0,0
2022-06-15 01:45,10,4,6,0,0,0
2022-06-15 02:00,6,1,5,0,0,0
2022-06-15 02:15,4,1,3,0,0,0
2022-06-15 02:30,8,0,8,0,0,0
2022-06-15 02:45,5,1,4,0,0,0
2022-06-15 03:00,10,3,7,0,0,0
2022-06-15 03:15,12,4,8,0,0,0
2022-06-15 03:30,9,2,7,0,0,0
2022-06-15 03:45,4,1,3,0,0,0
2022-06-15 04:00,4,4,0,0,0,0
2022-06-15 04:15,5,2,3,0,0,0
2022-06-15 04:30,11,6,5,0,0,0
2022-06-15 04:45,5,3,2,0,0,0
2022-06-15 05:00,13,9,4,0,0,0
2022-06-15 05:15,13,11,2,0,0,0
2022-06-15 05:30,25,19,6,0,0,0
2022-06-15 05:45,21,19,2,0,0,0
2022-06-15 06:00,39,28,11,0,0,0
2022-06-15 06:15,48,32,16,0,0,0
2022-06-15 06:30,74,46,28,0,0,0
2022-06-15 06:45,91,46,45,0,0,0
2022-06-15 07:00,119,71,48,0,0,0
2022-06-15 07:15,178,130,48,0,0,0
2022-06-15 07:30,299,206,93,0,0,0
2022-06-15 07:45,333,209,124,0,0,0
2022-06-15 08:00,365,201,164,0,0,0
2022-06-15 08:15,326,155,171,0,0,0
2022-06-15 08:30,227,128,99,0,0,0
2022-06-15 08:45,290,149,141,0,0,0
2022-06-15 09:00,225,124,101,0,0,0
2022-06-15 09:15,225,138,87,0,0,0
2022-06-15 09:30,198,119,79,0,0,0
2022-06-15 09:45,340,179,161,0,0,0
2022-06-15 10:00,416,241,175,0,0,0
2022-06-15 10:15,205,122,83,0,0,0
2022-06-15 10:30,172,105,67,0,0,0
2022-06-15 10:45,182,102,80,0,0,0
2022-06-15 11:00,166,83,83,0,0,0
2022-06-15 11:15,188,93,95,0,0,0
2022-06-15 11:30,235,132,103,0,0,0
2022-06-15 11:45,354,167,187,0,0,0
2022-06-15 12:00,368,201,167,0,0,0
2022-06-15 12:15,258,124,134,0,0,0
2022-06-15 12:30,239,123,116,0,0,0
2022-06-15 12:45,229,105,124,0,0,0
2022-06-15 13:00,273,107,166,0,0,0
2022-06-15 13:15,280,139,141,0,0,0
2022-06-15 13:30,269,140,129,0,0,0
2022-06-15 13:45,387,176,211,0,0,0
2022-06-15 14:00,349,165,184,0,0,0
2022-06-15 14:15,242,115,127,0,0,0
2022-06-15 14:30,247,121,126,0,0,0
2022-06-15 14:45,255,130,125,0,0,0
2022-06-15 15:00,224,107,117,0,0,0
2022-06-15 15:15,252,143,109,0,0,0
2022-06-15 15:30,246,122,124,0,0,0
2022-06-15 15:45,380,212,168,0,0,0
2022-06-15 16:00,359,199,160,0,0,0
2022-06-15 16:15,289,142,147,0,0,0
2022-06-15 16:30,275,135,140,0,0,0
2022-06-15 16:45,362,173,189,0,0,0
2022-06-15 17:00,295,152,143,0,0,0
2022-06-15 17:15,295,154,141,0,0,0
2022-06-15 17:30,337,167,170,0,0,0
2022-06-15 17:45,475,222,253,0,0,0
2022-06-15 18:00,359,189,170,0,0,0
2022-06-15 18:15,320,176,144,0,0,0
2022-06-15 18:30,285,156,129,0,0,0
2022-06-15 18:45,330,188,142,0,0,0
2022-06-15 19:00,316,184,132,0,0,0
2022-06-15 19:15,262,150,112,0,0,0
2022-06-15 19:30,281,147,134,0,0,0
2022-06-15 19:45,304,176,128,0,0,0
2022-06-15 20:00,266,142,124,0,0,0
2022-06-15 20:15,228,122,106,0,0,0
2022-06-15 20:30,218,118,100,0,0,0
2022-06-15 20:45,177,102,75,0,0,0
2022-06-15 21:00,195,96,99,0,0,0
2022-06-15 21:15,154,74,80,0,0,0
2022-06-15 21:30,128,63,65,0,0,0
2022-06-15 21:45,186,81,105,0,0,0
2022-06-15 22:00,204,69,135,0,0,0
2022-06-15 22:15,181,88,93,0,0,0
2022-06-15 22:30,136,40,96,0,0,0
2022-06-15 22:45,143,51,92,0,0,0
2022-06-15 23:00,126,45,81,0,0,0
2022-06-15 23:15,105,36,69,0,0,0
2022-06-15 23:30,129,57,72,0,0,0
2022-06-15 23:45,79,28,51,0,0,0
2022-06-16 00:00,88,31,57,0,0,0
2022-06-16 00:15,110,34,76,0,0,0
2022-06-16 00:30,100,38,62,0,0,0
2022-06-16 00:45,79,14,65,0,0,0
2022-06-16 01:00,66,25,41,0,0,0
2022-06-16 01:15,78,13,65,0,0,0
2022-06-16 01:30,72,19,53,0,0,0
2022-06-16 01:45,73,26,47,0,0,0
2022-06-16 02:00,53,6,47,0,0,0
2022-06-16 02:15,58,13,45,0,0,0
2022-06-16 02:30,31,5,26,0,0,0
2022-06-16 02:45,70,8,62,0,0,0
2022-06-16 03:00,44,14,30,0,0,0
2022-06-16 03:15,30,5,25,0,0,0
2022-06-16 03:30,44,7,37,0,0,0
2022-06-16 03:45,40,10,30,0,0,0
2022-06-16 04:00,28,3,25,0,0,0
2022-06-16 04:15,15,2,13,0,0,0
2022-06-16 04:30,22,9,13,0,0,0
2022-06-16 04:45,23,9,14,0,0,0
2022-06-16 05:00,12,5,7,0,0,0
2022-06-16 05:15,22,8,14,0,0,0
2022-06-16 05:30,23,7,16,0,0,0
2022-06-16 05:45,17,7,10,0,0,0
2022-06-16 06:00,16,8,8,0,0,0
2022-06-16 06:15,17,14,3,0,0,0
2022-06-16 06:30,25,14,11,0,0,0
2022-06-16 06:45,14,6,8,0,0,0
2022-06-16 07:00,18,7,11,0,0,0
2022-06-16 07:15,17,9,8,0,0,0
2022-06-16 07:30,25,15,10,0,0,0
2022-06-16 07:45,35,24,11,0,0,0
2022-06-16 08:00,32,19,13,0,0,0
2022-06-16 08:15,33,18,15,0,0,0
2022-06-16 08:30,45,17,28,0,0,0
2022-06-16 08:45,80,40,40,0,0,0
2022-06-16 09:00,50,29,21,0,0,0
2022-06-16 09:15,67,47,20,0,0,0
2022-06-16 09:30,67,47,20,0,0,0
2022-06-16 09:45,125,59,66,0,0,0
2022-06-16 10:00,103,50,53,0,0,0
2022-06-16 10:15,110,64,46,0,0,0
2022-06-16 10:30,71,45,26,0,0,0
2022-06-16 10:45,97,58,39,0,0,0
2022-06-16 11:00,78,45,33,0,0,0
2022-06-16 11:15,67,36,31,0,0,0
2022-06-16 11:30,98,54,44,0,0,0
2022-06-16 11:45,109,75,34,0,0,0
2022-06-16 12:00,139,76,63,0,0,0
2022-06-16 12:15,137,79,58,0,0,0
2022-06-16 12:30,120,71,49,0,0,0
2022-06-16 12:45,131,87,44,0,0,0
2022-06-16 13:00,132,73,59,0,0,0
2022-06-16 13:15,133,74,59,0,0,0
2022-06-16 13:30,170,99,71,0,0,0
2022-06-16 13:45,191,108,83,0,0,0
2022-06-16 14:00,148,84,64,0,0,0
2022-06-16 14:15,151,71,80,0,0,0
2022-06-16 14:30,159,107,52,0,0,0
2022-06-16 14:45,167,89,78,0,0,0
2022-06-16 15:00,181,109,72,0,0,0
2022-06-16 15:15,177,118,59,0,0,0
2022-06-16 15:30,174,109,65,0,0,0
2022-06-16 15:45,161,99,62,0,0,0
2022-06-16 16:00,118,75,43,0,0,0
2022-06-16 16:15,168,106,62,0,0,0
2022-06-16 16:30,153,90,63,0,0,0
2022-06-16 16:45,169,98,71,0,0,0
2022-06-16 17:00,146,81,65,0,0,0
2022-06-16 17:15,146,73,73,0,0,0
2022-06-16 17:30,168,101,67,0,0,0
2022-06-16 17:45,205,112,93,0,0,0
2022-06-16 18:00,184,100,84,0,0,0
2022-06-16 18:15,177,93,84,0,0,0
2022-06-16 18:30,173,94,79,0,0,0
2022-06-16 18:45,167,92,75,0,0,0
2022-06-16 19:00,157,82,75,0,0,0
2022-06-16 19:15,168,85,83,0,0,0
2022-06-16 19:30,170,93,77,0,0,0
2022-06-16 19:45,168,83,85,0,0,0
2022-06-16 20:00,148,67,81,0,0,0
2022-06-16 20:15,140,49,91,0,0,0
2022-06-16 20:30,145,56,89,0,0,0
2022-06-16 20:45,115,46,69,0,0,0
2022-06-16 21:00,107,47,60,0,0,0
2022-06-16 21:15,85,29,56,0,0,0
2022-06-16 21:30,84,26,58,0,0,0
2022-06-16 21:45,96,41,55,0,0,0
2022-06-16 22:00,120,41,79,0,0,0
2022-06-16 22:15,78,21,57,0,0,0
2022-06-16 22:30,108,30,78,0,0,0
2022-06-16 22:45,93,31,62,0,0,0
2022-06-16 23:00,75,18,57,0,0,0
2022-06-16 23:15,69,22,47,0,0,0
2022-06-16 23:30,40,11,29,0,0,0
2022-06-16 23:45,69,11,58,0,0,0
2022-06-17 00:00,39,11,28,0,0,0
2022-06-17 00:15,46,12,34,0,0,0
2022-06-17 00:30,50,18,32,0,0,0
2022-06-17 00:45,27,4,23,0,0,0
2022-06-17 01:00,35,14,21,0,0,0
2022-06-17 01:15,15,2,13,0,0,0
2022-06-17 01:30,14,4,10,0,0,0
2022-06-17 01:45,22,3,19,0,0,0
2022-06-17 02:00,12,4,8,0,0,0
2022-06-17 02:15,5,0,5,0,0,0
2022-06-17 02:30,6,2,4,0,0,0
2022-06-17 02:45,7,2,5,0,0,0
2022-06-17 03:00,2,0,2,0,0,0
2022-06-17 03:15,2,1,1,0,0,0
2022-06-17 03:30,4,1,3,0,0,0
2022-06-17 03:45,4,2,2,0,0,0
2022-06-17 04:00,3,0,3,0,0,0
2022-06-17 04:15,7,2,5,0,0,0
2022-06-17 04:30,7,2,5,0,0,0
2022-06-17 04:45,10,6,4,0,0,0
2022-06-17 05:00,12,9,3,0,0,0
2022-06-17 05:15,8,4,4,0,0,0
2022-06-17 05:30,23,18,5,0,0,0
2022-06-17 05:45,25,15,10,0,0,0
2022-06-17 06:00,31,19,12,0,0,0
2022-06-17 06:15,34,23,11,0,0,0
2022-06-17 06:30,55,33,22,0,0,0
2022-06-17 06:45,50,26,24,0,0,0
2022-06-17 07:00,58,39,19,0,0,0
2022-06-17 07:15,119,83,36,0,0,0
2022-06-17 07:30,206,149,57,0,0,0
2022-06-17 07:45,234,137,97,0,0,0
2022-06-17 08:00,186,106,80,0,0,0
2022-06-17 08:15,179,98,81,0,0,0
2022-06-17 08:30,134,82,52,0,0,0
2022-06-17 08:45,168,101,67,0,0,0
2022-06-17 09:00,152,89,63,0,0,0
2022-06-17 09:15,140,89,51,0,0,0
2022-06-17 09:30,144,87,57,0,0,0
2022-06-17 09:45,184,114,70,0,0,0
2022-06-17 10:00,210,114,96,0,0,0
2022-06-17 10:15,156,88,68,0,0,0
2022-06-17 10:30,144,71,73,0,0,0
2022-06-17 10:45,174,90,84,0,0,0
2022-06-17 11:00,166,73,93,0,0,0
2022-06-17 11:15,184,88,96,0,0,0
2022-06-17 11:30,174,92,82,0,0,0
2022-06-17 11:45,251,137,114,0,0,0
2022-06-17 12:00,261,136,125,0,0,0
2022-06-17 12:15,187,96,91,0,0,0
2022-06-17 12:30,177,87,90,0,0,0
2022-06-17 12:45,186,100,86,0,0,0
2022-06-17 13:00,195,88,107,0,0,0
2022-06-17 13:15,233,121,112,0,0,0
2022-06-17 13:30,201,115,86,0,0,0
2022-06-17 13:45,279,136,143,0,0,0
2022-06-17 14:00,259,126,133,0,0,0
2022-06-17 14:15,170,92,78,0,0,0
2022-06-17 14:30,191,89,102,0,0,0
2022-06-17 14:45,202,102,100,0,0,0
2022-06-17 15:00,185,97,88,0,0,0
2022-06-17 15:15,193,90,103,0,0,0
2022-06-17 15:30,207,102,105,0,0,0
2022-06-17 15:45,207,96,111,0,0,0
2022-06-17 16:00,238,108,130,0,0,0
2022-06-17 16:15,197,97,100,0,0,0
2022-06-17 16:30,187,96,91,0,0,0
2022-06-17 16:45,201,114,87,0,0,0
2022-06-17 17:00,199,86,113,0,0,0
2022-06-17 17:15,212,114,98,0,0,0
2022-06-17 17:30,260,148,112,0,0,0
2022-06-17 17:45,248,124,124,0,0,0
2022-06-17 18:00,258,121,137,0,0,0
2022-06-17 18:15,219,93,126,0,0,0
2022-06-17 18:30,201,117,84,0,0,0
2022-06-17 18:45,261,168,93,0,0,0
2022-06-17 19:00,264,154,110,0,0,0
2022-06-17 19:15,271,157,114,0,0,0
2022-06-17 19:30,256,160,96,0,0,0
2022-06-17 19:45,272,178,94,0,0,0
2022-06-17 20:00,226,154,72,0,0,0
2022-06-17 20:15,193,127,66,0,0,0
2022-06-17 20:30,218,148,70,0,0,0
2022-06-17 20:45,217,130,87,0,0,0
2022-06-17 21:00,194,105,89,0,0,0
2022-06-17 21:15,154,64,90,0,0,0
2022-06-17 21:30,144,71,73,0,0,0
2022-06-17 21:45,148,59,89,0,0,0
2022-06-17 22:00,146,67,79,0,0,0
2022-06-17 22:15,130,58,72,0,0,0
2022-06-17 22:30,139,45,94,0,0,0
2022-06-17 22:45,117,44,73,0,0,0
2022-06-17 23:00,134,61,73,0,0,0
2022-06-17 23:15,128,49,79,0,0,0
2022-06-17 23:30,128,30,98,0,0,0
2022-06-17 23:45,123,29,94,0,0,0
2022-06-18 00:00,114,26,88,0,0,0
2022-06-18 00:15,91,27,64,0,0,0
2022-06-18 00:30,100,24,76,0,0,0
2022-06-18 00:45,103,14,89,0,0,0
2022-06-18 01:00,67,16,51,0,0,0
2022-06-18 01:15,78,28,50,0,0,0
2022-06-18 01:30,61,14,47,0,0,0
2022-06-18 01:45,49,8,41,0,0,0
2022-06-18 02:00,56,10,46,0,0,0
2022-06-18 02:15,33,13,20,0,0,0
2022-06-18 02:30,16,4,12,0,0,0
2022-06-18 02:45,40,4,36,0,0,0
2022-06-18 03:00,41,8,33,0,0,0
2022-06-18 03:15,23,3,20,0,0,0
2022-06-18 03:30,36,6,30,0,0,0
2022-06-18 03:45,17,4,13,0,0,0
2022-06-18 04:00,16,4,12,0,0,0
2022-06-18 04:15,12,2,10,0,0,0
2022-06-18 04:30,12,2,10,0,0,0
2022-06-18 04:45,13,3,10,0,0,0
2022-06-18 05:00,15,6,9,0,0,0
2022-06-18 05:15,15,9,6,0,0,0
2022-06-18 05:30,23,14,9,0,0,0
2022-06-18 05:45,18,12,6,0,0,0
2022-06-18 06:00,11,3,8,0,0,0
2022-06-18 06:15,15,6,9,0,0,0
2022-06-18 06:30,19,15,4,0,0,0
2022-06-18 06:45,16,11,5,0,0,0
2022-06-18 07:00,25,19,6,0,0,0
2022-06-18 07:15,24,15,9,0,0,0
2022-06-18 07:30,43,27,16,0,0,0
2022-06-18 07:45,28,19,9,0,0,0
2022-06-18 08:00,57,35,22,0,0,0
2022-06-18 08:15,70,39,31,0,0,0
2022-06-18 08:30,72,42,30,0,0,0
2022-06-18 08:45,102,68,34,0,0,0
2022-06-18 09:00,77,56,21,0,0,0
2022-06-18 09:15,93,64,29,0,0,0
2022-06-18 09:30,124,95,29,0,0,0
2022-06-18 09:45,175,128,47,0,0,0
2022-06-18 10:00,173,120,53,0,0,0
2022-06-18 10:15,139,93,46,0,0,0
2022-06-18 10:30,145,87,58,0,0,0
2022-06-18 10:45,179,116,63,0,0,0
2022-06-18 11:00,114,77,37,0,0,0
2022-06-18 11:15,134,84,50,0,0,0
2022-06-18 11:30,157,112,45,0,0,0
2022-06-18 11:45,165,98,67,0,0,0
2022-06-18 12:00,150,83,67,0,0,0
2022-06-18 12:15,158,84,74,0,0,0
2022-06-18 12:30,133,74,59,0,0,0
2022-06-18 12:45,178,92,86,0,0,0
2022-06-18 13:00,157,94,63,0,0,0
2022-06-18 13:15,159,93,66,0,0,0
2022-06-18 13:30,164,84,80,0,0,0
2022-06-18 13:45,169,101,68,0,0,0
2022-06-18 14:00,178,91,87,0,0,0
2022-06-18 14:15,182,86,96,0,0,0
2022-06-18 14:30,152,78,74,0,0,0
2022-06-18 14:45,168,76,92,0,0,0
2022-06-18 15:00,135,85,50,0,0,0
2022-06-18 15:15,150,89,61,0,0,0
2022-06-18 15:30,148,90,58,0,0,0
2022-06-18 15:45,151,75,76,0,0,0
2022-06-18 16:00,166,99,67,0,0,0
2022-06-18 16:15,171,106,65,0,0,0
2022-06-18 16:30,104,56,48,0,0,0
2022-06-18 16:45,143,95,48,0,0,0
2022-06-18 17:00,126,57,69,0,0,0
2022-06-18 17:15,132,80,52,0,0,0
2022-06-18 17:30,164,84,80,0,0,0
2022-06-18 17:45,167,83,84,0,0,0
2022-06-18 18:00,171,81,90,0,0,0
2022-06-18 18:15,130,60,70,0,0,0
2022-06-18 18:30,126,61,65,0,0,0
2022-06-18 18:45,162,82,80,0,0,0
2022-06-18 19:00,164,74,90,0,0,0
2022-06-18 19:15,114,37,77,0,0,0
2022-06-18 19:30,139,57,82,0,0,0
2022-06-18 19:45,140,49,91,0,0,0
2022-06-18 20:00,126,47,79,0,0,0
2022-06-18 20:15,121,72,49,0,0,0
2022-06-18 20:30,101,51,50,0,0,0
2022-06-18 20:45,135,72,63,0,0,0
2022-06-18 21:00,104,55,49,0,0,0
2022-06-18 21:15,96,47,49,0,0,0
2022-06-18 21:30,110,51,59,0,0,0
2022-06-18 21:45,89,34,55,0,0,0
2022-06-18 22:00,95,38,57,0,0,0
2022-06-18 22:15,120,49,71,0,0,0
2022-06-18 22:30,97,35,62,0,0,0
2022-06-18 22:45,80,31,49,0,0,0
2022-06-18 23:00,105,38,67,0,0,0
2022-06-18 23:15,97,27,70,0,0,0
2022-06-18 23:30,78,28,50,0,0,0
2022-06-18 23:45,98,35,63,0,0,0
2022-06-19 00:00,65,16,49,0,0,0
2022-06-19 00:15,71,18,53,0,0,0
2022-06-19 00:30,84,27,57,0,0,0
2022-06-19 00:45,74,26,48,0,0,0
2022-06-19 01:00,74,16,58,0,0,0
2022-06-19 01:15,73,33,40,0,0,0
2022-06-19 01:30,47,17,30,0,0,0
2022-06-19 01:45,42,10,32,0,0,0
2022-06-19 02:00,58,12,46,0,0,0
2022-06-19 02:15,39,7,32,0,0,0
2022-06-19 02:30,22,7,15,0,0,0
2022-06-19 02:45,34,9,25,0,0,0
2022-06-19 03:00,29,4,25,0,0,0
2022-06-19 03:15,20,0,20,0,0,0
2022-06-19 03:30,33,4,29,0,0,0
2022-06-19 03:45,28,5,23,0,0,0
2022-06-19 04:00,24,3,21,0,0,0
2022-06-19 04:15,18,3,15,0,0,0
2022-06-19 04:30,12,3,9,0,0,0
2022-06-19 04:45,14,3,11,0,0,0
2022-06-19 05:00,9,2,7,0,0,0
2022-06-19 05:15,11,7,4,0,0,0
2022-06-19 05:30,9,4,5,0,0,0
2022-06-19 05:45,9,5,4,0,0,0
2022-06-19 06:00,8,4,4,0,0,0
2022-06-19 06:15,7,1,6,0,0,0
2022-06-19 06:30,9,7,2,0,0,0
2022-06-19 06:45,10,5,5,0,0,0
2022-06-19 07:00,18,8,10,0,0,0
2022-06-19 07:15,15,10,5,0,0,0
2022-06-19 07:30,12,7,5,0,0,0
2022-06-19 07:45,17,6,11,0,0,0
2022-06-19 08:00,15,9,6,0,0,0
2022-06-19 08:15,14,12,2,0,0,0
2022-06-19 08:30,17,10,7,0,0,0
2022-06-19 08:45,23,14,9,0,0,0
2022-06-19 09:00,47,32,15,0,0,0
2022-06-19 09:15,33,24,9,0,0,0
2022-06-19 09:30,67,40,27,0,0,0
2022-06-19 09:45,79,62,17,0,0,0
2022-06-19 10:00,69,50,19,0,0,0
2022-06-19 10:15,79,45,34,0,0,0
2022-06-19 10:30,80,53,27,0,0,0
2022-06-19 10:45,99,59,40,0,0,0
2022-06-19 11:00,97,61,36,0,0,0
2022-06-19 11:15,81,44,37,0,0,0
2022-06-19 11:30,84,43,41,0,0,0
2022-06-19 11:45,105,47,58,0,0,0
2022-06-19 12:00,80,42,38,0,0,0
2022-06-19 12:15,80,40,40,0,0,0
2022-06-19 12:30,71,33,38,0,0,0
2022-06-19 12:45,85,44,41,0,0,0
2022-06-19 13:00,97,58,39,0,0,0
2022-06-19 13:15,100,50,50,0,0,0
2022-06-19 13:30,130,77,53,0,0,0
2022-06-19 13:45,120,59,61,0,0,0
2022-06-19 14:00,117,68,49,0,0,0
2022-06-19 14:15,100,57,43,0,0,0
2022-06-19 14:30,104,46,58,0,0,0
2022-06-19 14:45,128,73,55,0,0,0
2022-06-19 15:00,99,49,50,0,0,0
2022-06-19 15:15,126,84,42,0,0,0
2022-06-19 15:30,107,52,55,0,0,0
2022-06-19 15:45,132,65,67,0,0,0
2022-06-19 16:00,125,75,50,0,0,0
2022-06-19 16:15,115,64,51,0,0,0
2022-06-19 16:30,79,40,39,0,0,0
2022-06-19 16:45,141,56,85,0,0,0
2022-06-19 17:00,120,39,81,0,0,0
2022-06-19 17:15,145,70,75,0,0,0
2022-06-19 17:30,122,57,65,0,0,0
2022-06-19 17:45,148,86,62,0,0,0
2022-06-19 18:00,129,51,78,0,0,0
2022-06-19 18:15,123,60,63,0,0,0
2022-06-19 18:30,112,58,54,0,0,0
2022-06-19 18:45,142,79,63,0,0,0
2022-06-19 19:00,101,39,62,0,0,0
2022-06-19 19:15,114,35,79,0,0,0
2022-06-19 19:30,108,49,59,0,0,0
2022-06-19 19:45,146,54,92,0,0,0
2022-06-19 20:00,83,41,42,0,0,0
2022-06-19 20:15,106,38,68,0,0,0
2022-06-19 20:30,65,20,45,0,0,0
2022-06-19 20:45,69,24,45,0,0,0
2022-06-19 21:00,77,18,59,0,0,0
2022-06-19 21:15,72,22,50,0,0,0
2022-06-19 21:30,84,27,57,0,0,0
2022-06-19 21:45,57,31,26,0,0,0
2022-06-19 22:00,72,26,46,0,0,0
2022-06-19 22:15,49,24,25,0,0,0
2022-06-19 22:30,47,11,36,0,0,0
2022-06-19 22:45,57,15,42,0,0,0
2022-06-19 23:00,31,7,24,0,0,0
2022-06-19 23:15,21,8,13,0,0,0
2022-06-19 23:30,24,4,20,0,0,0
2022-06-19 23:45,16,6,10,0,0,0
2022-06-20 00:00,17,4,13,0,0,0
2022-06-20 00:15,18,4,14,0,0,0
2022-06-20 00:30,11,3,8,0,0,0
2022-06-20 00:45,10,6,4,0,0,0
2022-06-20 01:00,7,4,3,0,0,0
2022-06-20 01:15,16,5,11,0,0,0
2022-06-20 01:30,8,1,7,0,0,0
2022-06-20 01:45,6,0,6,0,0,0
2022-06-20 02:00,5,1,4,0,0,0
2022-06-20 02:15,4,0,4,0,0,0
2022-06-20 02:30,2,2,0,0,0,0
2022-06-20 02:45,4,0,4,0,0,0
2022-06-20 03:00,3,2,1,0,0,0
2022-06-20 03:15,1,1,0,0,0,0
2022-06-20 03:30,2,0,2,0,0,0
2022-06-20 03:45,2,0,2,0,0,0
2022-06-20 04:00,4,2,2,0,0,0
2022-06-20 04:15,3,0,3,0,0,0
2022-06-20 04:30,7,4,3,0,0,0
2022-06-20 04:45,12,8,4,0,0,0
2022-06-20 05:00,8,6,2,0,0,0
2022-06-20 05:15,11,10,1,0,0,0
2022-06-20 05:30,19,7,12,0,0,0
2022-06-20 05:45,22,17,5,0,0,0
2022-06-20 06:00,32,25,7,0,0,0
2022-06-20 06:15,43,31,12,0,0,0
2022-06-20 06:30,69,44,25,0,0,0
2022-06-20 06:45,85,52,33,0,0,0
2022-06-20 07:00,92,53,39,0,0,0
2022-06-20 07:15,135,89,46,0,0,0
2022-06-20 07:30,264,194,70,0,0,0
2022-06-20 07:45,290,172,118,0,0,0
2022-06-20 08:00,293,150,143,0,0,0
2022-06-20 08:15,261,158,103,0,0,0
2022-06-20 08:30,231,141,90,0,0,0
2022-06-20 08:45,201,116,85,0,0,0
2022-06-20 09:00,193,114,79,0,0,0
2022-06-20 09:15,149,94,55,0,0,0
2022-06-20 09:30,179,110,69,0,0,0
2022-06-20 09:45,277,162,115,0,0,0
2022-06-20 10:00,285,154,131,0,0,0
2022-06-20 10:15,126,67,59,0,0,0
2022-06-20 10:30,145,73,72,0,0,0
2022-06-20 10:45,139,84,55,0,0,0
2022-06-20 11:00,121,58,63,0,0,0
2022-06-20 11:15,148,67,81,0,0,0
2022-06-20 11:30,160,75,85,0,0,0
2022-06-20 11:45,315,177,138,0,0,0
2022-06-20 12:00,290,161,129,0,0,0
2022-06-20 12:15,204,97,107,0,0,0
2022-06-20 12:30,188,89,99,0,0,0
2022-06-20 12:45,220,115,105,0,0,0
2022-06-20 13:00,243,103,140,0,0,0
2022-06-20 13:15,191,80,111,0,0,0
2022-06-20 13:30,221,104,117,0,0,0
2022-06-20 13:45,342,169,173,0,0,0
2022-06-20 14:00,357,207,150,0,0,0
2022-06-20 14:15,197,98,99,0,0,0
2022-06-20 14:30,179,94,85,0,0,0
2022-06-20 14:45,229,102,127,0,0,0
2022-06-20 15:00,195,103,92,0,0,0
2022-06-20 15:15,254,115,139,0,0,0
2022-06-20 15:30,236,109,127,0,0,0
2022-06-20 15:45,407,181,226,0,0,0
2022-06-20 16:00,362,205,157,0,0,0
2022-06-20 16:15,267,112,155,0,0,0
2022-06-20 16:30,275,139,136,0,0,0
2022-06-20 16:45,313,154,159,0,0,0
2022-06-20 17:00,285,135,150,0,0,0
2022-06-20 17:15,282,140,142,0,0,0
2022-06-20 17:30,308,147,161,0,0,0
2022-06-20 17:45,458,204,254,0,0,0
2022-06-20 18:00,387,198,189,0,0,0
2022-06-20 18:15,327,149,178,0,0,0
2022-06-20 18:30,271,116,155,0,0,0
2022-06-20 18:45,265,136,129,0,0,0
2022-06-20 19:00,263,116,147,0,0,0
2022-06-20 19:15,213,100,113,0,0,0
2022-06-20 19:30,209,90,119,0,0,0
2022-06-20 19:45,261,96,165,0,0,0
2022-06-20 20:00,210,104,106,0,0,0
2022-06-20 20:15,179,72,107,0,0,0
2022-06-20 20:30,131,56,75,0,0,0
2022-06-20 20:45,100,55,45,0,0,0
2022-06-20 21:00,113,55,58,0,0,0
2022-06-20 21:15,127,55,72,0,0,0
2022-06-20 21:30,122,43,79,0,0,0
2022-06-20 21:45,119,46,73,0,0,0
2022-06-20 22:00,122,51,71,0,0,0
2022-06-20 22:15,138,59,79,0,0,0
2022-06-20 22:30,63,22,41,0,0,0
2022-06-20 22:45,67,26,41,0,0,0
2022-06-20 23:00,89,35,54,0,0,0
2022-06-20 23:15,45,19,26,0,0,0
2022-06-20 23:30,35,14,21,0,0,0
2022-06-20 23:45,39,18,21,0,0,0
2022-06-21 00:00,42,9,33,0,0,0
2022-06-21 00:15,32,13,19,0,0,0
2022-06-21 00:30,20,7,13,0,0,0
2022-06-21 00:45,16,4,12,0,0,0
2022-06-21 01:00,13,4,9,0,0,0
2022-06-21 01:15,15,2,13,0,0,0
2022-06-21 01:30,10,5,5,0,0,0
2022-06-21 01:45,10,2,8,0,0,0
2022-06-21 02:00,4,2,2,0,0,0
2022-06-21 02:15,6,2,4,0,0,0
2022-06-21 02:30,5,3,2,0,0,0
2022-06-21 02:45,2,0,2,0,0,0
2022-06-21 03:00,3,2,1,0,0,0
2022-06-21 03:15,1,1,0,0,0,0
2022-06-21 03:30,0,0,0,0,0,0
2022-06-21 03:45,2,1,1,0,0,0
2022-06-21 04:00,5,2,3,0,0,0
2022-06-21 04:15,6,3,3,0,0,0
2022-06-21 04:30,5,3,2,0,0,0
2022-06-21 04:45,7,4,3,0,0,0
2022-06-21 05:00,13,12,1,0,0,0
2022-06-21 05:15,7,5,2,0,0,0
2022-06-21 05:30,29,17,12,0,0,0
2022-06-21 05:45,28,25,3,0,0,0
2022-06-21 06:00,41,26,15,0,0,0
2022-06-21 06:15,45,26,19,0,0,0
2022-06-21 06:30,68,44,24,0,0,0
2022-06-21 06:45,93,53,40,0,0,0
2022-06-21 07:00,108,70,38,0,0,0
2022-06-21 07:15,141,89,52,0,0,0
2022-06-21 07:30,290,195,95,0,0,0
2022-06-21 07:45,328,189,139,0,0,0
2022-06-21 08:00,372,203,169,0,0,0
2022-06-21 08:15,308,177,131,0,0,0
2022-06-21 08:30,205,128,77,0,0,0
2022-06-21 08:45,286,179,107,0,0,0
2022-06-21 09:00,220,148,72,0,0,0
2022-06-21 09:15,181,118,63,0,0,0
2022-06-21 09:30,180,105,75,0,0,0
2022-06-21 09:45,326,170,156,0,0,0
2022-06-21 10:00,429,255,174,0,0,0
2022-06-21 10:15,191,117,74,0,0,0
2022-06-21 10:30,152,79,73,0,0,0
2022-06-21 10:45,171,102,69,0,0,0
2022-06-21 11:00,145,72,73,0,0,0
2022-06-21 11:15,143,76,67,0,0,0
2022-06-21 11:30,178,81,97,0,0,0
2022-06-21 11:45,363,181,182,0,0,0
2022-06-21 12:00,358,171,187,0,0,0
2022-06-21 12:15,237,106,131,0,0,0
2022-06-21 12:30,203,113,90,0,0,0
2022-06-21 12:45,212,117,95,0,0,0
2022-06-21 13:00,279,100,179,0,0,0
2022-06-21 13:15,233,96,137,0,0,0
2022-06-21 13:30,286,168,118,0,0,0
2022-06-21 13:45,440,209,231,0,0,0
2022-06-21 14:00,403,212,191,0,0,0
2022-06-21 14:15,266,121,145,0,0,0
2022-06-21 14:30,200,100,100,0,0,0
2022-06-21 14:45,256,107,149,0,0,0
2022-06-21 15:00,217,94,123,0,0,0
2022-06-21 15:15,229,121,108,0,0,0
2022-06-21 15:30,282,147,135,0,0,0
2022-06-21 15:45,441,213,228,0,0,0
2022-06-21 16:00,393,202,191,0,0,0
2022-06-21 16:15,301,134,167,0,0,0
2022-06-21 16:30,278,125,153,0,0,0
2022-06-21 16:45,336,146,190,0,0,0
2022-06-21 17:00,306,156,150,0,0,0
2022-06-21 17:15,321,171,150,0,0,0
2022-06-21 17:30,349,185,164,0,0,0
2022-06-21 17:45,481,233,248,0,0,0
2022-06-21 18:00,437,233,204,0,0,0
2022-06-21 18:15,321,150,171,0,0,0
2022-06-21 18:30,262,127,135,0,0,0
2022-06-21 18:45,308,155,153,0,0,0
2022-06-21 19:00,275,137,138,0,0,0
2022-06-21 19:15,251,142,109,0,0,0
2022-06-21 19:30,233,111,122,0,0,0
2022-06-21 19:45,270,134,136,0,0,0
2022-06-21 20:00,252,146,106,0,0,0
2022-06-21 20:15,191,94,97,0,0,0
2022-06-21 20:30,176,82,94,0,0,0
2022-06-21 20:45,151,72,79,0,0,0
2022-06-21 21:00,190,87,103,0,0,0
2022-06-21 21:15,137,58,79,0,0,0
2022-06-21 21:30,147,60,87,0,0,0
2022-06-21 21:45,142,58,84,0,0,0
2022-06-21 22:00,135,53,82,0,0,0
2022-06-21 22:15,129,45,84,0,0,0
2022-06-21 22:30,120,54,66,0,0,0
2022-06-21 22:45,110,28,82,0,0,0
2022-06-21 23:00,109,24,85,0,0,0
2022-06-21 23:15,68,18,50,0,0,0
2022-06-21 23:30,54,20,34,0,0,0
2022-06-21 23:45,76,20,56,0,0,0
2022-06-22 00:00,48,16,32,0,0,0
2022-06-22 00:15,35,10,25,0,0,0
2022-06-22 00:30,22,5,17,0,0,0
2022-06-22 00:45,34,8,26,0,0,0
2022-06-22 01:00,27,4,23,0,0,0
2022-06-22 01:15,30,7,23,0,0,0
2022-06-22 01:30,12,2,10,0,0,0
2022-06-22 01:45,14,8,6,0,0,0
2022-06-22 02:00,4,1,3,0,0,0
2022-06-22 02:15,6,2,4,0,0,0
2022-06-22 02:30,1,0,1,0,0,0
2022-06-22 02:45,4,2,2,0,0,0
2022-06-22 03:00,3,0,3,0,0,0
2022-06-22 03:15,4,0,4,0,0,0
2022-06-22 03:30,0,0,0,0,0,0
2022-06-22 03:45,5,3,2,0,0,0
2022-06-22 04:00,3,1,2,0,0,0
2022-06-22 04:15,9,4,5,0,0,0
2022-06-22 04:30,10,5,5,0,0,0
2022-06-22 04:45,13,8,5,0,0,0
2022-06-22 05:00,15,11,4,0,0,0
2022-06-22 05:15,13,8,5,0,0,0
2022-06-22 05:30,16,9,7,0,0,0
2022-06-22 05:45,23,18,5,0,0,0
2022-06-22 06:00,33,21,12,0,0,0
2022-06-22 06:15,48,34,14,0,0,0
2022-06-22 06:30,81,55,26,0,0,0
2022-06-22 06:45,89,61,28,0,0,0
2022-06-22 07:00,100,69,31,0,0,0
2022-06-22 07:15,168,123,45,0,0,0
2022-06-22 07:30,296,200,96,0,0,0
2022-06-22 07:45,382,226,156,0,0,0
2022-06-22 08:00,373,209,164,0,0,0
2022-06-22 08:15,294,165,129,0,0,0
2022-06-22 08:30,270,166,104,0,0,0
2022-06-22 08:45,302,177,125,0,0,0
2022-06-22 09:00,258,155,103,0,0,0
2022-06-22 09:15,220,139,81,0,0,0
2022-06-22 09:30,217,126,91,0,0,0
2022-06-22 09:45,349,187,162,0,0,0
2022-06-22 10:00,414,273,141,0,0,0
2022-06-22 10:15,194,116,78,0,0,0
2022-06-22 10:30,182,99,83,0,0,0
2022-06-22 10:45,195,108,87,0,0,0
2022-06-22 11:00,174,100,74,0,0,0
2022-06-22 11:15,191,85,106,0,0,0
2022-06-22 11:30,222,115,107,0,0,0
2022-06-22 11:45,344,167,177,0,0,0
2022-06-22 12:00,290,158,132,0,0,0
2022-06-22 12:15,199,106,93,0,0,0
2022-06-22 12:30,260,103,157,0,0,0
2022-06-22 12:45,278,135,143,0,0,0
2022-06-22 13:00,311,136,175,0,0,0
2022-06-22 13:15,278,136,142,0,0,0
2022-06-22 13:30,313,164,149,0,0,0
2022-06-22 13:45,397,188,209,0,0,0
2022-06-22 14:00,376,208,168,0,0,0
2022-06-22 14:15,248,111,137,0,0,0
2022-06-22 14:30,241,115,126,0,0,0
2022-06-22 14:45,237,108,129,0,0,0
2022-06-22 15:00,240,108,132,0,0,0
2022-06-22 15:15,234,117,117,0,0,0
2022-06-22 15:30,258,124,134,0,0,0
2022-06-22 15:45,414,192,222,0,0,0
2022-06-22 16:00,426,213,213,0,0,0
2022-06-22 16:15,347,149,198,0,0,0
2022-06-22 16:30,357,160,197,0,0,0
2022-06-22 16:45,335,146,189,0,0,0
2022-06-22 17:00,346,161,185,0,0,0
2022-06-22 17:15,300,137,163,0,0,0
2022-06-22 17:30,340,145,195,0,0,0
2022-06-22 17:45,503,230,273,0,0,0
2022-06-22 18:00,376,173,203,0,0,0
2022-06-22 18:15,341,146,195,0,0,0
2022-06-22 18:30,353,175,178,0,0,0
2022-06-22 18:45,387,204,183,0,0,0
2022-06-22 19:00,345,167,178,0,0,0
2022-06-22 19:15,315,152,163,0,0,0
2022-06-22 19:30,264,144,120,0,0,0
2022-06-22 19:45,361,196,165,0,0,0
2022-06-22 20:00,262,149,113,0,0,0
2022-06-22 20:15,256,152,104,0,0,0
2022-06-22 20:30,212,107,105,0,0,0
2022-06-22 20:45,216,127,89,0,0,0
2022-06-22 21:00,222,109,113,0,0,0
2022-06-22 21:15,183,101,82,0,0,0
2022-06-22 21:30,191,95,96,0,0,0
2022-06-22 21:45,223,110,113,0,0,0
2022-06-22 22:00,198,104,94,0,0,0
2022-06-22 22:15,154,66,88,0,0,0
2022-06-22 22:30,141,50,91,0,0,0
2022-06-22 22:45,160,64,96,0,0,0
2022-06-22 23:00,99,38,61,0,0,0
2022-06-22 23:15,109,60,49,0,0,0
2022-06-22 23:30,127,60,67,0,0,0
2022-06-22 23:45,150,102,48,0,0,0
2022-06-23 00:00,110,71,39,0,0,0
2022-06-23 00:15,80,37,43,0,0,0
2022-06-23 00:30,48,25,23,0,0,0
2022-06-23 00:45,64,30,34,0,0,0
2022-06-23 01:00,49,16,33,0,0,0
2022-06-23 01:15,38,8,30,0,0,0
2022-06-23 01:30,33,8,25,0,0,0
2022-06-23 01:45,32,16,16,0,0,0
2022-06-23 02:00,48,6,42,0,0,0
2022-06-23 02:15,22,3,19,0,0,0
2022-06-23 02:30,26,1,25,0,0,0
2022-06-23 02:45,47,4,43,0,0,0
2022-06-23 03:00,22,2,20,0,0,0
2022-06-23 03:15,35,1,34,0,0,0
2022-06-23 03:30,30,3,27,0,0,0
2022-06-23 03:45,28,1,27,0,0,0
2022-06-23 04:00,22,2,20,0,0,0
2022-06-23 04:15,46,3,43,0,0,0
2022-06-23 04:30,18,4,14,0,0,0
2022-06-23 04:45,24,10,14,0,0,0
2022-06-23 05:00,18,10,8,0,0,0
2022-06-23 05:15,20,11,9,0,0,0
2022-06-23 05:30,24,12,12,0,0,0
2022-06-23 05:45,34,18,16,0,0,0
2022-06-23 06:00,44,30,14,0,0,0
2022-06-23 06:15,40,22,18,0,0,0
2022-06-23 06:30,75,45,30,0,0,0
2022-06-23 06:45,91,64,27,0,0,0
2022-06-23 07:00,115,75,40,0,0,0
2022-06-23 07:15,156,104,52,0,0,0
2022-06-23 07:30,244,166,78,0,0,0
2022-06-23 07:45,346,211,135,0,0,0
2022-06-23 08:00,387,201,186,0,0,0
2022-06-23 08:15,311,204,107,0,0,0
2022-06-23 08:30,239,155,84,0,0,0
2022-06-23 08:45,260,165,95,0,0,0
2022-06-23 09:00,197,108,89,0,0,0
2022-06-23 09:15,177,103,74,0,0,0
2022-06-23 09:30,266,126,140,0,0,0
2022-06-23 09:45,371,201,170,0,0,0
2022-06-23 10:00,418,232,186,0,0,0
2022-06-23 10:15,210,103,107,0,0,0
2022-06-23 10:30,131,71,60,0,0,0
2022-06-23 10:45,160,105,55,0,0,0
2022-06-23 11:00,150,72,78,0,0,0
2022-06-23 11:15,181,95,86,0,0,0
2022-06-23 11:30,221,102,119,0,0,0
2022-06-23 11:45,364,168,196,0,0,0
2022-06-23 12:00,329,173,156,0,0,0
2022-06-23 12:15,238,113,125,0,0,0
2022-06-23 12:30,202,100,102,0,0,0
2022-06-23 12:45,231,114,117,0,0,0
2022-06-23 13:00,254,105,149,0,0,0
2022-06-23 13:15,219,111,108,0,0,0
2022-06-23 13:30,242,125,117,0,0,0
2022-06-23 13:45,417,186,231,0,0,0
2022-06-23 14:00,363,197,166,0,0,0
2022-06-23 14:15,236,118,118,0,0,0
2022-06-23 14:30,210,108,102,0,0,0
2022-06-23 14:45,275,139,136,0,0,0
2022-06-23 15:00,238,98,140,0,0,0
2022-06-23 15:15,250,124,126,0,0,0
2022-06-23 15:30,293,147,146,0,0,0
2022-06-23 15:45,418,195,223,0,0,0
2022-06-23 16:00,399,203,196,0,0,0
2022-06-23 16:15,325,161,164,0,0,0
2022-06-23 16:30,281,149,132,0,0,0
2022-06-23 16:45,315,166,149,0,0,0
2022-06-23 17:00,252,144,108,0,0,0
2022-06-23 17:15,313,164,149,0,0,0
2022-06-23 17:30,359,191,168,0,0,0
2022-06-23 17:45,414,199,215,0,0,0
2022-06-23 18:00,354,191,163,0,0,0
2022-06-23 18:15,331,186,145,0,0,0
2022-06-23 18:30,272,143,129,0,0,0
2022-06-23 18:45,329,164,165,0,0,0
2022-06-23 19:00,277,133,144,0,0,0
2022-06-23 19:15,304,161,143,0,0,0
2022-06-23 19:30,247,104,143,0,0,0
2022-06-23 19:45,312,141,171,0,0,0
2022-06-23 20:00,211,93,118,0,0,0
2022-06-23 20:15,221,87,134,0,0,0
2022-06-23 20:30,176,61,115,0,0,0
2022-06-23 20:45,156,76,80,0,0,0
2022-06-23 21:00,164,62,102,0,0,0
2022-06-23 21:15,175,74,101,0,0,0
2022-06-23 21:30,160,61,99,0,0,0
2022-06-23 21:45,177,62,115,0,0,0
2022-06-23 22:00,167,59,108,0,0,0
2022-06-23 22:15,202,78,124,0,0,0
2022-06-23 22:30,144,42,102,0,0,0
2022-06-23 22:45,135,33,102,0,0,0
2022-06-23 23:00,126,43,83,0,0,0
2022-06-23 23:15,121,53,68,0,0,0
2022-06-23 23:30,115,36,79,0,0,0
2022-06-23 23:45,81,28,53,0,0,0
2022-06-24 00:00,82,27,55,0,0,0
2022-06-24 00:15,75,26,49,0,0,0
2022-06-24 00:30,58,17,41,0,0,0
2022-06-24 00:45,47,22,25,0,0,0
2022-06-24 01:00,45,16,29,0,0,0
2022-06-24 01:15,39,18,21,0,0,0
2022-06-24 01:30,28,9,19,0,0,0
2022-06-24 01:45,34,16,18,0,0,0
2022-06-24 02:00,26,15,11,0,0,0
2022-06-24 02:15,28,8,20,0,0,0
2022-06-24 02:30,12,2,10,0,0,0
2022-06-24 02:45,13,5,8,0,0,0
2022-06-24 03:00,12,6,6,0,0,0
2022-06-24 03:15,17,10,7,0,0,0
2022-06-24 03:30,14,8,6,0,0,0
2022-06-24 03:45,10,5,5,0,0,0
2022-06-24 04:00,11,5,6,0,0,0
2022-06-24 04:15,10,2,8,0,0,0
2022-06-24 04:30,7,4,3,0,0,0
2022-06-24 04:45,13,7,6,0,0,0
2022-06-24 05:00,15,13,2,0,0,0
2022-06-24 05:15,11,9,2,0,0,0
2022-06-24 05:30,15,9,6,0,0,0
2022-06-24 05:45,25,17,8,0,0,0
2022-06-24 06:00,34,20,14,0,0,0
2022-06-24 06:15,23,12,11,0,0,0
2022-06-24 06:30,53,38,15,0,0,0
2022-06-24 06:45,46,32,14,0,0,0
2022-06-24 07:00,77,46,31,0,0,0
2022-06-24 07:15,116,80,36,0,0,0
2022-06-24 07:30,203,154,49,0,0,0
2022-06-24 07:45,222,126,96,0,0,0
2022-06-24 08:00,164,91,73,0,0,0
2022-06-24 08:15,171,105,66,0,0,0
2022-06-24 08:30,128,71,57,0,0,0
2022-06-24 08:45,156,77,79,0,0,0
2022-06-24 09:00,88,56,32,0,0,0
2022-06-24 09:15,82,41,41,0,0,0
2022-06-24 09:30,125,80,45,0,0,0
2022-06-24 09:45,189,102,87,0,0,0
2022-06-24 10:00,230,116,114,0,0,0
2022-06-24 10:15,169,75,94,0,0,0
2022-06-24 10:30,163,64,99,0,0,0
2022-06-24 10:45,136,68,68,0,0,0
2022-06-24 11:00,120,62,58,0,0,0
2022-06-24 11:15,136,76,60,0,0,0
2022-06-24 11:30,151,86,65,0,0,0
2022-06-24 11:45,232,134,98,0,0,0
2022-06-24 12:00,211,120,91,0,0,0
2022-06-24 12:15,141,80,61,0,0,0
2022-06-24 12:30,158,89,69,0,0,0
2022-06-24 12:45,181,99,82,0,0,0
2022-06-24 13:00,166,82,84,0,0,0
2022-06-24 13:15,176,98,78,0,0,0
2022-06-24 13:30,158,70,88,0,0,0
2022-06-24 13:45,260,136,124,0,0,0
2022-06-24 14:00,223,127,96,0,0,0
2022-06-24 14:15,189,93,96,0,0,0
2022-06-24 14:30,178,93,85,0,0,0
2022-06-24 14:45,206,109,97,0,0,0
2022-06-24 15:00,176,90,86,0,0,0
2022-06-24 15:15,179,98,81,0,0,0
2022-06-24 15:30,163,87,76,0,0,0
2022-06-24 15:45,204,97,107,0,0,0
2022-06-24 16:00,192,95,97,0,0,0
2022-06-24 16:15,176,82,94,0,0,0
2022-06-24 16:30,169,101,68,0,0,0
2022-06-24 16:45,188,95,93,0,0,0
2022-06-24 17:00,200,93,107,0,0,0
2022-06-24 17:15,203,96,107,0,0,0
2022-06-24 17:30,211,104,107,0,0,0
2022-06-24 17:45,233,113,120,0,0,0
2022-06-24 18:00,217,112,105,0,0,0
2022-06-24 18:15,224,124,100,0,0,0
2022-06-24 18:30,195,92,103,0,0,0
2022-06-24 18:45,230,96,134,0,0,0
2022-06-24 19:00,183,84,99,0,0,0
2022-06-24 19:15,200,113,87,0,0,0
2022-06-24 19:30,170,88,82,0,0,0
2022-06-24 19:45,180,101,79,0,0,0
2022-06-24 20:00,183,97,86,0,0,0
2022-06-24 20:15,145,82,63,0,0,0
2022-06-24 20:30,141,69,72,0,0,0
2022-06-24 20:45,110,60,50,0,0,0
2022-06-24 21:00,119,67,52,0,0,0
2022-06-24 21:15,92,40,52,0,0,0
2022-06-24 21:30,107,50,57,0,0,0
2022-06-24 21:45,100,49,51,0,0,0
2022-06-24 22:00,77,36,41,0,0,0
2022-06-24 22:15,94,36,58,0,0,0
2022-06-24 22:30,103,41,62,0,0,0
2022-06-24 22:45,79,23,56,0,0,0
2022-06-24 23:00,74,30,44,0,0,0
2022-06-24 23:15,82,28,54,0,0,0
2022-06-24 23:30,85,29,56,0,0,0
2022-06-24 23:45,87,45,42,0,0,0
2022-06-25 00:00,93,50,43,0,0,0
2022-06-25 00:15,79,27,52,0,0,0
2022-06-25 00:30,61,20,41,0,0,0
2022-06-25 00:45,75,25,50,0,0,0
2022-06-25 01:00,56,15,41,0,0,0
2022-06-25 01:15,60,22,38,0,0,0
2022-06-25 01:30,69,27,42,0,0,0
2022-06-25 01:45,45,21,24,0,0,0
2022-06-25 02:00,58,22,36,0,0,0
2022-06-25 02:15,45,18,27,0,0,0
2022-06-25 02:30,24,5,19,0,0,0
2022-06-25 02:45,42,23,19,0,0,0
2022-06-25 03:00,29,11,18,0,0,0
2022-06-25 03:15,38,6,32,0,0,0
2022-06-25 03:30,28,8,20,0,0,0
2022-06-25 03:45,37,14,23,0,0,0
2022-06-25 04:00,21,9,12,0,0,0
2022-06-25 04:15,19,2,17,0,0,0
2022-06-25 04:30,24,7,17,0,0,0
2022-06-25 04:45,14,5,9,0,0,0
2022-06-25 05:00,12,3,9,0,0,0
2022-06-25 05:15,17,9,8,0,0,0
2022-06-25 05:30,26,10,16,0,0,0
2022-06-25 05:45,13,10,3,0,0,0
2022-06-25 06:00,14,7,7,0,0,0
2022-06-25 06:15,14,9,5,0,0,0
2022-06-25 06:30,11,6,5,0,0,0
2022-06-25 06:45,17,12,5,0,0,0
2022-06-25 07:00,14,12,2,0,0,0
2022-06-25 07:15,22,12,10,0,0,0
2022-06-25 07:30,32,20,12,0,0,0
2022-06-25 07:45,60,54,6,0,0,0
2022-06-25 08:00,42,30,12,0,0,0
2022-06-25 08:15,54,36,18,0,0,0
2022-06-25 08:30,94,62,32,0,0,0
2022-06-25 08:45,99,62,37,0,0,0
2022-06-25 09:00,96,66,30,0,0,0
2022-06-25 09:15,102,66,36,0,0,0
2022-06-25 09:30,117,88,29,0,0,0
2022-06-25 09:45,173,107,66,0,0,0
2022-06-25 10:00,144,102,42,0,0,0
2022-06-25 10:15,143,94,49,0,0,0
2022-06-25 10:30,142,96,46,0,0,0
2022-06-25 10:45,166,105,61,0,0,0
2022-06-25 11:00,120,80,40,0,0,0
2022-06-25 11:15,167,97,70,0,0,0
2022-06-25 11:30,160,104,56,0,0,0
2022-06-25 11:45,176,111,65,0,0,0
2022-06-25 12:00,158,104,54,0,0,0
2022-06-25 12:15,190,107,83,0,0,0
2022-06-25 12:30,161,88,73,0,0,0
2022-06-25 12:45,188,123,65,0,0,0
2022-06-25 13:00,187,89,98,0,0,0
2022-06-25 13:15,168,82,86,0,0,0
2022-06-25 13:30,129,62,67,0,0,0
2022-06-25 13:45,213,122,91,0,0,0
2022-06-25 14:00,168,88,80,0,0,0
2022-06-25 14:15,185,100,85,0,0,0
2022-06-25 14:30,176,83,93,0,0,0
2022-06-25 14:45,165,77,88,0,0,0
2022-06-25 15:00,173,91,82,0,0,0
2022-06-25 15:15,206,94,112,0,0,0
2022-06-25 15:30,195,110,85,0,0,0
2022-06-25 15:45,174,99,75,0,0,0
2022-06-25 16:00,164,80,84,0,0,0
2022-06-25 16:15,171,93,78,0,0,0
2022-06-25 16:30,174,79,95,0,0,0
2022-06-25 16:45,190,104,86,0,0,0
2022-06-25 17:00,159,75,84,0,0,0
2022-06-25 17:15,172,81,91,0,0,0
2022-06-25 17:30,177,90,87,0,0,0
2022-06-25 17:45,141,70,71,0,0,0
2022-06-25 18:00,215,100,115,0,0,0
2022-06-25 18:15,188,84,104,0,0,0
2022-06-25 18:30,181,83,98,0,0,0
2022-06-25 18:45,221,119,102,0,0,0
2022-06-25 19:00,201,108,93,0,0,0
2022-06-25 19:15,156,85,71,0,0,0
2022-06-25 19:30,184,94,90,0,0,0
2022-06-25 19:45,155,83,72,0,0,0
2022-06-25 20:00,172,97,75,0,0,0
2022-06-25 20:15,162,63,99,0,0,0
2022-06-25 20:30,120,55,65,0,0,0
2022-06-25 20:45,120,55,65,0,0,0
2022-06-25 21:00,135,80,55,0,0,0
2022-06-25 21:15,119,57,62,0,0,0
2022-06-25 21:30,125,34,91,0,0,0
2022-06-25 21:45,100,36,64,0,0,0
2022-06-25 22:00,111,45,66,0,0,0
2022-06-25 22:15,97,30,67,0,0,0
2022-06-25 22:30,129,30,99,0,0,0
2022-06-25 22:45,88,23,65,0,0,0
2022-06-25 23:00,136,38,98,0,0,0
2022-06-25 23:15,117,42,75,0,0,0
2022-06-25 23:30,79,36,43,0,0,0
2022-06-25 23:45,101,34,67,0,0,0
2022-06-26 00:00,88,32,56,0,0,0
2022-06-26 00:15,88,25,63,0,0,0
2022-06-26 00:30,77,27,50,0,0,0
2022-06-26 00:45,72,31,41,0,0,0
2022-06-26 01:00,51,15,36,0,0,0
2022-06-26 01:15,62,15,47,0,0,0
2022-06-26 01:30,64,22,42,0,0,0
2022-06-26 01:45,60,28,32,0,0,0
2022-06-26 02:00,61,20,41,0,0,0
2022-06-26 02:15,57,17,40,0,0,0
2022-06-26 02:30,31,6,25,0,0,0
2022-06-26 02:45,32,9,23,0,0,0
2022-06-26 03:00,42,9,33,0,0,0
2022-06-26 03:15,35,8,27,0,0,0
2022-06-26 03:30,23,6,17,0,0,0
2022-06-26 03:45,32,14,18,0,0,0
2022-06-26 04:00,21,13,8,0,0,0
2022-06-26 04:15,13,5,8,0,0,0
2022-06-26 04:30,11,4,7,0,0,0
2022-06-26 04:45,18,6,12,0,0,0
2022-06-26 05:00,19,3,16,0,0,0
2022-06-26 05:15,8,4,4,0,0,0
2022-06-26 05:30,15,4,11,0,0,0
2022-06-26 05:45,21,8,13,0,0,0
2022-06-26 06:00,13,8,5,0,0,0
2022-06-26 06:15,17,8,9,0,0,0
2022-06-26 06:30,9,7,2,0,0,0
2022-06-26 06:45,7,3,4,0,0,0
2022-06-26 07:00,12,3,9,0,0,0
2022-06-26 07:15,7,2,5,0,0,0
2022-06-26 07:30,10,6,4,0,0,0
2022-06-26 07:45,23,14,9,0,0,0
2022-06-26 08:00,17,11,6,0,0,0
2022-06-26 08:15,19,17,2,0,0,0
2022-06-26 08:30,24,10,14,0,0,0
2022-06-26 08:45,40,23,17,0,0,0
2022-06-26 09:00,50,36,14,0,0,0
2022-06-26 09:15,54,42,12,0,0,0
2022-06-26 09:30,68,55,13,0,0,0
2022-06-26 09:45,123,87,36,0,0,0
2022-06-26 10:00,76,50,26,0,0,0
2022-06-26 10:15,86,59,27,0,0,0
2022-06-26 10:30,118,85,33,0,0,0
2022-06-26 10:45,131,86,45,0,0,0
2022-06-26 11:00,100,68,32,0,0,0
2022-06-26 11:15,97,48,49,0,0,0
2022-06-26 11:30,90,55,35,0,0,0
2022-06-26 11:45,96,55,41,0,0,0
2022-06-26 12:00,116,58,58,0,0,0
2022-06-26 12:15,107,49,58,0,0,0
2022-06-26 12:30,89,52,37,0,0,0
2022-06-26 12:45,119,65,54,0,0,0
2022-06-26 13:00,154,70,84,0,0,0
2022-06-26 13:15,120,62,58,0,0,0
2022-06-26 13:30,116,61,55,0,0,0
2022-06-26 13:45,184,85,99,0,0,0
2022-06-26 14:00,171,90,81,0,0,0
2022-06-26 14:15,160,96,64,0,0,0
2022-06-26 14:30,148,91,57,0,0,0
2022-06-26 14:45,196,101,95,0,0,0
2022-06-26 15:00,123,55,68,0,0,0
2022-06-26 15:15,146,65,81,0,0,0
2022-06-26 15:30,153,73,80,0,0,0
2022-06-26 15:45,159,88,71,0,0,0
2022-06-26 16:00,178,86,92,0,0,0
2022-06-26 16:15,116,66,50,0,0,0
2022-06-26 16:30,140,74,66,0,0,0
2022-06-26 16:45,127,65,62,0,0,0
2022-06-26 17:00,118,62,56,0,0,0
2022-06-26 17:15,138,70,68,0,0,0
2022-06-26 17:30,152,97,55,0,0,0
2022-06-26 17:45,219,93,126,0,0,0
2022-06-26 18:00,128,63,65,0,0,0
2022-06-26 18:15,120,49,71,0,0,0
2022-06-26 18:30,127,70,57,0,0,0
2022-06-26 18:45,125,69,56,0,0,0
2022-06-26 19:00,112,54,58,0,0,0
2022-06-26 19:15,97,52,45,0,0,0
2022-06-26 19:30,102,47,55,0,0,0
2022-06-26 19:45,100,44,56,0,0,0
2022-06-26 20:00,112,41,71,0,0,0
2022-06-26 20:15,91,51,40,0,0,0
2022-06-26 20:30,103,31,72,0,0,0
2022-06-26 20:45,80,39,41,0,0,0
2022-06-26 21:00,77,41,36,0,0,0
2022-06-26 21:15,75,26,49,0,0,0
2022-06-26 21:30,70,22,48,0,0,0
2022-06-26 21:45,71,25,46,0,0,0
2022-06-26 22:00,82,18,64,0,0,0
2022-06-26 22:15,50,24,26,0,0,0
2022-06-26 22:30,47,21,26,0,0,0
2022-06-26 22:45,67,14,53,0,0,0
2022-06-26 23:00,57,10,47,0,0,0
2022-06-26 23:15,41,23,18,0,0,0
2022-06-26 23:30,24,9,15,0,0,0
2022-06-26 23:45,35,10,25,0,0,0
2022-06-27 00:00,20,11,9,0,0,0
2022-06-27 00:15,23,6,17,0,0,0
2022-06-27 00:30,12,5,7,0,0,0
2022-06-27 00:45,9,2,7,0,0,0
2022-06-27 01:00,7,1,6,0,0,0
2022-06-27 01:15,15,7,8,0,0,0
2022-06-27 01:30,8,4,4,0,0,0
2022-06-27 01:45,6,3,3,0,0,0
2022-06-27 02:00,5,2,3,0,0,0
2022-06-27 02:15,1,0,1,0,0,0
2022-06-27 02:30,2,0,2,0,0,0
2022-06-27 02:45,2,0,2,0,0,0
2022-06-27 03:00,0,0,0,0,0,0
2022-06-27 03:15,1,0,1,0,0,0
2022-06-27 03:30,3,0,3,0,0,0
2022-06-27 03:45,0,0,0,0,0,0
2022-06-27 04:00,1,0,1,0,0,0
2022-06-27 04:15,3,1,2,0,0,0
2022-06-27 04:30,0,0,0,0,0,0
2022-06-27 04:45,5,5,0,0,0,0
2022-06-27 05:00,11,9,2,0,0,0
2022-06-27 05:15,9,4,5,0,0,0
2022-06-27 05:30,12,7,5,0,0,0
2022-06-27 05:45,23,15,8,0,0,0
2022-06-27 06:00,34,20,14,0,0,0
2022-06-27 06:15,32,18,14,0,0,0
2022-06-27 06:30,67,35,32,0,0,0
2022-06-27 06:45,58,40,18,0,0,0
2022-06-27 07:00,86,55,31,0,0,0
2022-06-27 07:15,93,48,45,0,0,0
2022-06-27 07:30,192,113,79,0,0,0
2022-06-27 07:45,220,140,80,0,0,0
2022-06-27 08:00,257,144,113,0,0,0
2022-06-27 08:15,233,143,90,0,0,0
2022-06-27 08:30,233,124,109,0,0,0
2022-06-27 08:45,207,126,81,0,0,0
2022-06-27 09:00,166,99,67,0,0,0
2022-06-27 09:15,136,81,55,0,0,0
2022-06-27 09:30,150,82,68,0,0,0
2022-06-27 09:45,275,156,119,0,0,0
2022-06-27 10:00,277,157,120,0,0,0
2022-06-27 10:15,161,87,74,0,0,0
2022-06-27 10:30,97,57,40,0,0,0
2022-06-27 10:45,121,74,47,0,0,0
2022-06-27 11:00,122,67,55,0,0,0
2022-06-27 11:15,127,65,62,0,0,0
2022-06-27 11:30,140,64,76,0,0,0
2022-06-27 11:45,302,151,151,0,0,0
2022-06-27 12:00,290,162,128,0,0,0
2022-06-27 12:15,175,81,94,0,0,0
2022-06-27 12:30,161,88,73,0,0,0
2022-06-27 12:45,182,91,91,0,0,0
2022-06-27 13:00,225,119,106,0,0,0
2022-06-27 13:15,187,100,87,0,0,0
2022-06-27 13:30,186,98,88,0,0,0
2022-06-27 13:45,311,156,155,0,0,0
2022-06-27 14:00,370,212,158,0,0,0
2022-06-27 14:15,165,75,90,0,0,0
2022-06-27 14:30,160,77,83,0,0,0
2022-06-27 14:45,171,84,87,0,0,0
2022-06-27 15:00,147,77,70,0,0,0
2022-06-27 15:15,168,81,87,0,0,0
2022-06-27 15:30,218,99,119,0,0,0
2022-06-27 15:45,371,187,184,0,0,0
2022-06-27 16:00,355,186,169,0,0,0
2022-06-27 16:15,242,114,128,0,0,0
2022-06-27 16:30,233,109,124,0,0,0
2022-06-27 16:45,267,104,163,0,0,0
2022-06-27 17:00,276,116,160,0,0,0
2022-06-27 17:15,289,148,141,0,0,0
2022-06-27 17:30,307,128,179,0,0,0
2022-06-27 17:45,449,204,245,0,0,0
2022-06-27 18:00,336,154,182,0,0,0
2022-06-27 18:15,317,144,173,0,0,0
2022-06-27 18:30,163,70,93,0,0,0
2022-06-27 18:45,243,120,123,0,0,0
2022-06-27 19:00,233,100,133,0,0,0
2022-06-27 19:15,190,84,106,0,0,0
2022-06-27 19:30,224,81,143,0,0,0
2022-06-27 19:45,195,93,102,0,0,0
2022-06-27 20:00,196,83,113,0,0,0
2022-06-27 20:15,155,79,76,0,0,0
2022-06-27 20:30,130,75,55,0,0,0
2022-06-27 20:45,124,63,61,0,0,0
2022-06-27 21:00,101,52,49,0,0,0
2022-06-27 21:15,99,41,58,0,0,0
2022-06-27 21:30,101,34,67,0,0,0
2022-06-27 21:45,116,45,71,0,0,0
2022-06-27 22:00,108,49,59,0,0,0
2022-06-27 22:15,78,30,48,0,0,0
2022-06-27 22:30,56,20,36,0,0,0
2022-06-27 22:45,52,21,31,0,0,0
2022-06-27 23:00,54,14,40,0,0,0
2022-06-27 23:15,56,19,37,0,0,0
2022-06-27 23:30,39,17,22,0,0,0
2022-06-27 23:45,33,20,13,0,0,0
2022-06-28 00:00,36,12,24,0,0,0
2022-06-28 00:15,38,17,21,0,0,0
2022-06-28 00:30,18,3,15,0,0,0
2022-06-28 00:45,10,1,9,0,0,0
2022-06-28 01:00,10,4,6,0,0,0
2022-06-28 01:15,15,6,9,0,0,0
2022-06-28 01:30,13,1,12,0,0,0
2022-06-28 01:45,6,2,4,0,0,0
2022-06-28 02:00,4,2,2,0,0,0
2022-06-28 02:15,9,6,3,0,0,0
2022-06-28 02:30,3,1,2,0,0,0
2022-06-28 02:45,5,1,4,0,0,0
2022-06-28 03:00,9,1,8,0,0,0
2022-06-28 03:15,4,0,4,0,0,0
2022-06-28 03:30,2,0,2,0,0,0
2022-06-28 03:45,4,0,4,0,0,0
2022-06-28 04:00,1,1,0,0,0,0
2022-06-28 04:15,4,2,2,0,0,0
2022-06-28 04:30,3,1,2,0,0,0
2022-06-28 04:45,8,4,4,0,0,0
2022-06-28 05:00,7,6,1,0,0,0
2022-06-28 05:15,16,11,5,0,0,0
2022-06-28 05:30,29,18,11,0,0,0
2022-06-28 05:45,30,19,11,0,0,0
2022-06-28 06:00,32,22,10,0,0,0
2022-06-28 06:15,34,24,10,0,0,0
2022-06-28 06:30,66,39,27,0,0,0
2022-06-28 06:45,93,53,40,0,0,0
2022-06-28 07:00,99,60,39,0,0,0
2022-06-28 07:15,106,66,40,0,0,0
2022-06-28 07:30,191,106,85,0,0,0
2022-06-28 07:45,302,164,138,0,0,0
2022-06-28 08:00,346,186,160,0,0,0
2022-06-28 08:15,285,155,130,0,0,0
2022-06-28 08:30,214,109,105,0,0,0
2022-06-28 08:45,247,142,105,0,0,0
2022-06-28 09:00,221,147,74,0,0,0
2022-06-28 09:15,179,117,62,0,0,0
2022-06-28 09:30,195,106,89,0,0,0
2022-06-28 09:45,357,182,175,0,0,0
2022-06-28 10:00,418,246,172,0,0,0
2022-06-28 10:15,154,83,71,0,0,0
2022-06-28 10:30,149,82,67,0,0,0
2022-06-28 10:45,159,92,67,0,0,0
2022-06-28 11:00,169,86,83,0,0,0
2022-06-28 11:15,143,85,58,0,0,0
2022-06-28 11:30,185,97,88,0,0,0
2022-06-28 11:45,367,181,186,0,0,0
2022-06-28 12:00,351,191,160,0,0,0
2022-06-28 12:15,218,105,113,0,0,0
2022-06-28 12:30,181,92,89,0,0,0
2022-06-28 12:45,231,116,115,0,0,0
2022-06-28 13:00,197,104,93,0,0,0
2022-06-28 13:15,251,145,106,0,0,0
2022-06-28 13:30,249,129,120,0,0,0
2022-06-28 13:45,419,234,185,0,0,0
2022-06-28 14:00,368,213,155,0,0,0
2022-06-28 14:15,261,143,118,0,0,0
2022-06-28 14:30,196,104,92,0,0,0
2022-06-28 14:45,243,123,120,0,0,0
2022-06-28 15:00,212,94,118,0,0,0
2022-06-28 15:15,219,111,108,0,0,0
2022-06-28 15:30,251,121,130,0,0,0
2022-06-28 15:45,471,225,246,0,0,0
2022-06-28 16:00,419,226,193,0,0,0
2022-06-28 16:15,319,157,162,0,0,0
2022-06-28 16:30,264,140,124,0,0,0
2022-06-28 16:45,294,138,156,0,0,0
2022-06-28 17:00,309,169,140,0,0,0
2022-06-28 17:15,312,169,143,0,0,0
2022-06-28 17:30,343,165,178,0,0,0
2022-06-28 17:45,513,231,282,0,0,0
2022-06-28 18:00,377,197,180,0,0,0
2022-06-28 18:15,272,135,137,0,0,0
2022-06-28 18:30,277,138,139,0,0,0
2022-06-28 18:45,296,158,138,0,0,0
2022-06-28 19:00,235,121,114,0,0,0
2022-06-28 19:15,226,131,95,0,0,0
2022-06-28 19:30,248,124,124,0,0,0
2022-06-28 19:45,317,154,163,0,0,0
2022-06-28 20:00,245,139,106,0,0,0
2022-06-28 20:15,231,94,137,0,0,0
2022-06-28 20:30,155,75,80,0,0,0
2022-06-28 20:45,127,65,62,0,0,0
2022-06-28 21:00,163,70,93,0,0,0
2022-06-28 21:15,161,74,87,0,0,0
2022-06-28 21:30,111,58,53,0,0,0
2022-06-28 21:45,171,52,119,0,0,0
2022-06-28 22:00,123,41,82,0,0,0
2022-06-28 22:15,125,49,76,0,0,0
2022-06-28 22:30,137,34,103,0,0,0
2022-06-28 22:45,107,32,75,0,0,0
2022-06-28 23:00,103,28,75,0,0,0
2022-06-28 23:15,77,32,45,0,0,0
2022-06-28 23:30,74,23,51,0,0,0
2022-06-28 23:45,59,14,45,0,0,0
2022-06-29 00:00,51,13,38,0,0,0
2022-06-29 00:15,44,13,31,0,0,0
2022-06-29 00:30,37,9,28,0,0,0
2022-06-29 00:45,32,13,19,0,0,0
2022-06-29 01:00,17,4,13,0,0,0
2022-06-29 01:15,28,12,16,0,0,0
2022-06-29 01:30,24,9,15,0,0,0
2022-06-29 01:45,30,9,21,0,0,0
2022-06-29 02:00,16,5,11,0,0,0
2022-06-29 02:15,11,2,9,0,0,0
2022-06-29 02:30,12,1,11,0,0,0
2022-06-29 02:45,11,5,6,0,0,0
2022-06-29 03:00,11,2,9,0,0,0
2022-06-29 03:15,8,0,8,0,0,0
2022-06-29 03:30,9,1,8,0,0,0
2022-06-29 03:45,3,1,2,0,0,0
2022-06-29 04:00,12,1,11,0,0,0
2022-06-29 04:15,8,1,7,0,0,0
2022-06-29 04:30,3,1,2,0,0,0
2022-06-29 04:45,5,4,1,0,0,0
2022-06-29 05:00,6,6,0,0,0,0
2022-06-29 05:15,10,8,2,0,0,0
2022-06-29 05:30,20,14,6,0,0,0
2022-06-29 05:45,24,18,6,0,0,0
2022-06-29 06:00,33,22,11,0,0,0
2022-06-29 06:15,41,27,14,0,0,0
2022-06-29 06:30,87,48,39,0,0,0
2022-06-29 06:45,100,60,40,0,0,0
2022-06-29 07:00,109,73,36,0,0,0
2022-06-29 07:15,166,116,50,0,0,0
2022-06-29 07:30,195,118,77,0,0,0
2022-06-29 07:45,294,148,146,0,0,0
2022-06-29 08:00,344,172,172,0,0,0
2022-06-29 08:15,273,163,110,0,0,0
2022-06-29 08:30,215,115,100,0,0,0
2022-06-29 08:45,241,133,108,0,0,0
2022-06-29 09:00,231,142,89,0,0,0
2022-06-29 09:15,158,95,63,0,0,0
2022-06-29 09:30,188,98,90,0,0,0
2022-06-29 09:45,321,176,145,0,0,0
2022-06-29 10:00,414,244,170,0,0,0
2022-06-29 10:15,196,115,81,0,0,0
2022-06-29 10:30,151,79,72,0,0,0
2022-06-29 10:45,157,91,66,0,0,0
2022-06-29 11:00,140,76,64,0,0,0
2022-06-29 11:15,168,83,85,0,0,0
2022-06-29 11:30,174,97,77,0,0,0
2022-06-29 11:45,322,176,146,0,0,0
2022-06-29 12:00,319,177,142,0,0,0
2022-06-29 12:15,220,119,101,0,0,0
2022-06-29 12:30,212,78,134,0,0,0
2022-06-29 12:45,291,161,130,0,0,0
2022-06-29 13:00,249,116,133,0,0,0
2022-06-29 13:15,217,120,97,0,0,0
2022-06-29 13:30,265,115,150,0,0,0
2022-06-29 13:45,363,200,163,0,0,0
2022-06-29 14:00,365,188,177,0,0,0
2022-06-29 14:15,245,122,123,0,0,0
2022-06-29 14:30,210,101,109,0,0,0
2022-06-29 14:45,199,94,105,0,0,0
2022-06-29 15:00,207,92,115,0,0,0
2022-06-29 15:15,241,121,120,0,0,0
2022-06-29 15:30,236,124,112,0,0,0
2022-06-29 15:45,391,190,201,0,0,0
2022-06-29 16:00,395,196,199,0,0,0
2022-06-29 16:15,320,153,167,0,0,0
2022-06-29 16:30,288,144,144,0,0,0
2022-06-29 16:45,298,124,174,0,0,0
2022-06-29 17:00,319,153,166,0,0,0
2022-06-29 17:15,294,148,146,0,0,0
2022-06-29 17:30,320,167,153,0,0,0
2022-06-29 17:45,403,201,202,0,0,0
2022-06-29 18:00,373,168,205,0,0,0
2022-06-29 18:15,268,116,152,0,0,0
2022-06-29 18:30,269,124,145,0,0,0
2022-06-29 18:45,285,175,110,0,0,0
2022-06-29 19:00,281,152,129,0,0,0
2022-06-29 19:15,226,121,105,0,0,0
2022-06-29 19:30,240,116,124,0,0,0
2022-06-29 19:45,267,107,160,0,0,0
2022-06-29 20:00,224,135,89,0,0,0
2022-06-29 20:15,197,107,90,0,0,0
2022-06-29 20:30,166,73,93,0,0,0
2022-06-29 20:45,183,102,81,0,0,0
2022-06-29 21:00,148,67,81,0,0,0
2022-06-29 21:15,138,68,70,0,0,0
2022-06-29 21:30,160,75,85,0,0,0
2022-06-29 21:45,131,53,78,0,0,0
2022-06-29 22:00,138,49,89,0,0,0
2022-06-29 22:15,133,46,87,0,0,0
2022-06-29 22:30,141,60,81,0,0,0
2022-06-29 22:45,130,45,85,0,0,0
2022-06-29 23:00,123,49,74,0,0,0
2022-06-29 23:15,105,48,57,0,0,0
2022-06-29 23:30,111,40,71,0,0,0
2022-06-29 23:45,67,34,33,0,0,0
