Datetime,100035541 (Neutor),101035541 (Neutor stadteinwÃ¤rts),102035541 (Neutor stadtauswÃ¤rts),100035541-status,101035541-status,102035541-status
2022-03-01 00:00,24,8,16,0,0,0
2022-03-01 00:15,13,4,9,0,0,0
2022-03-01 00:30,15,7,8,0,0,0
2022-03-01 00:45,21,11,10,0,0,0
2022-03-01 01:00,13,4,9,0,0,0
2022-03-01 01:15,11,2,9,0,0,0
2022-03-01 01:30,8,2,6,0,0,0
2022-03-01 01:45,10,5,5,0,0,0
2022-03-01 02:00,7,2,5,0,0,0
2022-03-01 02:15,4,3,1,0,0,0
2022-03-01 02:30,4,3,1,0,0,0
2022-03-01 02:45,5,1,4,0,0,0
2022-03-01 03:00,4,2,2,0,0,0
2022-03-01 03:15,3,0,3,0,0,0
2022-03-01 03:30,3,0,3,0,0,0
2022-03-01 03:45,0,0,0,0,0,0
2022-03-01 04:00,3,2,1,0,0,0
2022-03-01 04:15,5,0,5,0,0,0
2022-03-01 04:30,3,1,2,0,0,0
2022-03-01 04:45,10,3,7,0,0,0
2022-03-01 05:00,7,4,3,0,0,0
2022-03-01 05:15,8,5,3,0,0,0
2022-03-01 05:30,22,18,4,0,0,0
2022-03-01 05:45,16,10,6,0,0,0
2022-03-01 06:00,27,19,8,0,0,0
2022-03-01 06:15,36,27,9,0,0,0
2022-03-01 06:30,61,42,19,0,0,0
2022-03-01 06:45,67,53,14,0,0,0
2022-03-01 07:00,102,69,33,0,0,0
2022-03-01 07:15,113,82,31,0,0,0
2022-03-01 07:30,168,102,66,0,0,0
2022-03-01 07:45,218,122,96,0,0,0
2022-03-01 08:00,172,107,65,0,0,0
2022-03-01 08:15,179,104,75,0,0,0
2022-03-01 08:30,139,74,65,0,0,0
2022-03-01 08:45,178,110,68,0,0,0
2022-03-01 09:00,112,65,47,0,0,0
2022-03-01 09:15,113,74,39,0,0,0
2022-03-01 09:30,103,59,44,0,0,0
2022-03-01 09:45,125,74,51,0,0,0
2022-03-01 10:00,96,59,37,0,0,0
2022-03-01 10:15,93,61,32,0,0,0
2022-03-01 10:30,99,56,43,0,0,0
2022-03-01 10:45,84,60,24,0,0,0
2022-03-01 11:00,101,53,48,0,0,0
2022-03-01 11:15,82,37,45,0,0,0
2022-03-01 11:30,104,63,41,0,0,0
2022-03-01 11:45,91,58,33,0,0,0
2022-03-01 12:00,109,53,56,0,0,0
2022-03-01 12:15,132,73,59,0,0,0
2022-03-01 12:30,108,52,56,0,0,0
2022-03-01 12:45,135,72,63,0,0,0
2022-03-01 13:00,158,87,71,0,0,0
2022-03-01 13:15,94,57,37,0,0,0
2022-03-01 13:30,146,70,76,0,0,0
2022-03-01 13:45,176,78,98,0,0,0
2022-03-01 14:00,140,67,73,0,0,0
2022-03-01 14:15,160,78,82,0,0,0
2022-03-01 14:30,113,56,57,0,0,0
2022-03-01 14:45,180,83,97,0,0,0
2022-03-01 15:00,165,75,90,0,0,0
2022-03-01 15:15,161,76,85,0,0,0
2022-03-01 15:30,186,87,99,0,0,0
2022-03-01 15:45,182,85,97,0,0,0
2022-03-01 16:00,166,93,73,0,0,0
2022-03-01 16:15,199,93,106,0,0,0
2022-03-01 16:30,219,106,113,0,0,0
2022-03-01 16:45,189,85,104,0,0,0
2022-03-01 17:00,198,97,101,0,0,0
2022-03-01 17:15,211,91,120,0,0,0
2022-03-01 17:30,198,99,99,0,0,0
2022-03-01 17:45,200,89,111,0,0,0
2022-03-01 18:00,185,78,107,0,0,0
2022-03-01 18:15,202,91,111,0,0,0
2022-03-01 18:30,193,89,104,0,0,0
2022-03-01 18:45,186,87,99,0,0,0
2022-03-01 19:00,150,75,75,0,0,0
2022-03-01 19:15,129,67,62,0,0,0
2022-03-01 19:30,139,64,75,0,0,0
2022-03-01 19:45,130,69,61,0,0,0
2022-03-01 20:00,114,35,79,0,0,0
2022-03-01 20:15,106,47,59,0,0,0
2022-03-01 20:30,71,29,42,0,0,0
2022-03-01 20:45,75,31,44,0,0,0
2022-03-01 21:00,76,28,48,0,0,0
2022-03-01 21:15,66,28,38,0,0,0
2022-03-01 21:30,53,18,35,0,0,0
2022-03-01 21:45,69,21,48,0,0,0
2022-03-01 22:00,67,16,51,0,0,0
2022-03-01 22:15,57,18,39,0,0,0
2022-03-01 22:30,55,24,31,0,0,0
2022-03-01 22:45,29,8,21,0,0,0
2022-03-01 23:00,44,18,26,0,0,0
2022-03-01 23:15,52,14,38,0,0,0
2022-03-01 23:30,21,4,17,0,0,0
2022-03-01 23:45,26,4,22,0,0,0
2022-03-02 00:00,19,5,14,0,0,0
2022-03-02 00:15,11,9,2,0,0,0
2022-03-02 00:30,13,7,6,0,0,0
2022-03-02 00:45,13,5,8,0,0,0
2022-03-02 01:00,17,6,11,0,0,0
2022-03-02 01:15,4,2,2,0,0,0
2022-03-02 01:30,3,1,2,0,0,0
2022-03-02 01:45,11,5,6,0,0,0
2022-03-02 02:00,8,2,6,0,0,0
2022-03-02 02:15,8,5,3,0,0,0
2022-03-02 02:30,0,0,0,0,0,0
2022-03-02 02:45,0,0,0,0,0,0
2022-03-02 03:00,8,0,8,0,0,0
2022-03-02 03:15,2,0,2,0,0,0
2022-03-02 03:30,0,0,0,0,0,0
2022-03-02 03:45,0,0,0,0,0,0
2022-03-02 04:00,3,3,0,0,0,0
2022-03-02 04:15,4,0,4,0,0,0
2022-03-02 04:30,6,4,2,0,0,0
2022-03-02 04:45,10,8,2,0,0,0
2022-03-02 05:00,5,4,1,0,0,0
2022-03-02 05:15,11,7,4,0,0,0
2022-03-02 05:30,16,10,6,0,0,0
2022-03-02 05:45,27,22,5,0,0,0
2022-03-02 06:00,27,18,9,0,0,0
2022-03-02 06:15,41,32,9,0,0,0
2022-03-02 06:30,54,37,17,0,0,0
2022-03-02 06:45,94,69,25,0,0,0
2022-03-02 07:00,100,62,38,0,0,0
2022-03-02 07:15,159,114,45,0,0,0
2022-03-02 07:30,246,183,63,0,0,0
2022-03-02 07:45,251,169,82,0,0,0
2022-03-02 08:00,179,100,79,0,0,0
2022-03-02 08:15,202,117,85,0,0,0
2022-03-02 08:30,158,106,52,0,0,0
2022-03-02 08:45,194,125,69,0,0,0
2022-03-02 09:00,146,90,56,0,0,0
2022-03-02 09:15,124,80,44,0,0,0
2022-03-02 09:30,150,102,48,0,0,0
2022-03-02 09:45,172,104,68,0,0,0
2022-03-02 10:00,114,69,45,0,0,0
2022-03-02 10:15,97,62,35,0,0,0
2022-03-02 10:30,116,69,47,0,0,0
2022-03-02 10:45,128,75,53,0,0,0
2022-03-02 11:00,114,57,57,0,0,0
2022-03-02 11:15,119,66,53,0,0,0
2022-03-02 11:30,134,72,62,0,0,0
2022-03-02 11:45,129,76,53,0,0,0
2022-03-02 12:00,111,61,50,0,0,0
2022-03-02 12:15,155,87,68,0,0,0
2022-03-02 12:30,133,68,65,0,0,0
2022-03-02 12:45,157,85,72,0,0,0
2022-03-02 13:00,156,73,83,0,0,0
2022-03-02 13:15,171,76,95,0,0,0
2022-03-02 13:30,164,82,82,0,0,0
2022-03-02 13:45,159,87,72,0,0,0
2022-03-02 14:00,171,89,82,0,0,0
2022-03-02 14:15,176,88,88,0,0,0
2022-03-02 14:30,169,77,92,0,0,0
2022-03-02 14:45,167,86,81,0,0,0
2022-03-02 15:00,186,73,113,0,0,0
2022-03-02 15:15,157,72,85,0,0,0
2022-03-02 15:30,217,67,150,0,0,0
2022-03-02 15:45,220,102,118,0,0,0
2022-03-02 16:00,212,92,120,0,0,0
2022-03-02 16:15,221,106,115,0,0,0
2022-03-02 16:30,228,106,122,0,0,0
2022-03-02 16:45,210,109,101,0,0,0
2022-03-02 17:00,242,115,127,0,0,0
2022-03-02 17:15,238,105,133,0,0,0
2022-03-02 17:30,230,108,122,0,0,0
2022-03-02 17:45,259,101,158,0,0,0
2022-03-02 18:00,232,91,141,0,0,0
2022-03-02 18:15,232,122,110,0,0,0
2022-03-02 18:30,174,77,97,0,0,0
2022-03-02 18:45,187,104,83,0,0,0
2022-03-02 19:00,157,72,85,0,0,0
2022-03-02 19:15,177,89,88,0,0,0
2022-03-02 19:30,118,58,60,0,0,0
2022-03-02 19:45,148,88,60,0,0,0
2022-03-02 20:00,163,70,93,0,0,0
2022-03-02 20:15,115,43,72,0,0,0
2022-03-02 20:30,75,33,42,0,0,0
2022-03-02 20:45,58,34,24,0,0,0
2022-03-02 21:00,72,27,45,0,0,0
2022-03-02 21:15,45,14,31,0,0,0
2022-03-02 21:30,57,14,43,0,0,0
2022-03-02 21:45,54,14,40,0,0,0
2022-03-02 22:00,82,24,58,0,0,0
2022-03-02 22:15,60,14,46,0,0,0
2022-03-02 22:30,74,27,47,0,0,0
2022-03-02 22:45,54,17,37,0,0,0
2022-03-02 23:00,43,10,33,0,0,0
2022-03-02 23:15,58,16,42,0,0,0
2022-03-02 23:30,33,5,28,0,0,0
2022-03-02 23:45,33,8,25,0,0,0
2022-03-03 00:00,29,5,24,0,0,0
2022-03-03 00:15,22,7,15,0,0,0
2022-03-03 00:30,12,6,6,0,0,0
2022-03-03 00:45,16,3,13,0,0,0
2022-03-03 01:00,19,4,15,0,0,0
2022-03-03 01:15,17,9,8,0,0,0
2022-03-03 01:30,8,4,4,0,0,0
2022-03-03 01:45,9,0,9,0,0,0
2022-03-03 02:00,8,2,6,0,0,0
2022-03-03 02:15,6,4,2,0,0,0
2022-03-03 02:30,1,0,1,0,0,0
2022-03-03 02:45,7,1,6,0,0,0
2022-03-03 03:00,3,1,2,0,0,0
2022-03-03 03:15,1,0,1,0,0,0
2022-03-03 03:30,0,0,0,0,0,0
2022-03-03 03:45,3,0,3,0,0,0
2022-03-03 04:00,4,1,3,0,0,0
2022-03-03 04:15,3,1,2,0,0,0
2022-03-03 04:30,5,2,3,0,0,0
2022-03-03 04:45,5,1,4,0,0,0
2022-03-03 05:00,5,5,0,0,0,0
2022-03-03 05:15,15,13,2,0,0,0
2022-03-03 05:30,17,12,5,0,0,0
2022-03-03 05:45,27,19,8,0,0,0
2022-03-03 06:00,27,16,11,0,0,0
2022-03-03 06:15,47,34,13,0,0,0
2022-03-03 06:30,46,27,19,0,0,0
2022-03-03 06:45,60,43,17,0,0,0
2022-03-03 07:00,87,60,27,0,0,0
2022-03-03 07:15,159,110,49,0,0,0
2022-03-03 07:30,262,201,61,0,0,0
2022-03-03 07:45,255,166,89,0,0,0
2022-03-03 08:00,158,97,61,0,0,0
2022-03-03 08:15,162,93,69,0,0,0
2022-03-03 08:30,181,112,69,0,0,0
2022-03-03 08:45,178,108,70,0,0,0
2022-03-03 09:00,135,75,60,0,0,0
2022-03-03 09:15,142,93,49,0,0,0
2022-03-03 09:30,121,77,44,0,0,0
2022-03-03 09:45,148,82,66,0,0,0
2022-03-03 10:00,107,66,41,0,0,0
2022-03-03 10:15,101,62,39,0,0,0
2022-03-03 10:30,104,60,44,0,0,0
2022-03-03 10:45,130,81,49,0,0,0
2022-03-03 11:00,82,44,38,0,0,0
2022-03-03 11:15,108,59,49,0,0,0
2022-03-03 11:30,94,52,42,0,0,0
2022-03-03 11:45,134,72,62,0,0,0
2022-03-03 12:00,114,54,60,0,0,0
2022-03-03 12:15,132,71,61,0,0,0
2022-03-03 12:30,153,77,76,0,0,0
2022-03-03 12:45,143,71,72,0,0,0
2022-03-03 13:00,140,67,73,0,0,0
2022-03-03 13:15,172,89,83,0,0,0
2022-03-03 13:30,140,72,68,0,0,0
2022-03-03 13:45,164,84,80,0,0,0
2022-03-03 14:00,156,67,89,0,0,0
2022-03-03 14:15,144,66,78,0,0,0
2022-03-03 14:30,155,74,81,0,0,0
2022-03-03 14:45,170,94,76,0,0,0
2022-03-03 15:00,192,90,102,0,0,0
2022-03-03 15:15,189,92,97,0,0,0
2022-03-03 15:30,259,105,154,0,0,0
2022-03-03 15:45,230,126,104,0,0,0
2022-03-03 16:00,192,92,100,0,0,0
2022-03-03 16:15,212,86,126,0,0,0
2022-03-03 16:30,225,101,124,0,0,0
2022-03-03 16:45,229,105,124,0,0,0
2022-03-03 17:00,226,106,120,0,0,0
2022-03-03 17:15,218,105,113,0,0,0
2022-03-03 17:30,213,111,102,0,0,0
2022-03-03 17:45,231,101,130,0,0,0
2022-03-03 18:00,220,99,121,0,0,0
2022-03-03 18:15,202,91,111,0,0,0
2022-03-03 18:30,188,68,120,0,0,0
2022-03-03 18:45,175,73,102,0,0,0
2022-03-03 19:00,150,79,71,0,0,0
2022-03-03 19:15,162,80,82,0,0,0
2022-03-03 19:30,118,68,50,0,0,0
2022-03-03 19:45,145,63,82,0,0,0
2022-03-03 20:00,109,42,67,0,0,0
2022-03-03 20:15,94,39,55,0,0,0
2022-03-03 20:30,71,29,42,0,0,0
2022-03-03 20:45,78,40,38,0,0,0
2022-03-03 21:00,80,37,43,0,0,0
2022-03-03 21:15,56,27,29,0,0,0
2022-03-03 21:30,42,21,21,0,0,0
2022-03-03 21:45,45,16,29,0,0,0
2022-03-03 22:00,53,24,29,0,0,0
2022-03-03 22:15,66,13,53,0,0,0
2022-03-03 22:30,57,13,44,0,0,0
2022-03-03 22:45,41,12,29,0,0,0
2022-03-03 23:00,37,11,26,0,0,0
2022-03-03 23:15,39,11,28,0,0,0
2022-03-03 23:30,26,8,18,0,0,0
2022-03-03 23:45,23,8,15,0,0,0
2022-03-04 00:00,32,7,25,0,0,0
2022-03-04 00:15,32,7,25,0,0,0
2022-03-04 00:30,17,3,14,0,0,0
2022-03-04 00:45,17,4,13,0,0,0
2022-03-04 01:00,10,5,5,0,0,0
2022-03-04 01:15,8,1,7,0,0,0
2022-03-04 01:30,9,2,7,0,0,0
2022-03-04 01:45,7,5,2,0,0,0
2022-03-04 02:00,11,4,7,0,0,0
2022-03-04 02:15,1,0,1,0,0,0
2022-03-04 02:30,2,1,1,0,0,0
2022-03-04 02:45,4,0,4,0,0,0
2022-03-04 03:00,1,0,1,0,0,0
2022-03-04 03:15,2,0,2,0,0,0
2022-03-04 03:30,3,0,3,0,0,0
2022-03-04 03:45,1,1,0,0,0,0
2022-03-04 04:00,2,0,2,0,0,0
2022-03-04 04:15,3,0,3,0,0,0
2022-03-04 04:30,4,2,2,0,0,0
2022-03-04 04:45,3,1,2,0,0,0
2022-03-04 05:00,10,6,4,0,0,0
2022-03-04 05:15,11,8,3,0,0,0
2022-03-04 05:30,11,8,3,0,0,0
2022-03-04 05:45,19,15,4,0,0,0
2022-03-04 06:00,31,21,10,0,0,0
2022-03-04 06:15,37,26,11,0,0,0
2022-03-04 06:30,55,31,24,0,0,0
2022-03-04 06:45,61,48,13,0,0,0
2022-03-04 07:00,88,63,25,0,0,0
2022-03-04 07:15,134,96,38,0,0,0
2022-03-04 07:30,233,184,49,0,0,0
2022-03-04 07:45,214,130,84,0,0,0
2022-03-04 08:00,149,89,60,0,0,0
2022-03-04 08:15,157,93,64,0,0,0
2022-03-04 08:30,136,100,36,0,0,0
2022-03-04 08:45,148,82,66,0,0,0
2022-03-04 09:00,130,86,44,0,0,0
2022-03-04 09:15,111,63,48,0,0,0
2022-03-04 09:30,109,68,41,0,0,0
2022-03-04 09:45,123,77,46,0,0,0
2022-03-04 10:00,112,70,42,0,0,0
2022-03-04 10:15,90,48,42,0,0,0
2022-03-04 10:30,86,46,40,0,0,0
2022-03-04 10:45,107,72,35,0,0,0
2022-03-04 11:00,99,59,40,0,0,0
2022-03-04 11:15,87,45,42,0,0,0
2022-03-04 11:30,114,62,52,0,0,0
2022-03-04 11:45,134,72,62,0,0,0
2022-03-04 12:00,137,69,68,0,0,0
2022-03-04 12:15,137,61,76,0,0,0
2022-03-04 12:30,159,89,70,0,0,0
2022-03-04 12:45,168,73,95,0,0,0
2022-03-04 13:00,203,89,114,0,0,0
2022-03-04 13:15,196,76,120,0,0,0
2022-03-04 13:30,167,89,78,0,0,0
2022-03-04 13:45,194,87,107,0,0,0
2022-03-04 14:00,229,91,138,0,0,0
2022-03-04 14:15,158,85,73,0,0,0
2022-03-04 14:30,160,90,70,0,0,0
2022-03-04 14:45,187,90,97,0,0,0
2022-03-04 15:00,172,87,85,0,0,0
2022-03-04 15:15,176,83,93,0,0,0
2022-03-04 15:30,191,89,102,0,0,0
2022-03-04 15:45,199,94,105,0,0,0
2022-03-04 16:00,145,75,70,0,0,0
2022-03-04 16:15,174,82,92,0,0,0
2022-03-04 16:30,160,86,74,0,0,0
2022-03-04 16:45,175,87,88,0,0,0
2022-03-04 17:00,175,86,89,0,0,0
2022-03-04 17:15,178,90,88,0,0,0
2022-03-04 17:30,174,75,99,0,0,0
2022-03-04 17:45,178,80,98,0,0,0
2022-03-04 18:00,182,66,116,0,0,0
2022-03-04 18:15,151,68,83,0,0,0
2022-03-04 18:30,150,61,89,0,0,0
2022-03-04 18:45,167,87,80,0,0,0
2022-03-04 19:00,135,62,73,0,0,0
2022-03-04 19:15,117,55,62,0,0,0
2022-03-04 19:30,111,54,57,0,0,0
2022-03-04 19:45,136,68,68,0,0,0
2022-03-04 20:00,114,50,64,0,0,0
2022-03-04 20:15,100,61,39,0,0,0
2022-03-04 20:30,80,38,42,0,0,0
2022-03-04 20:45,74,36,38,0,0,0
2022-03-04 21:00,60,23,37,0,0,0
2022-03-04 21:15,67,33,34,0,0,0
2022-03-04 21:30,43,18,25,0,0,0
2022-03-04 21:45,63,37,26,0,0,0
2022-03-04 22:00,53,20,33,0,0,0
2022-03-04 22:15,57,27,30,0,0,0
2022-03-04 22:30,41,9,32,0,0,0
2022-03-04 22:45,59,27,32,0,0,0
2022-03-04 23:00,59,22,37,0,0,0
2022-03-04 23:15,50,15,35,0,0,0
2022-03-04 23:30,61,22,39,0,0,0
2022-03-04 23:45,53,9,44,0,0,0
2022-03-05 00:00,54,16,38,0,0,0
2022-03-05 00:15,34,14,20,0,0,0
2022-03-05 00:30,38,17,21,0,0,0
2022-03-05 00:45,36,14,22,0,0,0
2022-03-05 01:00,28,3,25,0,0,0
2022-03-05 01:15,33,11,22,0,0,0
2022-03-05 01:30,32,14,18,0,0,0
2022-03-05 01:45,10,1,9,0,0,0
2022-03-05 02:00,35,9,26,0,0,0
2022-03-05 02:15,23,9,14,0,0,0
2022-03-05 02:30,9,2,7,0,0,0
2022-03-05 02:45,22,5,17,0,0,0
2022-03-05 03:00,19,2,17,0,0,0
2022-03-05 03:15,14,5,9,0,0,0
2022-03-05 03:30,15,1,14,0,0,0
2022-03-05 03:45,9,1,8,0,0,0
2022-03-05 04:00,14,4,10,0,0,0
2022-03-05 04:15,6,1,5,0,0,0
2022-03-05 04:30,12,5,7,0,0,0
2022-03-05 04:45,14,1,13,0,0,0
2022-03-05 05:00,11,5,6,0,0,0
2022-03-05 05:15,5,2,3,0,0,0
2022-03-05 05:30,19,11,8,0,0,0
2022-03-05 05:45,12,7,5,0,0,0
2022-03-05 06:00,7,3,4,0,0,0
2022-03-05 06:15,13,7,6,0,0,0
2022-03-05 06:30,18,8,10,0,0,0
2022-03-05 06:45,14,8,6,0,0,0
2022-03-05 07:00,15,14,1,0,0,0
2022-03-05 07:15,15,12,3,0,0,0
2022-03-05 07:30,24,15,9,0,0,0
2022-03-05 07:45,25,17,8,0,0,0
2022-03-05 08:00,36,22,14,0,0,0
2022-03-05 08:15,31,19,12,0,0,0
2022-03-05 08:30,37,25,12,0,0,0
2022-03-05 08:45,63,47,16,0,0,0
2022-03-05 09:00,65,41,24,0,0,0
2022-03-05 09:15,77,57,20,0,0,0
2022-03-05 09:30,90,54,36,0,0,0
2022-03-05 09:45,109,86,23,0,0,0
2022-03-05 10:00,95,58,37,0,0,0
2022-03-05 10:15,80,47,33,0,0,0
2022-03-05 10:30,113,76,37,0,0,0
2022-03-05 10:45,108,75,33,0,0,0
2022-03-05 11:00,103,70,33,0,0,0
2022-03-05 11:15,123,77,46,0,0,0
2022-03-05 11:30,119,67,52,0,0,0
2022-03-05 11:45,130,98,32,0,0,0
2022-03-05 12:00,116,66,50,0,0,0
2022-03-05 12:15,117,76,41,0,0,0
2022-03-05 12:30,148,82,66,0,0,0
2022-03-05 12:45,146,88,58,0,0,0
2022-03-05 13:00,163,82,81,0,0,0
2022-03-05 13:15,145,75,70,0,0,0
2022-03-05 13:30,149,95,54,0,0,0
2022-03-05 13:45,157,92,65,0,0,0
2022-03-05 14:00,142,62,80,0,0,0
2022-03-05 14:15,163,90,73,0,0,0
2022-03-05 14:30,132,58,74,0,0,0
2022-03-05 14:45,140,70,70,0,0,0
2022-03-05 15:00,149,67,82,0,0,0
2022-03-05 15:15,143,71,72,0,0,0
2022-03-05 15:30,155,79,76,0,0,0
2022-03-05 15:45,136,73,63,0,0,0
2022-03-05 16:00,125,46,79,0,0,0
2022-03-05 16:15,135,53,82,0,0,0
2022-03-05 16:30,115,52,63,0,0,0
2022-03-05 16:45,142,67,75,0,0,0
2022-03-05 17:00,87,41,46,0,0,0
2022-03-05 17:15,115,53,62,0,0,0
2022-03-05 17:30,110,31,79,0,0,0
2022-03-05 17:45,139,62,77,0,0,0
2022-03-05 18:00,115,48,67,0,0,0
2022-03-05 18:15,113,49,64,0,0,0
2022-03-05 18:30,117,59,58,0,0,0
2022-03-05 18:45,138,65,73,0,0,0
2022-03-05 19:00,105,48,57,0,0,0
2022-03-05 19:15,81,41,40,0,0,0
2022-03-05 19:30,69,34,35,0,0,0
2022-03-05 19:45,119,60,59,0,0,0
2022-03-05 20:00,70,31,39,0,0,0
2022-03-05 20:15,83,51,32,0,0,0
2022-03-05 20:30,63,34,29,0,0,0
2022-03-05 20:45,65,41,24,0,0,0
2022-03-05 21:00,52,30,22,0,0,0
2022-03-05 21:15,54,30,24,0,0,0
2022-03-05 21:30,59,26,33,0,0,0
2022-03-05 21:45,46,16,30,0,0,0
2022-03-05 22:00,51,16,35,0,0,0
2022-03-05 22:15,59,23,36,0,0,0
2022-03-05 22:30,43,14,29,0,0,0
2022-03-05 22:45,49,16,33,0,0,0
2022-03-05 23:00,45,15,30,0,0,0
2022-03-05 23:15,42,19,23,0,0,0
2022-03-05 23:30,39,16,23,0,0,0
2022-03-05 23:45,55,23,32,0,0,0
2022-03-06 00:00,38,6,32,0,0,0
2022-03-06 00:15,47,17,30,0,0,0
2022-03-06 00:30,32,6,26,0,0,0
2022-03-06 00:45,26,5,21,0,0,0
2022-03-06 01:00,32,10,22,0,0,0
2022-03-06 01:15,38,9,29,0,0,0
2022-03-06 01:30,25,9,16,0,0,0
2022-03-06 01:45,19,9,10,0,0,0
2022-03-06 02:00,21,7,14,0,0,0
2022-03-06 02:15,36,9,27,0,0,0
2022-03-06 02:30,18,7,11,0,0,0
2022-03-06 02:45,19,3,16,0,0,0
2022-03-06 03:00,17,4,13,0,0,0
2022-03-06 03:15,18,1,17,0,0,0
2022-03-06 03:30,23,2,21,0,0,0
2022-03-06 03:45,16,6,10,0,0,0
2022-03-06 04:00,11,2,9,0,0,0
2022-03-06 04:15,11,3,8,0,0,0
2022-03-06 04:30,4,2,2,0,0,0
2022-03-06 04:45,12,0,12,0,0,0
2022-03-06 05:00,11,4,7,0,0,0
2022-03-06 05:15,7,1,6,0,0,0
2022-03-06 05:30,16,5,11,0,0,0
2022-03-06 05:45,10,5,5,0,0,0
2022-03-06 06:00,6,2,4,0,0,0
2022-03-06 06:15,6,2,4,0,0,0
2022-03-06 06:30,10,3,7,0,0,0
2022-03-06 06:45,2,1,1,0,0,0
2022-03-06 07:00,5,4,1,0,0,0
2022-03-06 07:15,8,5,3,0,0,0
2022-03-06 07:30,12,7,5,0,0,0
2022-03-06 07:45,11,6,5,0,0,0
2022-03-06 08:00,14,10,4,0,0,0
2022-03-06 08:15,8,3,5,0,0,0
2022-03-06 08:30,10,8,2,0,0,0
2022-03-06 08:45,18,11,7,0,0,0
2022-03-06 09:00,25,20,5,0,0,0
2022-03-06 09:15,23,14,9,0,0,0
2022-03-06 09:30,50,37,13,0,0,0
2022-03-06 09:45,70,55,15,0,0,0
2022-03-06 10:00,54,39,15,0,0,0
2022-03-06 10:15,47,29,18,0,0,0
2022-03-06 10:30,46,34,12,0,0,0
2022-03-06 10:45,65,27,38,0,0,0
2022-03-06 11:00,53,36,17,0,0,0
2022-03-06 11:15,76,37,39,0,0,0
2022-03-06 11:30,57,32,25,0,0,0
2022-03-06 11:45,70,35,35,0,0,0
2022-03-06 12:00,54,35,19,0,0,0
2022-03-06 12:15,87,46,41,0,0,0
2022-03-06 12:30,76,44,32,0,0,0
2022-03-06 12:45,81,43,38,0,0,0
2022-03-06 13:00,70,42,28,0,0,0
2022-03-06 13:15,94,46,48,0,0,0
2022-03-06 13:30,109,58,51,0,0,0
2022-03-06 13:45,93,51,42,0,0,0
2022-03-06 14:00,113,69,44,0,0,0
2022-03-06 14:15,102,54,48,0,0,0
2022-03-06 14:30,99,50,49,0,0,0
2022-03-06 14:45,118,60,58,0,0,0
2022-03-06 15:00,95,47,48,0,0,0
2022-03-06 15:15,95,54,41,0,0,0
2022-03-06 15:30,113,58,55,0,0,0
2022-03-06 15:45,103,56,47,0,0,0
2022-03-06 16:00,76,38,38,0,0,0
2022-03-06 16:15,84,45,39,0,0,0
2022-03-06 16:30,91,43,48,0,0,0
2022-03-06 16:45,112,63,49,0,0,0
2022-03-06 17:00,89,46,43,0,0,0
2022-03-06 17:15,95,32,63,0,0,0
2022-03-06 17:30,82,39,43,0,0,0
2022-03-06 17:45,91,41,50,0,0,0
2022-03-06 18:00,104,44,60,0,0,0
2022-03-06 18:15,85,40,45,0,0,0
2022-03-06 18:30,64,24,40,0,0,0
2022-03-06 18:45,59,27,32,0,0,0
2022-03-06 19:00,54,26,28,0,0,0
2022-03-06 19:15,64,27,37,0,0,0
2022-03-06 19:30,66,25,41,0,0,0
2022-03-06 19:45,61,26,35,0,0,0
2022-03-06 20:00,62,26,36,0,0,0
2022-03-06 20:15,51,20,31,0,0,0
2022-03-06 20:30,49,20,29,0,0,0
2022-03-06 20:45,41,8,33,0,0,0
2022-03-06 21:00,24,8,16,0,0,0
2022-03-06 21:15,30,11,19,0,0,0
2022-03-06 21:30,22,5,17,0,0,0
2022-03-06 21:45,25,8,17,0,0,0
2022-03-06 22:00,21,7,14,0,0,0
2022-03-06 22:15,27,7,20,0,0,0
2022-03-06 22:30,40,10,30,0,0,0
2022-03-06 22:45,25,11,14,0,0,0
2022-03-06 23:00,21,10,11,0,0,0
2022-03-06 23:15,21,8,13,0,0,0
2022-03-06 23:30,11,6,5,0,0,0
2022-03-06 23:45,21,2,19,0,0,0
2022-03-07 00:00,8,2,6,0,0,0
2022-03-07 00:15,7,2,5,0,0,0
2022-03-07 00:30,1,1,0,0,0,0
2022-03-07 00:45,7,2,5,0,0,0
2022-03-07 01:00,6,3,3,0,0,0
2022-03-07 01:15,4,1,3,0,0,0
2022-03-07 01:30,3,1,2,0,0,0
2022-03-07 01:45,2,2,0,0,0,0
2022-03-07 02:00,1,0,1,0,0,0
2022-03-07 02:15,0,0,0,0,0,0
2022-03-07 02:30,1,1,0,0,0,0
2022-03-07 02:45,2,1,1,0,0,0
2022-03-07 03:00,1,1,0,0,0,0
2022-03-07 03:15,0,0,0,0,0,0
2022-03-07 03:30,0,0,0,0,0,0
2022-03-07 03:45,2,1,1,0,0,0
2022-03-07 04:00,0,0,0,0,0,0
2022-03-07 04:15,4,2,2,0,0,0
2022-03-07 04:30,5,3,2,0,0,0
2022-03-07 04:45,8,6,2,0,0,0
2022-03-07 05:00,7,5,2,0,0,0
2022-03-07 05:15,6,4,2,0,0,0
2022-03-07 05:30,20,13,7,0,0,0
2022-03-07 05:45,26,19,7,0,0,0
2022-03-07 06:00,29,13,16,0,0,0
2022-03-07 06:15,36,28,8,0,0,0
2022-03-07 06:30,47,32,15,0,0,0
2022-03-07 06:45,83,66,17,0,0,0
2022-03-07 07:00,77,50,27,0,0,0
2022-03-07 07:15,162,120,42,0,0,0
2022-03-07 07:30,308,236,72,0,0,0
2022-03-07 07:45,253,161,92,0,0,0
2022-03-07 08:00,140,91,49,0,0,0
2022-03-07 08:15,190,125,65,0,0,0
2022-03-07 08:30,160,98,62,0,0,0
2022-03-07 08:45,154,84,70,0,0,0
2022-03-07 09:00,120,79,41,0,0,0
2022-03-07 09:15,114,69,45,0,0,0
2022-03-07 09:30,122,71,51,0,0,0
2022-03-07 09:45,122,62,60,0,0,0
2022-03-07 10:00,100,62,38,0,0,0
2022-03-07 10:15,116,59,57,0,0,0
2022-03-07 10:30,98,48,50,0,0,0
2022-03-07 10:45,122,72,50,0,0,0
2022-03-07 11:00,86,55,31,0,0,0
2022-03-07 11:15,101,58,43,0,0,0
2022-03-07 11:30,82,49,33,0,0,0
2022-03-07 11:45,114,70,44,0,0,0
2022-03-07 12:00,101,44,57,0,0,0
2022-03-07 12:15,117,57,60,0,0,0
2022-03-07 12:30,137,70,67,0,0,0
2022-03-07 12:45,155,86,69,0,0,0
2022-03-07 13:00,127,52,75,0,0,0
2022-03-07 13:15,167,80,87,0,0,0
2022-03-07 13:30,135,74,61,0,0,0
2022-03-07 13:45,166,91,75,0,0,0
2022-03-07 14:00,141,55,86,0,0,0
2022-03-07 14:15,144,73,71,0,0,0
2022-03-07 14:30,148,70,78,0,0,0
2022-03-07 14:45,167,73,94,0,0,0
2022-03-07 15:00,151,58,93,0,0,0
2022-03-07 15:15,166,90,76,0,0,0
2022-03-07 15:30,226,85,141,0,0,0
2022-03-07 15:45,204,95,109,0,0,0
2022-03-07 16:00,166,78,88,0,0,0
2022-03-07 16:15,202,102,100,0,0,0
2022-03-07 16:30,193,94,99,0,0,0
2022-03-07 16:45,205,86,119,0,0,0
2022-03-07 17:00,208,92,116,0,0,0
2022-03-07 17:15,228,106,122,0,0,0
2022-03-07 17:30,229,114,115,0,0,0
2022-03-07 17:45,230,132,98,0,0,0
2022-03-07 18:00,222,99,123,0,0,0
2022-03-07 18:15,195,93,102,0,0,0
2022-03-07 18:30,178,80,98,0,0,0
2022-03-07 18:45,170,83,87,0,0,0
2022-03-07 19:00,131,58,73,0,0,0
2022-03-07 19:15,120,60,60,0,0,0
2022-03-07 19:30,135,66,69,0,0,0
2022-03-07 19:45,111,57,54,0,0,0
2022-03-07 20:00,82,25,57,0,0,0
2022-03-07 20:15,100,31,69,0,0,0
2022-03-07 20:30,67,25,42,0,0,0
2022-03-07 20:45,64,25,39,0,0,0
2022-03-07 21:00,37,17,20,0,0,0
2022-03-07 21:15,52,22,30,0,0,0
2022-03-07 21:30,67,14,53,0,0,0
2022-03-07 21:45,53,17,36,0,0,0
2022-03-07 22:00,47,9,38,0,0,0
2022-03-07 22:15,44,13,31,0,0,0
2022-03-07 22:30,32,13,19,0,0,0
2022-03-07 22:45,32,6,26,0,0,0
2022-03-07 23:00,26,9,17,0,0,0
2022-03-07 23:15,20,4,16,0,0,0
2022-03-07 23:30,23,3,20,0,0,0
2022-03-07 23:45,20,4,16,0,0,0
2022-03-08 00:00,17,8,9,0,0,0
2022-03-08 00:15,18,8,10,0,0,0
2022-03-08 00:30,8,2,6,0,0,0
2022-03-08 00:45,9,5,4,0,0,0
2022-03-08 01:00,3,1,2,0,0,0
2022-03-08 01:15,2,1,1,0,0,0
2022-03-08 01:30,5,1,4,0,0,0
2022-03-08 01:45,10,3,7,0,0,0
2022-03-08 02:00,2,2,0,0,0,0
2022-03-08 02:15,2,0,2,0,0,0
2022-03-08 02:30,0,0,0,0,0,0
2022-03-08 02:45,0,0,0,0,0,0
2022-03-08 03:00,4,3,1,0,0,0
2022-03-08 03:15,1,0,1,0,0,0
2022-03-08 03:30,1,1,0,0,0,0
2022-03-08 03:45,4,3,1,0,0,0
2022-03-08 04:00,0,0,0,0,0,0
2022-03-08 04:15,2,0,2,0,0,0
2022-03-08 04:30,9,5,4,0,0,0
2022-03-08 04:45,6,4,2,0,0,0
2022-03-08 05:00,7,6,1,0,0,0
2022-03-08 05:15,9,6,3,0,0,0
2022-03-08 05:30,25,17,8,0,0,0
2022-03-08 05:45,24,13,11,0,0,0
2022-03-08 06:00,23,11,12,0,0,0
2022-03-08 06:15,34,25,9,0,0,0
2022-03-08 06:30,64,44,20,0,0,0
2022-03-08 06:45,88,63,25,0,0,0
2022-03-08 07:00,102,74,28,0,0,0
2022-03-08 07:15,142,106,36,0,0,0
2022-03-08 07:30,292,232,60,0,0,0
2022-03-08 07:45,261,179,82,0,0,0
2022-03-08 08:00,166,110,56,0,0,0
2022-03-08 08:15,202,120,82,0,0,0
2022-03-08 08:30,162,99,63,0,0,0
2022-03-08 08:45,175,101,74,0,0,0
2022-03-08 09:00,127,76,51,0,0,0
2022-03-08 09:15,117,85,32,0,0,0
2022-03-08 09:30,136,75,61,0,0,0
2022-03-08 09:45,120,69,51,0,0,0
2022-03-08 10:00,92,49,43,0,0,0
2022-03-08 10:15,89,53,36,0,0,0
2022-03-08 10:30,111,69,42,0,0,0
2022-03-08 10:45,112,53,59,0,0,0
2022-03-08 11:00,112,59,53,0,0,0
2022-03-08 11:15,97,48,49,0,0,0
2022-03-08 11:30,104,60,44,0,0,0
2022-03-08 11:45,131,75,56,0,0,0
2022-03-08 12:00,109,55,54,0,0,0
2022-03-08 12:15,148,80,68,0,0,0
2022-03-08 12:30,142,76,66,0,0,0
2022-03-08 12:45,167,101,66,0,0,0
2022-03-08 13:00,204,78,126,0,0,0
2022-03-08 13:15,173,68,105,0,0,0
2022-03-08 13:30,185,94,91,0,0,0
2022-03-08 13:45,175,94,81,0,0,0
2022-03-08 14:00,184,85,99,0,0,0
2022-03-08 14:15,185,101,84,0,0,0
2022-03-08 14:30,148,86,62,0,0,0
2022-03-08 14:45,185,94,91,0,0,0
2022-03-08 15:00,183,97,86,0,0,0
2022-03-08 15:15,178,85,93,0,0,0
2022-03-08 15:30,205,101,104,0,0,0
2022-03-08 15:45,195,97,98,0,0,0
2022-03-08 16:00,216,115,101,0,0,0
2022-03-08 16:15,179,90,89,0,0,0
2022-03-08 16:30,212,103,109,0,0,0
2022-03-08 16:45,230,116,114,0,0,0
2022-03-08 17:00,217,122,95,0,0,0
2022-03-08 17:15,252,116,136,0,0,0
2022-03-08 17:30,239,101,138,0,0,0
2022-03-08 17:45,224,102,122,0,0,0
2022-03-08 18:00,198,73,125,0,0,0
2022-03-08 18:15,235,89,146,0,0,0
2022-03-08 18:30,182,55,127,0,0,0
2022-03-08 18:45,174,75,99,0,0,0
2022-03-08 19:00,165,64,101,0,0,0
2022-03-08 19:15,126,70,56,0,0,0
2022-03-08 19:30,126,48,78,0,0,0
2022-03-08 19:45,128,61,67,0,0,0
2022-03-08 20:00,99,38,61,0,0,0
2022-03-08 20:15,99,41,58,0,0,0
2022-03-08 20:30,84,34,50,0,0,0
2022-03-08 20:45,72,24,48,0,0,0
2022-03-08 21:00,47,20,27,0,0,0
2022-03-08 21:15,55,19,36,0,0,0
2022-03-08 21:30,46,14,32,0,0,0
2022-03-08 21:45,55,17,38,0,0,0
2022-03-08 22:00,59,29,30,0,0,0
2022-03-08 22:15,60,14,46,0,0,0
2022-03-08 22:30,34,3,31,0,0,0
2022-03-08 22:45,48,15,33,0,0,0
2022-03-08 23:00,56,18,38,0,0,0
2022-03-08 23:15,49,15,34,0,0,0
2022-03-08 23:30,46,16,30,0,0,0
2022-03-08 23:45,20,9,11,0,0,0
2022-03-09 00:00,28,6,22,0,0,0
2022-03-09 00:15,18,7,11,0,0,0
2022-03-09 00:30,8,1,7,0,0,0
2022-03-09 00:45,17,8,9,0,0,0
2022-03-09 01:00,5,4,1,0,0,0
2022-03-09 01:15,8,5,3,0,0,0
2022-03-09 01:30,12,1,11,0,0,0
2022-03-09 01:45,4,1,3,0,0,0
2022-03-09 02:00,6,3,3,0,0,0
2022-03-09 02:15,4,1,3,0,0,0
2022-03-09 02:30,0,0,0,0,0,0
2022-03-09 02:45,2,1,1,0,0,0
2022-03-09 03:00,2,1,1,0,0,0
2022-03-09 03:15,4,0,4,0,0,0
2022-03-09 03:30,4,1,3,0,0,0
2022-03-09 03:45,6,2,4,0,0,0
2022-03-09 04:00,2,1,1,0,0,0
2022-03-09 04:15,3,0,3,0,0,0
2022-03-09 04:30,6,3,3,0,0,0
2022-03-09 04:45,8,6,2,0,0,0
2022-03-09 05:00,9,7,2,0,0,0
2022-03-09 05:15,14,8,6,0,0,0
2022-03-09 05:30,19,13,6,0,0,0
2022-03-09 05:45,20,12,8,0,0,0
2022-03-09 06:00,28,13,15,0,0,0
2022-03-09 06:15,47,34,13,0,0,0
2022-03-09 06:30,63,46,17,0,0,0
2022-03-09 06:45,108,80,28,0,0,0
2022-03-09 07:00,103,68,35,0,0,0
2022-03-09 07:15,171,126,45,0,0,0
2022-03-09 07:30,302,232,70,0,0,0
2022-03-09 07:45,259,166,93,0,0,0
2022-03-09 08:00,166,100,66,0,0,0
2022-03-09 08:15,186,118,68,0,0,0
2022-03-09 08:30,173,108,65,0,0,0
2022-03-09 08:45,192,119,73,0,0,0
2022-03-09 09:00,140,82,58,0,0,0
2022-03-09 09:15,155,102,53,0,0,0
2022-03-09 09:30,136,82,54,0,0,0
2022-03-09 09:45,125,75,50,0,0,0
2022-03-09 10:00,97,53,44,0,0,0
2022-03-09 10:15,108,73,35,0,0,0
2022-03-09 10:30,104,76,28,0,0,0
2022-03-09 10:45,131,76,55,0,0,0
2022-03-09 11:00,100,54,46,0,0,0
2022-03-09 11:15,128,80,48,0,0,0
2022-03-09 11:30,142,77,65,0,0,0
2022-03-09 11:45,134,78,56,0,0,0
2022-03-09 12:00,144,78,66,0,0,0
2022-03-09 12:15,166,91,75,0,0,0
2022-03-09 12:30,140,74,66,0,0,0
2022-03-09 12:45,176,90,86,0,0,0
2022-03-09 13:00,164,73,91,0,0,0
2022-03-09 13:15,162,74,88,0,0,0
2022-03-09 13:30,136,68,68,0,0,0
2022-03-09 13:45,219,100,119,0,0,0
2022-03-09 14:00,192,74,118,0,0,0
2022-03-09 14:15,172,78,94,0,0,0
2022-03-09 14:30,149,70,79,0,0,0
2022-03-09 14:45,194,85,109,0,0,0
2022-03-09 15:00,192,87,105,0,0,0
2022-03-09 15:15,153,74,79,0,0,0
2022-03-09 15:30,233,83,150,0,0,0
2022-03-09 15:45,214,97,117,0,0,0
2022-03-09 16:00,213,101,112,0,0,0
2022-03-09 16:15,210,109,101,0,0,0
2022-03-09 16:30,214,97,117,0,0,0
2022-03-09 16:45,258,99,159,0,0,0
2022-03-09 17:00,245,124,121,0,0,0
2022-03-09 17:15,256,124,132,0,0,0
2022-03-09 17:30,244,114,130,0,0,0
2022-03-09 17:45,256,117,139,0,0,0
2022-03-09 18:00,240,108,132,0,0,0
2022-03-09 18:15,230,99,131,0,0,0
2022-03-09 18:30,169,61,108,0,0,0
2022-03-09 18:45,184,87,97,0,0,0
2022-03-09 19:00,153,68,85,0,0,0
2022-03-09 19:15,142,73,69,0,0,0
2022-03-09 19:30,147,69,78,0,0,0
2022-03-09 19:45,144,79,65,0,0,0
2022-03-09 20:00,103,57,46,0,0,0
2022-03-09 20:15,114,48,66,0,0,0
2022-03-09 20:30,86,37,49,0,0,0
2022-03-09 20:45,71,26,45,0,0,0
2022-03-09 21:00,71,27,44,0,0,0
2022-03-09 21:15,61,16,45,0,0,0
2022-03-09 21:30,61,29,32,0,0,0
2022-03-09 21:45,53,19,34,0,0,0
2022-03-09 22:00,53,21,32,0,0,0
2022-03-09 22:15,68,27,41,0,0,0
2022-03-09 22:30,67,18,49,0,0,0
2022-03-09 22:45,38,16,22,0,0,0
2022-03-09 23:00,56,22,34,0,0,0
2022-03-09 23:15,46,15,31,0,0,0
2022-03-09 23:30,21,5,16,0,0,0
2022-03-09 23:45,28,14,14,0,0,0
2022-03-10 00:00,24,4,20,0,0,0
2022-03-10 00:15,26,11,15,0,0,0
2022-03-10 00:30,18,2,16,0,0,0
2022-03-10 00:45,17,7,10,0,0,0
2022-03-10 01:00,19,3,16,0,0,0
2022-03-10 01:15,8,0,8,0,0,0
2022-03-10 01:30,10,4,6,0,0,0
2022-03-10 01:45,12,0,12,0,0,0
2022-03-10 02:00,12,3,9,0,0,0
2022-03-10 02:15,4,0,4,0,0,0
2022-03-10 02:30,10,0,10,0,0,0
2022-03-10 02:45,7,1,6,0,0,0
2022-03-10 03:00,6,1,5,0,0,0
2022-03-10 03:15,6,3,3,0,0,0
2022-03-10 03:30,11,1,10,0,0,0
2022-03-10 03:45,9,0,9,0,0,0
2022-03-10 04:00,6,2,4,0,0,0
2022-03-10 04:15,2,0,2,0,0,0
2022-03-10 04:30,7,2,5,0,0,0
2022-03-10 04:45,9,5,4,0,0,0
2022-03-10 05:00,10,9,1,0,0,0
2022-03-10 05:15,16,9,7,0,0,0
2022-03-10 05:30,23,12,11,0,0,0
2022-03-10 05:45,30,18,12,0,0,0
2022-03-10 06:00,20,13,7,0,0,0
2022-03-10 06:15,51,35,16,0,0,0
2022-03-10 06:30,56,39,17,0,0,0
2022-03-10 06:45,79,55,24,0,0,0
2022-03-10 07:00,97,57,40,0,0,0
2022-03-10 07:15,170,120,50,0,0,0
2022-03-10 07:30,260,196,64,0,0,0
2022-03-10 07:45,253,156,97,0,0,0
2022-03-10 08:00,185,110,75,0,0,0
2022-03-10 08:15,203,125,78,0,0,0
2022-03-10 08:30,159,92,67,0,0,0
2022-03-10 08:45,207,128,79,0,0,0
2022-03-10 09:00,136,86,50,0,0,0
2022-03-10 09:15,154,93,61,0,0,0
2022-03-10 09:30,130,78,52,0,0,0
2022-03-10 09:45,142,91,51,0,0,0
2022-03-10 10:00,105,67,38,0,0,0
2022-03-10 10:15,91,69,22,0,0,0
2022-03-10 10:30,115,72,43,0,0,0
2022-03-10 10:45,115,73,42,0,0,0
2022-03-10 11:00,109,64,45,0,0,0
2022-03-10 11:15,120,69,51,0,0,0
2022-03-10 11:30,128,66,62,0,0,0
2022-03-10 11:45,138,83,55,0,0,0
2022-03-10 12:00,133,60,73,0,0,0
2022-03-10 12:15,148,76,72,0,0,0
2022-03-10 12:30,141,74,67,0,0,0
2022-03-10 12:45,156,78,78,0,0,0
2022-03-10 13:00,166,70,96,0,0,0
2022-03-10 13:15,160,68,92,0,0,0
2022-03-10 13:30,144,60,84,0,0,0
2022-03-10 13:45,173,78,95,0,0,0
2022-03-10 14:00,156,61,95,0,0,0
2022-03-10 14:15,172,81,91,0,0,0
2022-03-10 14:30,142,57,85,0,0,0
2022-03-10 14:45,181,83,98,0,0,0
2022-03-10 15:00,161,66,95,0,0,0
2022-03-10 15:15,210,112,98,0,0,0
2022-03-10 15:30,236,89,147,0,0,0
2022-03-10 15:45,249,116,133,0,0,0
2022-03-10 16:00,217,99,118,0,0,0
2022-03-10 16:15,247,112,135,0,0,0
2022-03-10 16:30,266,144,122,0,0,0
2022-03-10 16:45,253,120,133,0,0,0
2022-03-10 17:00,243,117,126,0,0,0
2022-03-10 17:15,220,105,115,0,0,0
2022-03-10 17:30,243,112,131,0,0,0
2022-03-10 17:45,257,119,138,0,0,0
2022-03-10 18:00,197,81,116,0,0,0
2022-03-10 18:15,246,100,146,0,0,0
2022-03-10 18:30,201,69,132,0,0,0
2022-03-10 18:45,186,88,98,0,0,0
2022-03-10 19:00,166,93,73,0,0,0
2022-03-10 19:15,147,74,73,0,0,0
2022-03-10 19:30,137,61,76,0,0,0
2022-03-10 19:45,152,68,84,0,0,0
2022-03-10 20:00,139,55,84,0,0,0
2022-03-10 20:15,100,37,63,0,0,0
2022-03-10 20:30,76,34,42,0,0,0
2022-03-10 20:45,61,25,36,0,0,0
2022-03-10 21:00,61,27,34,0,0,0
2022-03-10 21:15,57,24,33,0,0,0
2022-03-10 21:30,50,16,34,0,0,0
2022-03-10 21:45,50,12,38,0,0,0
2022-03-10 22:00,57,20,37,0,0,0
2022-03-10 22:15,49,12,37,0,0,0
2022-03-10 22:30,56,24,32,0,0,0
2022-03-10 22:45,32,7,25,0,0,0
2022-03-10 23:00,37,9,28,0,0,0
2022-03-10 23:15,38,7,31,0,0,0
2022-03-10 23:30,46,15,31,0,0,0
2022-03-10 23:45,46,22,24,0,0,0
2022-03-11 00:00,46,11,35,0,0,0
2022-03-11 00:15,19,2,17,0,0,0
2022-03-11 00:30,15,5,10,0,0,0
2022-03-11 00:45,19,5,14,0,0,0
2022-03-11 01:00,5,1,4,0,0,0
2022-03-11 01:15,12,2,10,0,0,0
2022-03-11 01:30,9,2,7,0,0,0
2022-03-11 01:45,4,2,2,0,0,0
2022-03-11 02:00,4,1,3,0,0,0
2022-03-11 02:15,6,1,5,0,0,0
2022-03-11 02:30,3,1,2,0,0,0
2022-03-11 02:45,4,2,2,0,0,0
2022-03-11 03:00,5,0,5,0,0,0
2022-03-11 03:15,3,0,3,0,0,0
2022-03-11 03:30,6,3,3,0,0,0
2022-03-11 03:45,3,0,3,0,0,0
2022-03-11 04:00,0,0,0,0,0,0
2022-03-11 04:15,5,1,4,0,0,0
2022-03-11 04:30,5,2,3,0,0,0
2022-03-11 04:45,8,5,3,0,0,0
2022-03-11 05:00,12,9,3,0,0,0
2022-03-11 05:15,14,10,4,0,0,0
2022-03-11 05:30,24,18,6,0,0,0
2022-03-11 05:45,18,11,7,0,0,0
2022-03-11 06:00,27,21,6,0,0,0
2022-03-11 06:15,35,22,13,0,0,0
2022-03-11 06:30,41,28,13,0,0,0
2022-03-11 06:45,80,62,18,0,0,0
2022-03-11 07:00,83,63,20,0,0,0
2022-03-11 07:15,151,103,48,0,0,0
2022-03-11 07:30,253,185,68,0,0,0
2022-03-11 07:45,229,152,77,0,0,0
2022-03-11 08:00,157,92,65,0,0,0
2022-03-11 08:15,176,109,67,0,0,0
2022-03-11 08:30,150,83,67,0,0,0
2022-03-11 08:45,180,111,69,0,0,0
2022-03-11 09:00,124,76,48,0,0,0
2022-03-11 09:15,100,68,32,0,0,0
2022-03-11 09:30,111,75,36,0,0,0
2022-03-11 09:45,135,83,52,0,0,0
2022-03-11 10:00,111,64,47,0,0,0
2022-03-11 10:15,120,70,50,0,0,0
2022-03-11 10:30,88,54,34,0,0,0
2022-03-11 10:45,126,73,53,0,0,0
2022-03-11 11:00,122,76,46,0,0,0
2022-03-11 11:15,118,65,53,0,0,0
2022-03-11 11:30,115,66,49,0,0,0
2022-03-11 11:45,121,71,50,0,0,0
2022-03-11 12:00,131,66,65,0,0,0
2022-03-11 12:15,165,79,86,0,0,0
2022-03-11 12:30,157,82,75,0,0,0
2022-03-11 12:45,205,105,100,0,0,0
2022-03-11 13:00,209,75,134,0,0,0
2022-03-11 13:15,202,79,123,0,0,0
2022-03-11 13:30,168,73,95,0,0,0
2022-03-11 13:45,184,88,96,0,0,0
2022-03-11 14:00,206,95,111,0,0,0
2022-03-11 14:15,182,98,84,0,0,0
2022-03-11 14:30,197,105,92,0,0,0
2022-03-11 14:45,202,95,107,0,0,0
2022-03-11 15:00,194,108,86,0,0,0
2022-03-11 15:15,159,84,75,0,0,0
2022-03-11 15:30,229,110,119,0,0,0
2022-03-11 15:45,194,106,88,0,0,0
2022-03-11 16:00,189,83,106,0,0,0
2022-03-11 16:15,225,108,117,0,0,0
2022-03-11 16:30,190,93,97,0,0,0
2022-03-11 16:45,184,99,85,0,0,0
2022-03-11 17:00,216,113,103,0,0,0
2022-03-11 17:15,203,103,100,0,0,0
2022-03-11 17:30,189,85,104,0,0,0
2022-03-11 17:45,203,109,94,0,0,0
2022-03-11 18:00,183,71,112,0,0,0
2022-03-11 18:15,180,69,111,0,0,0
2022-03-11 18:30,140,71,69,0,0,0
2022-03-11 18:45,175,98,77,0,0,0
2022-03-11 19:00,182,87,95,0,0,0
2022-03-11 19:15,119,62,57,0,0,0
2022-03-11 19:30,109,57,52,0,0,0
2022-03-11 19:45,137,71,66,0,0,0
2022-03-11 20:00,128,60,68,0,0,0
2022-03-11 20:15,106,49,57,0,0,0
2022-03-11 20:30,85,43,42,0,0,0
2022-03-11 20:45,62,20,42,0,0,0
2022-03-11 21:00,60,27,33,0,0,0
2022-03-11 21:15,77,41,36,0,0,0
2022-03-11 21:30,65,25,40,0,0,0
2022-03-11 21:45,77,34,43,0,0,0
2022-03-11 22:00,57,16,41,0,0,0
2022-03-11 22:15,67,21,46,0,0,0
2022-03-11 22:30,57,24,33,0,0,0
2022-03-11 22:45,57,18,39,0,0,0
2022-03-11 23:00,55,20,35,0,0,0
2022-03-11 23:15,47,19,28,0,0,0
2022-03-11 23:30,49,16,33,0,0,0
2022-03-11 23:45,61,16,45,0,0,0
2022-03-12 00:00,46,6,40,0,0,0
2022-03-12 00:15,47,6,41,0,0,0
2022-03-12 00:30,39,16,23,0,0,0
2022-03-12 00:45,43,16,27,0,0,0
2022-03-12 01:00,42,20,22,0,0,0
2022-03-12 01:15,24,10,14,0,0,0
2022-03-12 01:30,30,10,20,0,0,0
2022-03-12 01:45,31,15,16,0,0,0
2022-03-12 02:00,18,2,16,0,0,0
2022-03-12 02:15,25,6,19,0,0,0
2022-03-12 02:30,22,8,14,0,0,0
2022-03-12 02:45,31,3,28,0,0,0
2022-03-12 03:00,16,1,15,0,0,0
2022-03-12 03:15,10,0,10,0,0,0
2022-03-12 03:30,19,3,16,0,0,0
2022-03-12 03:45,9,2,7,0,0,0
2022-03-12 04:00,3,3,0,0,0,0
2022-03-12 04:15,8,4,4,0,0,0
2022-03-12 04:30,8,3,5,0,0,0
2022-03-12 04:45,9,0,9,0,0,0
2022-03-12 05:00,10,5,5,0,0,0
2022-03-12 05:15,17,8,9,0,0,0
2022-03-12 05:30,9,6,3,0,0,0
2022-03-12 05:45,16,7,9,0,0,0
2022-03-12 06:00,10,4,6,0,0,0
2022-03-12 06:15,7,2,5,0,0,0
2022-03-12 06:30,14,4,10,0,0,0
2022-03-12 06:45,12,8,4,0,0,0
2022-03-12 07:00,11,5,6,0,0,0
2022-03-12 07:15,20,9,11,0,0,0
2022-03-12 07:30,16,10,6,0,0,0
2022-03-12 07:45,28,19,9,0,0,0
2022-03-12 08:00,25,15,10,0,0,0
2022-03-12 08:15,37,27,10,0,0,0
2022-03-12 08:30,41,30,11,0,0,0
2022-03-12 08:45,50,33,17,0,0,0
2022-03-12 09:00,71,46,25,0,0,0
2022-03-12 09:15,59,43,16,0,0,0
2022-03-12 09:30,92,55,37,0,0,0
2022-03-12 09:45,124,87,37,0,0,0
2022-03-12 10:00,101,70,31,0,0,0
2022-03-12 10:15,95,64,31,0,0,0
2022-03-12 10:30,97,70,27,0,0,0
2022-03-12 10:45,137,86,51,0,0,0
2022-03-12 11:00,143,98,45,0,0,0
2022-03-12 11:15,88,54,34,0,0,0
2022-03-12 11:30,141,102,39,0,0,0
2022-03-12 11:45,139,80,59,0,0,0
2022-03-12 12:00,129,58,71,0,0,0
2022-03-12 12:15,164,91,73,0,0,0
2022-03-12 12:30,146,82,64,0,0,0
2022-03-12 12:45,164,78,86,0,0,0
2022-03-12 13:00,144,71,73,0,0,0
2022-03-12 13:15,175,79,96,0,0,0
2022-03-12 13:30,130,58,72,0,0,0
2022-03-12 13:45,162,73,89,0,0,0
2022-03-12 14:00,164,81,83,0,0,0
2022-03-12 14:15,164,90,74,0,0,0
2022-03-12 14:30,147,63,84,0,0,0
2022-03-12 14:45,180,83,97,0,0,0
2022-03-12 15:00,171,79,92,0,0,0
2022-03-12 15:15,134,63,71,0,0,0
2022-03-12 15:30,143,73,70,0,0,0
2022-03-12 15:45,153,65,88,0,0,0
2022-03-12 16:00,129,57,72,0,0,0
2022-03-12 16:15,143,62,81,0,0,0
2022-03-12 16:30,138,64,74,0,0,0
2022-03-12 16:45,147,80,67,0,0,0
2022-03-12 17:00,117,46,71,0,0,0
2022-03-12 17:15,131,76,55,0,0,0
2022-03-12 17:30,122,46,76,0,0,0
2022-03-12 17:45,130,53,77,0,0,0
2022-03-12 18:00,125,48,77,0,0,0
2022-03-12 18:15,150,52,98,0,0,0
2022-03-12 18:30,125,53,72,0,0,0
2022-03-12 18:45,111,56,55,0,0,0
2022-03-12 19:00,114,47,67,0,0,0
2022-03-12 19:15,99,47,52,0,0,0
2022-03-12 19:30,103,55,48,0,0,0
2022-03-12 19:45,113,51,62,0,0,0
2022-03-12 20:00,133,54,79,0,0,0
2022-03-12 20:15,84,32,52,0,0,0
2022-03-12 20:30,76,43,33,0,0,0
2022-03-12 20:45,75,40,35,0,0,0
2022-03-12 21:00,64,33,31,0,0,0
2022-03-12 21:15,60,30,30,0,0,0
2022-03-12 21:30,57,30,27,0,0,0
2022-03-12 21:45,48,19,29,0,0,0
2022-03-12 22:00,54,22,32,0,0,0
2022-03-12 22:15,52,14,38,0,0,0
2022-03-12 22:30,47,18,29,0,0,0
2022-03-12 22:45,55,20,35,0,0,0
2022-03-12 23:00,35,18,17,0,0,0
2022-03-12 23:15,47,19,28,0,0,0
2022-03-12 23:30,55,22,33,0,0,0
2022-03-12 23:45,54,14,40,0,0,0
2022-03-13 00:00,33,11,22,0,0,0
2022-03-13 00:15,41,8,33,0,0,0
2022-03-13 00:30,40,18,22,0,0,0
2022-03-13 00:45,28,11,17,0,0,0
2022-03-13 01:00,31,14,17,0,0,0
2022-03-13 01:15,22,8,14,0,0,0
2022-03-13 01:30,30,8,22,0,0,0
2022-03-13 01:45,29,15,14,0,0,0
2022-03-13 02:00,33,8,25,0,0,0
2022-03-13 02:15,25,5,20,0,0,0
2022-03-13 02:30,20,8,12,0,0,0
2022-03-13 02:45,27,12,15,0,0,0
2022-03-13 03:00,25,3,22,0,0,0
2022-03-13 03:15,22,4,18,0,0,0
2022-03-13 03:30,22,5,17,0,0,0
2022-03-13 03:45,13,3,10,0,0,0
2022-03-13 04:00,9,2,7,0,0,0
2022-03-13 04:15,3,2,1,0,0,0
2022-03-13 04:30,12,4,8,0,0,0
2022-03-13 04:45,4,2,2,0,0,0
2022-03-13 05:00,15,1,14,0,0,0
2022-03-13 05:15,6,3,3,0,0,0
2022-03-13 05:30,7,4,3,0,0,0
2022-03-13 05:45,7,4,3,0,0,0
2022-03-13 06:00,10,4,6,0,0,0
2022-03-13 06:15,5,1,4,0,0,0
2022-03-13 06:30,14,7,7,0,0,0
2022-03-13 06:45,12,7,5,0,0,0
2022-03-13 07:00,8,4,4,0,0,0
2022-03-13 07:15,11,5,6,0,0,0
2022-03-13 07:30,10,9,1,0,0,0
2022-03-13 07:45,17,7,10,0,0,0
2022-03-13 08:00,12,8,4,0,0,0
2022-03-13 08:15,14,7,7,0,0,0
2022-03-13 08:30,23,13,10,0,0,0
2022-03-13 08:45,29,15,14,0,0,0
2022-03-13 09:00,38,31,7,0,0,0
2022-03-13 09:15,27,20,7,0,0,0
2022-03-13 09:30,46,27,19,0,0,0
2022-03-13 09:45,71,52,19,0,0,0
2022-03-13 10:00,52,34,18,0,0,0
2022-03-13 10:15,62,39,23,0,0,0
2022-03-13 10:30,70,44,26,0,0,0
2022-03-13 10:45,83,46,37,0,0,0
2022-03-13 11:00,58,37,21,0,0,0
2022-03-13 11:15,57,26,31,0,0,0
2022-03-13 11:30,66,31,35,0,0,0
2022-03-13 11:45,87,46,41,0,0,0
2022-03-13 12:00,81,28,53,0,0,0
2022-03-13 12:15,71,34,37,0,0,0
2022-03-13 12:30,87,40,47,0,0,0
2022-03-13 12:45,113,59,54,0,0,0
2022-03-13 13:00,112,58,54,0,0,0
2022-03-13 13:15,131,63,68,0,0,0
2022-03-13 13:30,120,56,64,0,0,0
2022-03-13 13:45,108,68,40,0,0,0
2022-03-13 14:00,145,73,72,0,0,0
2022-03-13 14:15,148,67,81,0,0,0
2022-03-13 14:30,150,88,62,0,0,0
2022-03-13 14:45,167,80,87,0,0,0
2022-03-13 15:00,165,96,69,0,0,0
2022-03-13 15:15,165,79,86,0,0,0
2022-03-13 15:30,137,74,63,0,0,0
2022-03-13 15:45,164,81,83,0,0,0
2022-03-13 16:00,148,77,71,0,0,0
2022-03-13 16:15,131,57,74,0,0,0
2022-03-13 16:30,183,78,105,0,0,0
2022-03-13 16:45,144,71,73,0,0,0
2022-03-13 17:00,142,64,78,0,0,0
2022-03-13 17:15,127,74,53,0,0,0
2022-03-13 17:30,142,62,80,0,0,0
2022-03-13 17:45,151,61,90,0,0,0
2022-03-13 18:00,117,52,65,0,0,0
2022-03-13 18:15,118,43,75,0,0,0
2022-03-13 18:30,108,46,62,0,0,0
2022-03-13 18:45,94,31,63,0,0,0
2022-03-13 19:00,89,39,50,0,0,0
2022-03-13 19:15,64,20,44,0,0,0
2022-03-13 19:30,68,14,54,0,0,0
2022-03-13 19:45,76,18,58,0,0,0
2022-03-13 20:00,87,22,65,0,0,0
2022-03-13 20:15,52,10,42,0,0,0
2022-03-13 20:30,65,17,48,0,0,0
2022-03-13 20:45,44,14,30,0,0,0
2022-03-13 21:00,47,18,29,0,0,0
2022-03-13 21:15,40,19,21,0,0,0
2022-03-13 21:30,41,16,25,0,0,0
2022-03-13 21:45,33,12,21,0,0,0
2022-03-13 22:00,34,14,20,0,0,0
2022-03-13 22:15,37,11,26,0,0,0
2022-03-13 22:30,33,11,22,0,0,0
2022-03-13 22:45,26,9,17,0,0,0
2022-03-13 23:00,29,14,15,0,0,0
2022-03-13 23:15,10,3,7,0,0,0
2022-03-13 23:30,13,6,7,0,0,0
2022-03-13 23:45,10,5,5,0,0,0
2022-03-14 00:00,10,5,5,0,0,0
2022-03-14 00:15,6,3,3,0,0,0
2022-03-14 00:30,7,3,4,0,0,0
2022-03-14 00:45,6,1,5,0,0,0
2022-03-14 01:00,2,2,0,0,0,0
2022-03-14 01:15,7,1,6,0,0,0
2022-03-14 01:30,5,2,3,0,0,0
2022-03-14 01:45,3,1,2,0,0,0
2022-03-14 02:00,1,0,1,0,0,0
2022-03-14 02:15,2,1,1,0,0,0
2022-03-14 02:30,0,0,0,0,0,0
2022-03-14 02:45,0,0,0,0,0,0
2022-03-14 03:00,0,0,0,0,0,0
2022-03-14 03:15,3,1,2,0,0,0
2022-03-14 03:30,0,0,0,0,0,0
2022-03-14 03:45,2,0,2,0,0,0
2022-03-14 04:00,4,1,3,0,0,0
2022-03-14 04:15,2,0,2,0,0,0
2022-03-14 04:30,7,4,3,0,0,0
2022-03-14 04:45,9,6,3,0,0,0
2022-03-14 05:00,6,3,3,0,0,0
2022-03-14 05:15,7,3,4,0,0,0
2022-03-14 05:30,19,14,5,0,0,0
2022-03-14 05:45,10,8,2,0,0,0
2022-03-14 06:00,21,16,5,0,0,0
2022-03-14 06:15,29,20,9,0,0,0
2022-03-14 06:30,30,19,11,0,0,0
2022-03-14 06:45,48,34,14,0,0,0
2022-03-14 07:00,63,40,23,0,0,0
2022-03-14 07:15,91,69,22,0,0,0
2022-03-14 07:30,196,151,45,0,0,0
2022-03-14 07:45,175,103,72,0,0,0
2022-03-14 08:00,114,64,50,0,0,0
2022-03-14 08:15,120,77,43,0,0,0
2022-03-14 08:30,118,74,44,0,0,0
2022-03-14 08:45,132,72,60,0,0,0
2022-03-14 09:00,82,54,28,0,0,0
2022-03-14 09:15,71,42,29,0,0,0
2022-03-14 09:30,93,59,34,0,0,0
2022-03-14 09:45,83,45,38,0,0,0
2022-03-14 10:00,73,33,40,0,0,0
2022-03-14 10:15,69,37,32,0,0,0
2022-03-14 10:30,67,36,31,0,0,0
2022-03-14 10:45,79,44,35,0,0,0
2022-03-14 11:00,71,37,34,0,0,0
2022-03-14 11:15,78,38,40,0,0,0
2022-03-14 11:30,75,40,35,0,0,0
2022-03-14 11:45,92,47,45,0,0,0
2022-03-14 12:00,97,43,54,0,0,0
2022-03-14 12:15,86,50,36,0,0,0
2022-03-14 12:30,98,60,38,0,0,0
2022-03-14 12:45,112,51,61,0,0,0
2022-03-14 13:00,118,56,62,0,0,0
2022-03-14 13:15,114,56,58,0,0,0
2022-03-14 13:30,115,54,61,0,0,0
2022-03-14 13:45,127,66,61,0,0,0
2022-03-14 14:00,103,38,65,0,0,0
2022-03-14 14:15,92,56,36,0,0,0
2022-03-14 14:30,112,59,53,0,0,0
2022-03-14 14:45,128,59,69,0,0,0
2022-03-14 15:00,125,56,69,0,0,0
2022-03-14 15:15,147,76,71,0,0,0
2022-03-14 15:30,174,64,110,0,0,0
2022-03-14 15:45,176,73,103,0,0,0
2022-03-14 16:00,147,64,83,0,0,0
2022-03-14 16:15,144,59,85,0,0,0
2022-03-14 16:30,153,64,89,0,0,0
2022-03-14 16:45,183,83,100,0,0,0
2022-03-14 17:00,182,95,87,0,0,0
2022-03-14 17:15,187,83,104,0,0,0
2022-03-14 17:30,193,98,95,0,0,0
2022-03-14 17:45,185,90,95,0,0,0
2022-03-14 18:00,157,78,79,0,0,0
2022-03-14 18:15,193,80,113,0,0,0
2022-03-14 18:30,155,64,91,0,0,0
2022-03-14 18:45,148,63,85,0,0,0
2022-03-14 19:00,133,55,78,0,0,0
2022-03-14 19:15,128,61,67,0,0,0
2022-03-14 19:30,106,49,57,0,0,0
2022-03-14 19:45,112,35,77,0,0,0
2022-03-14 20:00,100,40,60,0,0,0
2022-03-14 20:15,109,39,70,0,0,0
2022-03-14 20:30,73,25,48,0,0,0
2022-03-14 20:45,91,25,66,0,0,0
2022-03-14 21:00,69,34,35,0,0,0
2022-03-14 21:15,62,19,43,0,0,0
2022-03-14 21:30,39,11,28,0,0,0
2022-03-14 21:45,42,11,31,0,0,0
2022-03-14 22:00,58,16,42,0,0,0
2022-03-14 22:15,47,18,29,0,0,0
2022-03-14 22:30,54,17,37,0,0,0
2022-03-14 22:45,20,5,15,0,0,0
2022-03-14 23:00,32,8,24,0,0,0
2022-03-14 23:15,26,8,18,0,0,0
2022-03-14 23:30,15,6,9,0,0,0
2022-03-14 23:45,17,9,8,0,0,0
2022-03-15 00:00,17,5,12,0,0,0
2022-03-15 00:15,9,1,8,0,0,0
2022-03-15 00:30,9,2,7,0,0,0
2022-03-15 00:45,2,0,2,0,0,0
2022-03-15 01:00,2,1,1,0,0,0
2022-03-15 01:15,6,1,5,0,0,0
2022-03-15 01:30,1,0,1,0,0,0
2022-03-15 01:45,4,4,0,0,0,0
2022-03-15 02:00,1,0,1,0,0,0
2022-03-15 02:15,3,1,2,0,0,0
2022-03-15 02:30,3,0,3,0,0,0
2022-03-15 02:45,1,1,0,0,0,0
2022-03-15 03:00,1,0,1,0,0,0
2022-03-15 03:15,3,1,2,0,0,0
2022-03-15 03:30,1,1,0,0,0,0
2022-03-15 03:45,2,1,1,0,0,0
2022-03-15 04:00,1,1,0,0,0,0
2022-03-15 04:15,3,2,1,0,0,0
2022-03-15 04:30,4,3,1,0,0,0
2022-03-15 04:45,3,2,1,0,0,0
2022-03-15 05:00,12,8,4,0,0,0
2022-03-15 05:15,10,8,2,0,0,0
2022-03-15 05:30,23,17,6,0,0,0
2022-03-15 05:45,24,21,3,0,0,0
2022-03-15 06:00,34,22,12,0,0,0
2022-03-15 06:15,37,28,9,0,0,0
2022-03-15 06:30,56,40,16,0,0,0
2022-03-15 06:45,92,66,26,0,0,0
2022-03-15 07:00,114,74,40,0,0,0
2022-03-15 07:15,163,121,42,0,0,0
2022-03-15 07:30,305,236,69,0,0,0
2022-03-15 07:45,253,168,85,0,0,0
2022-03-15 08:00,156,96,60,0,0,0
2022-03-15 08:15,178,109,69,0,0,0
2022-03-15 08:30,174,108,66,0,0,0
2022-03-15 08:45,177,103,74,0,0,0
2022-03-15 09:00,143,94,49,0,0,0
2022-03-15 09:15,113,73,40,0,0,0
2022-03-15 09:30,114,69,45,0,0,0
2022-03-15 09:45,120,78,42,0,0,0
2022-03-15 10:00,76,35,41,0,0,0
2022-03-15 10:15,88,53,35,0,0,0
2022-03-15 10:30,111,56,55,0,0,0
2022-03-15 10:45,109,54,55,0,0,0
2022-03-15 11:00,94,45,49,0,0,0
2022-03-15 11:15,118,53,65,0,0,0
2022-03-15 11:30,106,55,51,0,0,0
2022-03-15 11:45,102,59,43,0,0,0
2022-03-15 12:00,115,46,69,0,0,0
2022-03-15 12:15,123,64,59,0,0,0
2022-03-15 12:30,141,63,78,0,0,0
2022-03-15 12:45,145,80,65,0,0,0
2022-03-15 13:00,169,60,109,0,0,0
2022-03-15 13:15,169,67,102,0,0,0
2022-03-15 13:30,138,63,75,0,0,0
2022-03-15 13:45,162,85,77,0,0,0
2022-03-15 14:00,122,49,73,0,0,0
2022-03-15 14:15,142,71,71,0,0,0
2022-03-15 14:30,132,65,67,0,0,0
2022-03-15 14:45,131,55,76,0,0,0
2022-03-15 15:00,163,71,92,0,0,0
2022-03-15 15:15,138,63,75,0,0,0
2022-03-15 15:30,155,78,77,0,0,0
2022-03-15 15:45,156,77,79,0,0,0
2022-03-15 16:00,187,91,96,0,0,0
2022-03-15 16:15,197,76,121,0,0,0
2022-03-15 16:30,192,80,112,0,0,0
2022-03-15 16:45,214,98,116,0,0,0
2022-03-15 17:00,181,93,88,0,0,0
2022-03-15 17:15,211,99,112,0,0,0
2022-03-15 17:30,238,109,129,0,0,0
2022-03-15 17:45,242,109,133,0,0,0
2022-03-15 18:00,224,90,134,0,0,0
2022-03-15 18:15,198,67,131,0,0,0
2022-03-15 18:30,153,62,91,0,0,0
2022-03-15 18:45,213,91,122,0,0,0
2022-03-15 19:00,142,64,78,0,0,0
2022-03-15 19:15,170,71,99,0,0,0
2022-03-15 19:30,119,38,81,0,0,0
2022-03-15 19:45,116,46,70,0,0,0
2022-03-15 20:00,96,38,58,0,0,0
2022-03-15 20:15,103,51,52,0,0,0
2022-03-15 20:30,73,35,38,0,0,0
2022-03-15 20:45,73,34,39,0,0,0
2022-03-15 21:00,70,26,44,0,0,0
2022-03-15 21:15,90,38,52,0,0,0
2022-03-15 21:30,59,19,40,0,0,0
2022-03-15 21:45,56,12,44,0,0,0
2022-03-15 22:00,50,16,34,0,0,0
2022-03-15 22:15,51,16,35,0,0,0
2022-03-15 22:30,44,16,28,0,0,0
2022-03-15 22:45,30,6,24,0,0,0
2022-03-15 23:00,41,16,25,0,0,0
2022-03-15 23:15,41,8,33,0,0,0
2022-03-15 23:30,28,13,15,0,0,0
2022-03-15 23:45,14,6,8,0,0,0
2022-03-16 00:00,11,2,9,0,0,0
2022-03-16 00:15,19,5,14,0,0,0
2022-03-16 00:30,24,8,16,0,0,0
2022-03-16 00:45,3,2,1,0,0,0
2022-03-16 01:00,22,3,19,0,0,0
2022-03-16 01:15,6,1,5,0,0,0
2022-03-16 01:30,9,7,2,0,0,0
2022-03-16 01:45,5,0,5,0,0,0
2022-03-16 02:00,4,1,3,0,0,0
2022-03-16 02:15,3,1,2,0,0,0
2022-03-16 02:30,2,1,1,0,0,0
2022-03-16 02:45,6,2,4,0,0,0
2022-03-16 03:00,1,1,0,0,0,0
2022-03-16 03:15,2,0,2,0,0,0
2022-03-16 03:30,2,1,1,0,0,0
2022-03-16 03:45,3,1,2,0,0,0
2022-03-16 04:00,1,0,1,0,0,0
2022-03-16 04:15,4,1,3,0,0,0
2022-03-16 04:30,6,4,2,0,0,0
2022-03-16 04:45,5,3,2,0,0,0
2022-03-16 05:00,8,6,2,0,0,0
2022-03-16 05:15,12,8,4,0,0,0
2022-03-16 05:30,25,21,4,0,0,0
2022-03-16 05:45,19,15,4,0,0,0
2022-03-16 06:00,37,26,11,0,0,0
2022-03-16 06:15,52,41,11,0,0,0
2022-03-16 06:30,57,42,15,0,0,0
2022-03-16 06:45,94,69,25,0,0,0
2022-03-16 07:00,123,89,34,0,0,0
2022-03-16 07:15,184,139,45,0,0,0
2022-03-16 07:30,278,207,71,0,0,0
2022-03-16 07:45,298,189,109,0,0,0
2022-03-16 08:00,175,103,72,0,0,0
2022-03-16 08:15,213,140,73,0,0,0
2022-03-16 08:30,160,103,57,0,0,0
2022-03-16 08:45,200,123,77,0,0,0
2022-03-16 09:00,158,92,66,0,0,0
2022-03-16 09:15,149,92,57,0,0,0
2022-03-16 09:30,136,97,39,0,0,0
2022-03-16 09:45,139,92,47,0,0,0
2022-03-16 10:00,116,61,55,0,0,0
2022-03-16 10:15,118,73,45,0,0,0
2022-03-16 10:30,100,61,39,0,0,0
2022-03-16 10:45,98,59,39,0,0,0
2022-03-16 11:00,132,68,64,0,0,0
2022-03-16 11:15,122,66,56,0,0,0
2022-03-16 11:30,115,65,50,0,0,0
2022-03-16 11:45,137,69,68,0,0,0
2022-03-16 12:00,133,64,69,0,0,0
2022-03-16 12:15,157,85,72,0,0,0
2022-03-16 12:30,164,82,82,0,0,0
2022-03-16 12:45,193,99,94,0,0,0
2022-03-16 13:00,166,53,113,0,0,0
2022-03-16 13:15,163,74,89,0,0,0
2022-03-16 13:30,155,73,82,0,0,0
2022-03-16 13:45,207,87,120,0,0,0
2022-03-16 14:00,184,64,120,0,0,0
2022-03-16 14:15,168,77,91,0,0,0
2022-03-16 14:30,182,74,108,0,0,0
2022-03-16 14:45,204,91,113,0,0,0
2022-03-16 15:00,182,76,106,0,0,0
2022-03-16 15:15,175,84,91,0,0,0
2022-03-16 15:30,245,106,139,0,0,0
2022-03-16 15:45,195,93,102,0,0,0
2022-03-16 16:00,227,100,127,0,0,0
2022-03-16 16:15,234,97,137,0,0,0
2022-03-16 16:30,226,108,118,0,0,0
2022-03-16 16:45,246,106,140,0,0,0
2022-03-16 17:00,226,104,122,0,0,0
2022-03-16 17:15,238,118,120,0,0,0
2022-03-16 17:30,221,105,116,0,0,0
2022-03-16 17:45,238,102,136,0,0,0
2022-03-16 18:00,215,99,116,0,0,0
2022-03-16 18:15,236,94,142,0,0,0
2022-03-16 18:30,205,78,127,0,0,0
2022-03-16 18:45,166,84,82,0,0,0
2022-03-16 19:00,140,61,79,0,0,0
2022-03-16 19:15,169,70,99,0,0,0
2022-03-16 19:30,118,53,65,0,0,0
2022-03-16 19:45,137,62,75,0,0,0
2022-03-16 20:00,111,50,61,0,0,0
2022-03-16 20:15,112,51,61,0,0,0
2022-03-16 20:30,94,45,49,0,0,0
2022-03-16 20:45,66,28,38,0,0,0
2022-03-16 21:00,101,52,49,0,0,0
2022-03-16 21:15,71,31,40,0,0,0
2022-03-16 21:30,73,27,46,0,0,0
2022-03-16 21:45,69,19,50,0,0,0
2022-03-16 22:00,60,21,39,0,0,0
2022-03-16 22:15,73,19,54,0,0,0
2022-03-16 22:30,60,25,35,0,0,0
2022-03-16 22:45,64,18,46,0,0,0
2022-03-16 23:00,52,17,35,0,0,0
2022-03-16 23:15,43,14,29,0,0,0
2022-03-16 23:30,29,12,17,0,0,0
2022-03-16 23:45,34,13,21,0,0,0
2022-03-17 00:00,35,11,24,0,0,0
2022-03-17 00:15,28,3,25,0,0,0
2022-03-17 00:30,21,5,16,0,0,0
2022-03-17 00:45,26,5,21,0,0,0
2022-03-17 01:00,14,3,11,0,0,0
2022-03-17 01:15,11,2,9,0,0,0
2022-03-17 01:30,4,0,4,0,0,0
2022-03-17 01:45,15,1,14,0,0,0
2022-03-17 02:00,8,1,7,0,0,0
2022-03-17 02:15,11,0,11,0,0,0
2022-03-17 02:30,9,0,9,0,0,0
2022-03-17 02:45,9,2,7,0,0,0
2022-03-17 03:00,3,0,3,0,0,0
2022-03-17 03:15,10,2,8,0,0,0
2022-03-17 03:30,4,1,3,0,0,0
2022-03-17 03:45,3,1,2,0,0,0
2022-03-17 04:00,11,1,10,0,0,0
2022-03-17 04:15,8,3,5,0,0,0
2022-03-17 04:30,12,6,6,0,0,0
2022-03-17 04:45,6,4,2,0,0,0
2022-03-17 05:00,11,4,7,0,0,0
2022-03-17 05:15,12,6,6,0,0,0
2022-03-17 05:30,18,12,6,0,0,0
2022-03-17 05:45,20,11,9,0,0,0
2022-03-17 06:00,31,19,12,0,0,0
2022-03-17 06:15,49,30,19,0,0,0
2022-03-17 06:30,45,32,13,0,0,0
2022-03-17 06:45,67,43,24,0,0,0
2022-03-17 07:00,74,47,27,0,0,0
2022-03-17 07:15,112,84,28,0,0,0
2022-03-17 07:30,231,172,59,0,0,0
2022-03-17 07:45,229,139,90,0,0,0
2022-03-17 08:00,134,75,59,0,0,0
2022-03-17 08:15,125,66,59,0,0,0
2022-03-17 08:30,134,85,49,0,0,0
2022-03-17 08:45,152,90,62,0,0,0
2022-03-17 09:00,129,76,53,0,0,0
2022-03-17 09:15,95,64,31,0,0,0
2022-03-17 09:30,110,64,46,0,0,0
2022-03-17 09:45,125,75,50,0,0,0
2022-03-17 10:00,95,57,38,0,0,0
2022-03-17 10:15,96,61,35,0,0,0
2022-03-17 10:30,92,51,41,0,0,0
2022-03-17 10:45,92,46,46,0,0,0
2022-03-17 11:00,80,37,43,0,0,0
2022-03-17 11:15,81,43,38,0,0,0
2022-03-17 11:30,78,45,33,0,0,0
2022-03-17 11:45,112,59,53,0,0,0
2022-03-17 12:00,94,38,56,0,0,0
2022-03-17 12:15,99,41,58,0,0,0
2022-03-17 12:30,123,50,73,0,0,0
2022-03-17 12:45,137,70,67,0,0,0
2022-03-17 13:00,160,73,87,0,0,0
2022-03-17 13:15,121,51,70,0,0,0
2022-03-17 13:30,107,54,53,0,0,0
2022-03-17 13:45,132,67,65,0,0,0
2022-03-17 14:00,132,59,73,0,0,0
2022-03-17 14:15,135,76,59,0,0,0
2022-03-17 14:30,153,66,87,0,0,0
2022-03-17 14:45,172,90,82,0,0,0
2022-03-17 15:00,138,59,79,0,0,0
2022-03-17 15:15,146,63,83,0,0,0
2022-03-17 15:30,172,61,111,0,0,0
2022-03-17 15:45,186,88,98,0,0,0
2022-03-17 16:00,154,68,86,0,0,0
2022-03-17 16:15,155,62,93,0,0,0
2022-03-17 16:30,202,97,105,0,0,0
2022-03-17 16:45,201,83,118,0,0,0
2022-03-17 17:00,195,97,98,0,0,0
2022-03-17 17:15,176,79,97,0,0,0
2022-03-17 17:30,187,76,111,0,0,0
2022-03-17 17:45,214,97,117,0,0,0
2022-03-17 18:00,199,98,101,0,0,0
2022-03-17 18:15,197,77,120,0,0,0
2022-03-17 18:30,183,70,113,0,0,0
2022-03-17 18:45,152,72,80,0,0,0
2022-03-17 19:00,169,75,94,0,0,0
2022-03-17 19:15,171,64,107,0,0,0
2022-03-17 19:30,126,59,67,0,0,0
2022-03-17 19:45,129,66,63,0,0,0
2022-03-17 20:00,99,33,66,0,0,0
2022-03-17 20:15,112,47,65,0,0,0
2022-03-17 20:30,67,28,39,0,0,0
2022-03-17 20:45,71,31,40,0,0,0
2022-03-17 21:00,67,25,42,0,0,0
2022-03-17 21:15,61,25,36,0,0,0
2022-03-17 21:30,59,14,45,0,0,0
2022-03-17 21:45,51,10,41,0,0,0
2022-03-17 22:00,50,27,23,0,0,0
2022-03-17 22:15,74,25,49,0,0,0
2022-03-17 22:30,37,11,26,0,0,0
2022-03-17 22:45,32,14,18,0,0,0
2022-03-17 23:00,46,17,29,0,0,0
2022-03-17 23:15,40,14,26,0,0,0
2022-03-17 23:30,29,10,19,0,0,0
2022-03-17 23:45,34,12,22,0,0,0
2022-03-18 00:00,40,15,25,0,0,0
2022-03-18 00:15,22,8,14,0,0,0
2022-03-18 00:30,18,8,10,0,0,0
2022-03-18 00:45,17,6,11,0,0,0
2022-03-18 01:00,12,2,10,0,0,0
2022-03-18 01:15,13,4,9,0,0,0
2022-03-18 01:30,13,4,9,0,0,0
2022-03-18 01:45,8,3,5,0,0,0
2022-03-18 02:00,6,2,4,0,0,0
2022-03-18 02:15,2,1,1,0,0,0
2022-03-18 02:30,2,0,2,0,0,0
2022-03-18 02:45,6,1,5,0,0,0
2022-03-18 03:00,2,0,2,0,0,0
2022-03-18 03:15,4,1,3,0,0,0
2022-03-18 03:30,2,1,1,0,0,0
2022-03-18 03:45,2,2,0,0,0,0
2022-03-18 04:00,4,3,1,0,0,0
2022-03-18 04:15,3,1,2,0,0,0
2022-03-18 04:30,6,2,4,0,0,0
2022-03-18 04:45,4,2,2,0,0,0
2022-03-18 05:00,11,8,3,0,0,0
2022-03-18 05:15,10,6,4,0,0,0
2022-03-18 05:30,19,12,7,0,0,0
2022-03-18 05:45,22,19,3,0,0,0
2022-03-18 06:00,35,20,15,0,0,0
2022-03-18 06:15,36,24,12,0,0,0
2022-03-18 06:30,36,22,14,0,0,0
2022-03-18 06:45,61,48,13,0,0,0
2022-03-18 07:00,84,53,31,0,0,0
2022-03-18 07:15,146,106,40,0,0,0
2022-03-18 07:30,241,185,56,0,0,0
2022-03-18 07:45,213,128,85,0,0,0
2022-03-18 08:00,128,82,46,0,0,0
2022-03-18 08:15,160,100,60,0,0,0
2022-03-18 08:30,137,77,60,0,0,0
2022-03-18 08:45,176,119,57,0,0,0
2022-03-18 09:00,124,89,35,0,0,0
2022-03-18 09:15,125,81,44,0,0,0
2022-03-18 09:30,118,72,46,0,0,0
2022-03-18 09:45,115,69,46,0,0,0
2022-03-18 10:00,90,45,45,0,0,0
2022-03-18 10:15,74,42,32,0,0,0
2022-03-18 10:30,112,69,43,0,0,0
2022-03-18 10:45,103,59,44,0,0,0
2022-03-18 11:00,82,46,36,0,0,0
2022-03-18 11:15,116,63,53,0,0,0
2022-03-18 11:30,108,62,46,0,0,0
2022-03-18 11:45,124,59,65,0,0,0
2022-03-18 12:00,143,73,70,0,0,0
2022-03-18 12:15,147,79,68,0,0,0
2022-03-18 12:30,148,83,65,0,0,0
2022-03-18 12:45,185,97,88,0,0,0
2022-03-18 13:00,211,80,131,0,0,0
2022-03-18 13:15,186,79,107,0,0,0
2022-03-18 13:30,188,78,110,0,0,0
2022-03-18 13:45,192,102,90,0,0,0
2022-03-18 14:00,168,74,94,0,0,0
2022-03-18 14:15,179,90,89,0,0,0
2022-03-18 14:30,197,101,96,0,0,0
2022-03-18 14:45,204,110,94,0,0,0
2022-03-18 15:00,175,89,86,0,0,0
2022-03-18 15:15,172,91,81,0,0,0
2022-03-18 15:30,191,88,103,0,0,0
2022-03-18 15:45,162,99,63,0,0,0
2022-03-18 16:00,163,79,84,0,0,0
2022-03-18 16:15,186,87,99,0,0,0
2022-03-18 16:30,178,92,86,0,0,0
2022-03-18 16:45,159,85,74,0,0,0
2022-03-18 17:00,201,74,127,0,0,0
2022-03-18 17:15,158,54,104,0,0,0
2022-03-18 17:30,177,92,85,0,0,0
2022-03-18 17:45,211,115,96,0,0,0
2022-03-18 18:00,195,73,122,0,0,0
2022-03-18 18:15,171,61,110,0,0,0
2022-03-18 18:30,166,70,96,0,0,0
2022-03-18 18:45,176,82,94,0,0,0
2022-03-18 19:00,168,75,93,0,0,0
2022-03-18 19:15,147,68,79,0,0,0
2022-03-18 19:30,135,57,78,0,0,0
2022-03-18 19:45,145,73,72,0,0,0
2022-03-18 20:00,144,58,86,0,0,0
2022-03-18 20:15,103,49,54,0,0,0
2022-03-18 20:30,96,50,46,0,0,0
2022-03-18 20:45,89,33,56,0,0,0
2022-03-18 21:00,70,25,45,0,0,0
2022-03-18 21:15,56,18,38,0,0,0
2022-03-18 21:30,57,23,34,0,0,0
2022-03-18 21:45,72,23,49,0,0,0
2022-03-18 22:00,60,24,36,0,0,0
2022-03-18 22:15,57,8,49,0,0,0
2022-03-18 22:30,48,14,34,0,0,0
2022-03-18 22:45,49,21,28,0,0,0
2022-03-18 23:00,48,18,30,0,0,0
2022-03-18 23:15,63,33,30,0,0,0
2022-03-18 23:30,60,21,39,0,0,0
2022-03-18 23:45,39,19,20,0,0,0
2022-03-19 00:00,79,30,49,0,0,0
2022-03-19 00:15,56,29,27,0,0,0
2022-03-19 00:30,48,15,33,0,0,0
2022-03-19 00:45,56,20,36,0,0,0
2022-03-19 01:00,40,11,29,0,0,0
2022-03-19 01:15,37,15,22,0,0,0
2022-03-19 01:30,39,9,30,0,0,0
2022-03-19 01:45,29,7,22,0,0,0
2022-03-19 02:00,32,7,25,0,0,0
2022-03-19 02:15,17,2,15,0,0,0
2022-03-19 02:30,10,3,7,0,0,0
2022-03-19 02:45,26,6,20,0,0,0
2022-03-19 03:00,22,0,22,0,0,0
2022-03-19 03:15,13,4,9,0,0,0
2022-03-19 03:30,26,1,25,0,0,0
2022-03-19 03:45,13,2,11,0,0,0
2022-03-19 04:00,12,5,7,0,0,0
2022-03-19 04:15,12,1,11,0,0,0
2022-03-19 04:30,13,3,10,0,0,0
2022-03-19 04:45,6,1,5,0,0,0
2022-03-19 05:00,12,5,7,0,0,0
2022-03-19 05:15,12,3,9,0,0,0
2022-03-19 05:30,16,7,9,0,0,0
2022-03-19 05:45,9,5,4,0,0,0
2022-03-19 06:00,8,5,3,0,0,0
2022-03-19 06:15,15,5,10,0,0,0
2022-03-19 06:30,12,7,5,0,0,0
2022-03-19 06:45,27,16,11,0,0,0
2022-03-19 07:00,7,5,2,0,0,0
2022-03-19 07:15,24,19,5,0,0,0
2022-03-19 07:30,26,18,8,0,0,0
2022-03-19 07:45,36,25,11,0,0,0
2022-03-19 08:00,34,26,8,0,0,0
2022-03-19 08:15,47,31,16,0,0,0
2022-03-19 08:30,55,41,14,0,0,0
2022-03-19 08:45,70,48,22,0,0,0
2022-03-19 09:00,66,52,14,0,0,0
2022-03-19 09:15,91,64,27,0,0,0
2022-03-19 09:30,83,61,22,0,0,0
2022-03-19 09:45,128,100,28,0,0,0
2022-03-19 10:00,85,59,26,0,0,0
2022-03-19 10:15,123,79,44,0,0,0
2022-03-19 10:30,133,90,43,0,0,0
2022-03-19 10:45,149,106,43,0,0,0
2022-03-19 11:00,114,65,49,0,0,0
2022-03-19 11:15,122,78,44,0,0,0
2022-03-19 11:30,152,83,69,0,0,0
2022-03-19 11:45,145,89,56,0,0,0
2022-03-19 12:00,155,100,55,0,0,0
2022-03-19 12:15,151,79,72,0,0,0
2022-03-19 12:30,133,73,60,0,0,0
2022-03-19 12:45,146,86,60,0,0,0
2022-03-19 13:00,144,72,72,0,0,0
2022-03-19 13:15,146,76,70,0,0,0
2022-03-19 13:30,147,67,80,0,0,0
2022-03-19 13:45,152,87,65,0,0,0
2022-03-19 14:00,156,85,71,0,0,0
2022-03-19 14:15,204,108,96,0,0,0
2022-03-19 14:30,161,77,84,0,0,0
2022-03-19 14:45,164,78,86,0,0,0
2022-03-19 15:00,163,75,88,0,0,0
2022-03-19 15:15,169,90,79,0,0,0
2022-03-19 15:30,190,94,96,0,0,0
2022-03-19 15:45,170,83,87,0,0,0
2022-03-19 16:00,136,48,88,0,0,0
2022-03-19 16:15,151,60,91,0,0,0
2022-03-19 16:30,184,65,119,0,0,0
2022-03-19 16:45,135,74,61,0,0,0
2022-03-19 17:00,182,100,82,0,0,0
2022-03-19 17:15,152,71,81,0,0,0
2022-03-19 17:30,174,83,91,0,0,0
2022-03-19 17:45,152,71,81,0,0,0
2022-03-19 18:00,163,67,96,0,0,0
2022-03-19 18:15,187,91,96,0,0,0
2022-03-19 18:30,141,59,82,0,0,0
2022-03-19 18:45,168,82,86,0,0,0
2022-03-19 19:00,167,85,82,0,0,0
2022-03-19 19:15,140,72,68,0,0,0
2022-03-19 19:30,122,50,72,0,0,0
2022-03-19 19:45,134,60,74,0,0,0
2022-03-19 20:00,131,67,64,0,0,0
2022-03-19 20:15,100,40,60,0,0,0
2022-03-19 20:30,103,45,58,0,0,0
2022-03-19 20:45,65,29,36,0,0,0
2022-03-19 21:00,82,42,40,0,0,0
2022-03-19 21:15,68,24,44,0,0,0
2022-03-19 21:30,49,13,36,0,0,0
2022-03-19 21:45,70,25,45,0,0,0
2022-03-19 22:00,67,24,43,0,0,0
2022-03-19 22:15,61,29,32,0,0,0
2022-03-19 22:30,61,13,48,0,0,0
2022-03-19 22:45,62,19,43,0,0,0
2022-03-19 23:00,61,29,32,0,0,0
2022-03-19 23:15,53,30,23,0,0,0
2022-03-19 23:30,56,21,35,0,0,0
2022-03-19 23:45,60,20,40,0,0,0
2022-03-20 00:00,61,26,35,0,0,0
2022-03-20 00:15,46,17,29,0,0,0
2022-03-20 00:30,40,21,19,0,0,0
2022-03-20 00:45,43,11,32,0,0,0
2022-03-20 01:00,39,12,27,0,0,0
2022-03-20 01:15,39,16,23,0,0,0
2022-03-20 01:30,28,3,25,0,0,0
2022-03-20 01:45,43,14,29,0,0,0
2022-03-20 02:00,32,11,21,0,0,0
2022-03-20 02:15,27,3,24,0,0,0
2022-03-20 02:30,24,9,15,0,0,0
2022-03-20 02:45,26,7,19,0,0,0
2022-03-20 03:00,24,4,20,0,0,0
2022-03-20 03:15,15,4,11,0,0,0
2022-03-20 03:30,18,6,12,0,0,0
2022-03-20 03:45,11,3,8,0,0,0
2022-03-20 04:00,19,1,18,0,0,0
2022-03-20 04:15,21,3,18,0,0,0
2022-03-20 04:30,20,2,18,0,0,0
2022-03-20 04:45,12,1,11,0,0,0
2022-03-20 05:00,6,0,6,0,0,0
2022-03-20 05:15,11,4,7,0,0,0
2022-03-20 05:30,12,4,8,0,0,0
2022-03-20 05:45,11,8,3,0,0,0
2022-03-20 06:00,10,6,4,0,0,0
2022-03-20 06:15,9,5,4,0,0,0
2022-03-20 06:30,10,4,6,0,0,0
2022-03-20 06:45,8,5,3,0,0,0
2022-03-20 07:00,12,5,7,0,0,0
2022-03-20 07:15,15,10,5,0,0,0
2022-03-20 07:30,12,8,4,0,0,0
2022-03-20 07:45,7,7,0,0,0,0
2022-03-20 08:00,11,9,2,0,0,0
2022-03-20 08:15,14,8,6,0,0,0
2022-03-20 08:30,26,17,9,0,0,0
2022-03-20 08:45,23,12,11,0,0,0
2022-03-20 09:00,30,16,14,0,0,0
2022-03-20 09:15,35,23,12,0,0,0
2022-03-20 09:30,49,33,16,0,0,0
2022-03-20 09:45,88,65,23,0,0,0
2022-03-20 10:00,68,35,33,0,0,0
2022-03-20 10:15,53,40,13,0,0,0
2022-03-20 10:30,71,50,21,0,0,0
2022-03-20 10:45,81,51,30,0,0,0
2022-03-20 11:00,81,43,38,0,0,0
2022-03-20 11:15,82,60,22,0,0,0
2022-03-20 11:30,75,44,31,0,0,0
2022-03-20 11:45,76,49,27,0,0,0
2022-03-20 12:00,70,31,39,0,0,0
2022-03-20 12:15,107,58,49,0,0,0
2022-03-20 12:30,125,73,52,0,0,0
2022-03-20 12:45,119,70,49,0,0,0
2022-03-20 13:00,129,55,74,0,0,0
2022-03-20 13:15,103,53,50,0,0,0
2022-03-20 13:30,97,47,50,0,0,0
2022-03-20 13:45,117,68,49,0,0,0
2022-03-20 14:00,113,51,62,0,0,0
2022-03-20 14:15,132,70,62,0,0,0
2022-03-20 14:30,161,95,66,0,0,0
2022-03-20 14:45,166,108,58,0,0,0
2022-03-20 15:00,132,74,58,0,0,0
2022-03-20 15:15,141,80,61,0,0,0
2022-03-20 15:30,126,61,65,0,0,0
2022-03-20 15:45,134,72,62,0,0,0
2022-03-20 16:00,134,52,82,0,0,0
2022-03-20 16:15,132,59,73,0,0,0
2022-03-20 16:30,118,46,72,0,0,0
2022-03-20 16:45,146,65,81,0,0,0
2022-03-20 17:00,120,52,68,0,0,0
2022-03-20 17:15,99,43,56,0,0,0
2022-03-20 17:30,131,46,85,0,0,0
2022-03-20 17:45,113,52,61,0,0,0
2022-03-20 18:00,107,50,57,0,0,0
2022-03-20 18:15,121,51,70,0,0,0
2022-03-20 18:30,86,35,51,0,0,0
2022-03-20 18:45,97,53,44,0,0,0
2022-03-20 19:00,109,60,49,0,0,0
2022-03-20 19:15,91,43,48,0,0,0
2022-03-20 19:30,84,34,50,0,0,0
2022-03-20 19:45,78,32,46,0,0,0
2022-03-20 20:00,78,26,52,0,0,0
2022-03-20 20:15,73,23,50,0,0,0
2022-03-20 20:30,56,14,42,0,0,0
2022-03-20 20:45,55,20,35,0,0,0
2022-03-20 21:00,44,18,26,0,0,0
2022-03-20 21:15,30,4,26,0,0,0
2022-03-20 21:30,62,17,45,0,0,0
2022-03-20 21:45,36,11,25,0,0,0
2022-03-20 22:00,27,11,16,0,0,0
2022-03-20 22:15,35,11,24,0,0,0
2022-03-20 22:30,29,17,12,0,0,0
2022-03-20 22:45,31,8,23,0,0,0
2022-03-20 23:00,25,7,18,0,0,0
2022-03-20 23:15,26,11,15,0,0,0
2022-03-20 23:30,14,4,10,0,0,0
2022-03-20 23:45,23,5,18,0,0,0
2022-03-21 00:00,10,3,7,0,0,0
2022-03-21 00:15,9,1,8,0,0,0
2022-03-21 00:30,8,6,2,0,0,0
2022-03-21 00:45,8,2,6,0,0,0
2022-03-21 01:00,6,3,3,0,0,0
2022-03-21 01:15,13,3,10,0,0,0
2022-03-21 01:30,5,1,4,0,0,0
2022-03-21 01:45,6,1,5,0,0,0
2022-03-21 02:00,5,3,2,0,0,0
2022-03-21 02:15,2,0,2,0,0,0
2022-03-21 02:30,1,1,0,0,0,0
2022-03-21 02:45,0,0,0,0,0,0
2022-03-21 03:00,2,0,2,0,0,0
2022-03-21 03:15,1,1,0,0,0,0
2022-03-21 03:30,2,2,0,0,0,0
2022-03-21 03:45,3,1,2,0,0,0
2022-03-21 04:00,5,0,5,0,0,0
2022-03-21 04:15,5,1,4,0,0,0
2022-03-21 04:30,6,4,2,0,0,0
2022-03-21 04:45,5,4,1,0,0,0
2022-03-21 05:00,9,8,1,0,0,0
2022-03-21 05:15,16,12,4,0,0,0
2022-03-21 05:30,26,19,7,0,0,0
2022-03-21 05:45,24,18,6,0,0,0
2022-03-21 06:00,25,14,11,0,0,0
2022-03-21 06:15,47,34,13,0,0,0
2022-03-21 06:30,58,34,24,0,0,0
2022-03-21 06:45,81,63,18,0,0,0
2022-03-21 07:00,102,69,33,0,0,0
2022-03-21 07:15,157,110,47,0,0,0
2022-03-21 07:30,317,241,76,0,0,0
2022-03-21 07:45,272,183,89,0,0,0
2022-03-21 08:00,165,103,62,0,0,0
2022-03-21 08:15,181,113,68,0,0,0
2022-03-21 08:30,174,106,68,0,0,0
2022-03-21 08:45,186,116,70,0,0,0
2022-03-21 09:00,125,76,49,0,0,0
2022-03-21 09:15,137,91,46,0,0,0
2022-03-21 09:30,133,82,51,0,0,0
2022-03-21 09:45,126,87,39,0,0,0
2022-03-21 10:00,97,60,37,0,0,0
2022-03-21 10:15,91,53,38,0,0,0
2022-03-21 10:30,104,58,46,0,0,0
2022-03-21 10:45,105,57,48,0,0,0
2022-03-21 11:00,103,50,53,0,0,0
2022-03-21 11:15,97,50,47,0,0,0
2022-03-21 11:30,104,64,40,0,0,0
2022-03-21 11:45,124,58,66,0,0,0
2022-03-21 12:00,136,73,63,0,0,0
2022-03-21 12:15,155,89,66,0,0,0
2022-03-21 12:30,150,70,80,0,0,0
2022-03-21 12:45,157,76,81,0,0,0
2022-03-21 13:00,172,71,101,0,0,0
2022-03-21 13:15,165,68,97,0,0,0
2022-03-21 13:30,148,62,86,0,0,0
2022-03-21 13:45,153,75,78,0,0,0
2022-03-21 14:00,172,80,92,0,0,0
2022-03-21 14:15,139,74,65,0,0,0
2022-03-21 14:30,145,70,75,0,0,0
2022-03-21 14:45,242,102,140,0,0,0
2022-03-21 15:00,180,83,97,0,0,0
2022-03-21 15:15,202,103,99,0,0,0
2022-03-21 15:30,237,101,136,0,0,0
2022-03-21 15:45,246,124,122,0,0,0
2022-03-21 16:00,226,119,107,0,0,0
2022-03-21 16:15,223,100,123,0,0,0
2022-03-21 16:30,284,142,142,0,0,0
2022-03-21 16:45,301,142,159,0,0,0
2022-03-21 17:00,249,134,115,0,0,0
2022-03-21 17:15,287,138,149,0,0,0
2022-03-21 17:30,263,131,132,0,0,0
2022-03-21 17:45,234,107,127,0,0,0
2022-03-21 18:00,258,104,154,0,0,0
2022-03-21 18:15,222,91,131,0,0,0
2022-03-21 18:30,230,103,127,0,0,0
2022-03-21 18:45,233,107,126,0,0,0
2022-03-21 19:00,182,69,113,0,0,0
2022-03-21 19:15,182,80,102,0,0,0
2022-03-21 19:30,156,70,86,0,0,0
2022-03-21 19:45,160,54,106,0,0,0
2022-03-21 20:00,145,54,91,0,0,0
2022-03-21 20:15,101,26,75,0,0,0
2022-03-21 20:30,101,34,67,0,0,0
2022-03-21 20:45,68,25,43,0,0,0
2022-03-21 21:00,98,35,63,0,0,0
2022-03-21 21:15,83,29,54,0,0,0
2022-03-21 21:30,66,21,45,0,0,0
2022-03-21 21:45,78,17,61,0,0,0
2022-03-21 22:00,58,25,33,0,0,0
2022-03-21 22:15,59,14,45,0,0,0
2022-03-21 22:30,57,16,41,0,0,0
2022-03-21 22:45,39,11,28,0,0,0
2022-03-21 23:00,33,6,27,0,0,0
2022-03-21 23:15,48,10,38,0,0,0
2022-03-21 23:30,16,4,12,0,0,0
2022-03-21 23:45,22,5,17,0,0,0
2022-03-22 00:00,14,4,10,0,0,0
2022-03-22 00:15,18,5,13,0,0,0
2022-03-22 00:30,12,4,8,0,0,0
2022-03-22 00:45,8,3,5,0,0,0
2022-03-22 01:00,5,1,4,0,0,0
2022-03-22 01:15,10,4,6,0,0,0
2022-03-22 01:30,6,1,5,0,0,0
2022-03-22 01:45,7,4,3,0,0,0
2022-03-22 02:00,6,2,4,0,0,0
2022-03-22 02:15,8,4,4,0,0,0
2022-03-22 02:30,2,1,1,0,0,0
2022-03-22 02:45,6,2,4,0,0,0
2022-03-22 03:00,1,0,1,0,0,0
2022-03-22 03:15,3,0,3,0,0,0
2022-03-22 03:30,5,3,2,0,0,0
2022-03-22 03:45,0,0,0,0,0,0
2022-03-22 04:00,0,0,0,0,0,0
2022-03-22 04:15,5,2,3,0,0,0
2022-03-22 04:30,6,5,1,0,0,0
2022-03-22 04:45,6,5,1,0,0,0
2022-03-22 05:00,11,7,4,0,0,0
2022-03-22 05:15,16,8,8,0,0,0
2022-03-22 05:30,26,18,8,0,0,0
2022-03-22 05:45,32,23,9,0,0,0
2022-03-22 06:00,32,20,12,0,0,0
2022-03-22 06:15,60,42,18,0,0,0
2022-03-22 06:30,67,40,27,0,0,0
2022-03-22 06:45,90,64,26,0,0,0
2022-03-22 07:00,123,82,41,0,0,0
2022-03-22 07:15,169,121,48,0,0,0
2022-03-22 07:30,320,238,82,0,0,0
2022-03-22 07:45,286,179,107,0,0,0
2022-03-22 08:00,181,113,68,0,0,0
2022-03-22 08:15,216,135,81,0,0,0
2022-03-22 08:30,180,105,75,0,0,0
2022-03-22 08:45,229,140,89,0,0,0
2022-03-22 09:00,138,87,51,0,0,0
2022-03-22 09:15,149,96,53,0,0,0
2022-03-22 09:30,128,72,56,0,0,0
2022-03-22 09:45,137,84,53,0,0,0
2022-03-22 10:00,103,66,37,0,0,0
2022-03-22 10:15,87,46,41,0,0,0
2022-03-22 10:30,104,72,32,0,0,0
2022-03-22 10:45,127,71,56,0,0,0
2022-03-22 11:00,112,56,56,0,0,0
2022-03-22 11:15,115,53,62,0,0,0
2022-03-22 11:30,96,58,38,0,0,0
2022-03-22 11:45,147,81,66,0,0,0
2022-03-22 12:00,152,76,76,0,0,0
2022-03-22 12:15,160,79,81,0,0,0
2022-03-22 12:30,157,74,83,0,0,0
2022-03-22 12:45,180,100,80,0,0,0
2022-03-22 13:00,206,63,143,0,0,0
2022-03-22 13:15,179,80,99,0,0,0
2022-03-22 13:30,188,99,89,0,0,0
2022-03-22 13:45,199,88,111,0,0,0
2022-03-22 14:00,195,93,102,0,0,0
2022-03-22 14:15,175,86,89,0,0,0
2022-03-22 14:30,158,79,79,0,0,0
2022-03-22 14:45,166,69,97,0,0,0
2022-03-22 15:00,157,77,80,0,0,0
2022-03-22 15:15,201,105,96,0,0,0
2022-03-22 15:30,222,109,113,0,0,0
2022-03-22 15:45,246,126,120,0,0,0
2022-03-22 16:00,236,122,114,0,0,0
2022-03-22 16:15,255,129,126,0,0,0
2022-03-22 16:30,288,154,134,0,0,0
2022-03-22 16:45,306,146,160,0,0,0
2022-03-22 17:00,262,141,121,0,0,0
2022-03-22 17:15,287,156,131,0,0,0
2022-03-22 17:30,268,125,143,0,0,0
2022-03-22 17:45,271,109,162,0,0,0
2022-03-22 18:00,251,107,144,0,0,0
2022-03-22 18:15,263,113,150,0,0,0
2022-03-22 18:30,227,104,123,0,0,0
2022-03-22 18:45,256,110,146,0,0,0
2022-03-22 19:00,198,82,116,0,0,0
2022-03-22 19:15,191,77,114,0,0,0
2022-03-22 19:30,180,86,94,0,0,0
2022-03-22 19:45,149,68,81,0,0,0
2022-03-22 20:00,124,48,76,0,0,0
2022-03-22 20:15,128,51,77,0,0,0
2022-03-22 20:30,87,39,48,0,0,0
2022-03-22 20:45,93,27,66,0,0,0
2022-03-22 21:00,87,35,52,0,0,0
2022-03-22 21:15,111,46,65,0,0,0
2022-03-22 21:30,92,39,53,0,0,0
2022-03-22 21:45,86,18,68,0,0,0
2022-03-22 22:00,68,19,49,0,0,0
2022-03-22 22:15,76,27,49,0,0,0
2022-03-22 22:30,66,19,47,0,0,0
2022-03-22 22:45,55,6,49,0,0,0
2022-03-22 23:00,37,13,24,0,0,0
2022-03-22 23:15,40,5,35,0,0,0
2022-03-22 23:30,35,8,27,0,0,0
2022-03-22 23:45,24,7,17,0,0,0
2022-03-23 00:00,17,6,11,0,0,0
2022-03-23 00:15,11,3,8,0,0,0
2022-03-23 00:30,8,3,5,0,0,0
2022-03-23 00:45,11,5,6,0,0,0
2022-03-23 01:00,9,5,4,0,0,0
2022-03-23 01:15,16,2,14,0,0,0
2022-03-23 01:30,11,2,9,0,0,0
2022-03-23 01:45,5,0,5,0,0,0
2022-03-23 02:00,9,3,6,0,0,0
2022-03-23 02:15,4,1,3,0,0,0
2022-03-23 02:30,2,0,2,0,0,0
2022-03-23 02:45,1,0,1,0,0,0
2022-03-23 03:00,0,0,0,0,0,0
2022-03-23 03:15,2,1,1,0,0,0
2022-03-23 03:30,3,2,1,0,0,0
2022-03-23 03:45,5,3,2,0,0,0
2022-03-23 04:00,6,4,2,0,0,0
2022-03-23 04:15,4,2,2,0,0,0
2022-03-23 04:30,6,3,3,0,0,0
2022-03-23 04:45,8,5,3,0,0,0
2022-03-23 05:00,7,4,3,0,0,0
2022-03-23 05:15,17,11,6,0,0,0
2022-03-23 05:30,30,22,8,0,0,0
2022-03-23 05:45,30,23,7,0,0,0
2022-03-23 06:00,36,20,16,0,0,0
2022-03-23 06:15,49,37,12,0,0,0
2022-03-23 06:30,52,37,15,0,0,0
2022-03-23 06:45,98,72,26,0,0,0
2022-03-23 07:00,115,78,37,0,0,0
2022-03-23 07:15,200,132,68,0,0,0
2022-03-23 07:30,305,227,78,0,0,0
2022-03-23 07:45,300,183,117,0,0,0
2022-03-23 08:00,218,135,83,0,0,0
2022-03-23 08:15,236,161,75,0,0,0
2022-03-23 08:30,194,126,68,0,0,0
2022-03-23 08:45,218,133,85,0,0,0
2022-03-23 09:00,169,107,62,0,0,0
2022-03-23 09:15,145,88,57,0,0,0
2022-03-23 09:30,159,103,56,0,0,0
2022-03-23 09:45,173,104,69,0,0,0
2022-03-23 10:00,161,107,54,0,0,0
2022-03-23 10:15,115,61,54,0,0,0
2022-03-23 10:30,122,72,50,0,0,0
2022-03-23 10:45,133,83,50,0,0,0
2022-03-23 11:00,115,67,48,0,0,0
2022-03-23 11:15,137,84,53,0,0,0
2022-03-23 11:30,127,78,49,0,0,0
2022-03-23 11:45,141,88,53,0,0,0
2022-03-23 12:00,159,79,80,0,0,0
2022-03-23 12:15,195,107,88,0,0,0
2022-03-23 12:30,185,87,98,0,0,0
2022-03-23 12:45,195,104,91,0,0,0
2022-03-23 13:00,177,63,114,0,0,0
2022-03-23 13:15,206,80,126,0,0,0
2022-03-23 13:30,203,98,105,0,0,0
2022-03-23 13:45,252,102,150,0,0,0
2022-03-23 14:00,238,109,129,0,0,0
2022-03-23 14:15,205,108,97,0,0,0
2022-03-23 14:30,177,87,90,0,0,0
2022-03-23 14:45,242,124,118,0,0,0
2022-03-23 15:00,211,87,124,0,0,0
2022-03-23 15:15,239,128,111,0,0,0
2022-03-23 15:30,218,86,132,0,0,0
2022-03-23 15:45,222,106,116,0,0,0
2022-03-23 16:00,229,113,116,0,0,0
2022-03-23 16:15,280,135,145,0,0,0
2022-03-23 16:30,289,149,140,0,0,0
2022-03-23 16:45,279,138,141,0,0,0
2022-03-23 17:00,274,137,137,0,0,0
2022-03-23 17:15,279,137,142,0,0,0
2022-03-23 17:30,257,108,149,0,0,0
2022-03-23 17:45,284,135,149,0,0,0
2022-03-23 18:00,243,106,137,0,0,0
2022-03-23 18:15,272,129,143,0,0,0
2022-03-23 18:30,245,126,119,0,0,0
2022-03-23 18:45,261,122,139,0,0,0
2022-03-23 19:00,189,95,94,0,0,0
2022-03-23 19:15,198,81,117,0,0,0
2022-03-23 19:30,213,97,116,0,0,0
2022-03-23 19:45,182,93,89,0,0,0
2022-03-23 20:00,152,68,84,0,0,0
2022-03-23 20:15,142,63,79,0,0,0
2022-03-23 20:30,99,38,61,0,0,0
2022-03-23 20:45,106,34,72,0,0,0
2022-03-23 21:00,102,46,56,0,0,0
2022-03-23 21:15,93,33,60,0,0,0
2022-03-23 21:30,115,38,77,0,0,0
2022-03-23 21:45,96,31,65,0,0,0
2022-03-23 22:00,87,22,65,0,0,0
2022-03-23 22:15,106,22,84,0,0,0
2022-03-23 22:30,114,32,82,0,0,0
2022-03-23 22:45,78,16,62,0,0,0
2022-03-23 23:00,92,15,77,0,0,0
2022-03-23 23:15,76,28,48,0,0,0
2022-03-23 23:30,49,9,40,0,0,0
2022-03-23 23:45,19,7,12,0,0,0
2022-03-24 00:00,46,14,32,0,0,0
2022-03-24 00:15,32,16,16,0,0,0
2022-03-24 00:30,26,6,20,0,0,0
2022-03-24 00:45,28,4,24,0,0,0
2022-03-24 01:00,24,14,10,0,0,0
2022-03-24 01:15,18,7,11,0,0,0
2022-03-24 01:30,17,2,15,0,0,0
2022-03-24 01:45,8,3,5,0,0,0
2022-03-24 02:00,16,2,14,0,0,0
2022-03-24 02:15,13,1,12,0,0,0
2022-03-24 02:30,16,0,16,0,0,0
2022-03-24 02:45,13,1,12,0,0,0
2022-03-24 03:00,13,3,10,0,0,0
2022-03-24 03:15,9,2,7,0,0,0
2022-03-24 03:30,9,1,8,0,0,0
2022-03-24 03:45,11,3,8,0,0,0
2022-03-24 04:00,5,0,5,0,0,0
2022-03-24 04:15,9,3,6,0,0,0
2022-03-24 04:30,5,2,3,0,0,0
2022-03-24 04:45,13,4,9,0,0,0
2022-03-24 05:00,10,8,2,0,0,0
2022-03-24 05:15,15,7,8,0,0,0
2022-03-24 05:30,35,22,13,0,0,0
2022-03-24 05:45,23,14,9,0,0,0
2022-03-24 06:00,39,23,16,0,0,0
2022-03-24 06:15,42,27,15,0,0,0
2022-03-24 06:30,56,36,20,0,0,0
2022-03-24 06:45,89,65,24,0,0,0
2022-03-24 07:00,113,79,34,0,0,0
2022-03-24 07:15,172,125,47,0,0,0
2022-03-24 07:30,302,216,86,0,0,0
2022-03-24 07:45,259,175,84,0,0,0
2022-03-24 08:00,176,106,70,0,0,0
2022-03-24 08:15,205,115,90,0,0,0
2022-03-24 08:30,168,99,69,0,0,0
2022-03-24 08:45,228,139,89,0,0,0
2022-03-24 09:00,142,88,54,0,0,0
2022-03-24 09:15,140,93,47,0,0,0
2022-03-24 09:30,160,105,55,0,0,0
2022-03-24 09:45,125,75,50,0,0,0
2022-03-24 10:00,120,83,37,0,0,0
2022-03-24 10:15,93,53,40,0,0,0
2022-03-24 10:30,128,76,52,0,0,0
2022-03-24 10:45,132,75,57,0,0,0
2022-03-24 11:00,117,56,61,0,0,0
2022-03-24 11:15,113,55,58,0,0,0
2022-03-24 11:30,120,55,65,0,0,0
2022-03-24 11:45,155,82,73,0,0,0
2022-03-24 12:00,137,75,62,0,0,0
2022-03-24 12:15,151,77,74,0,0,0
2022-03-24 12:30,159,75,84,0,0,0
2022-03-24 12:45,171,87,84,0,0,0
2022-03-24 13:00,180,81,99,0,0,0
2022-03-24 13:15,166,81,85,0,0,0
2022-03-24 13:30,194,100,94,0,0,0
2022-03-24 13:45,214,104,110,0,0,0
2022-03-24 14:00,196,87,109,0,0,0
2022-03-24 14:15,186,88,98,0,0,0
2022-03-24 14:30,192,105,87,0,0,0
2022-03-24 14:45,228,120,108,0,0,0
2022-03-24 15:00,208,109,99,0,0,0
2022-03-24 15:15,194,105,89,0,0,0
2022-03-24 15:30,249,97,152,0,0,0
2022-03-24 15:45,273,142,131,0,0,0
2022-03-24 16:00,248,123,125,0,0,0
2022-03-24 16:15,297,151,146,0,0,0
2022-03-24 16:30,266,134,132,0,0,0
2022-03-24 16:45,273,132,141,0,0,0
2022-03-24 17:00,263,146,117,0,0,0
2022-03-24 17:15,278,155,123,0,0,0
2022-03-24 17:30,268,126,142,0,0,0
2022-03-24 17:45,295,149,146,0,0,0
2022-03-24 18:00,275,117,158,0,0,0
2022-03-24 18:15,248,118,130,0,0,0
2022-03-24 18:30,249,104,145,0,0,0
2022-03-24 18:45,256,130,126,0,0,0
2022-03-24 19:00,219,101,118,0,0,0
2022-03-24 19:15,198,90,108,0,0,0
2022-03-24 19:30,146,65,81,0,0,0
2022-03-24 19:45,164,81,83,0,0,0
2022-03-24 20:00,145,47,98,0,0,0
2022-03-24 20:15,139,36,103,0,0,0
2022-03-24 20:30,105,25,80,0,0,0
2022-03-24 20:45,108,30,78,0,0,0
2022-03-24 21:00,87,42,45,0,0,0
2022-03-24 21:15,78,24,54,0,0,0
2022-03-24 21:30,87,34,53,0,0,0
2022-03-24 21:45,73,21,52,0,0,0
2022-03-24 22:00,83,22,61,0,0,0
2022-03-24 22:15,88,27,61,0,0,0
2022-03-24 22:30,65,21,44,0,0,0
2022-03-24 22:45,46,9,37,0,0,0
2022-03-24 23:00,53,17,36,0,0,0
2022-03-24 23:15,51,15,36,0,0,0
2022-03-24 23:30,45,10,35,0,0,0
2022-03-24 23:45,47,6,41,0,0,0
2022-03-25 00:00,26,7,19,0,0,0
2022-03-25 00:15,26,7,19,0,0,0
2022-03-25 00:30,21,6,15,0,0,0
2022-03-25 00:45,17,5,12,0,0,0
2022-03-25 01:00,11,1,10,0,0,0
2022-03-25 01:15,11,1,10,0,0,0
2022-03-25 01:30,15,5,10,0,0,0
2022-03-25 01:45,6,1,5,0,0,0
2022-03-25 02:00,14,2,12,0,0,0
2022-03-25 02:15,8,2,6,0,0,0
2022-03-25 02:30,5,2,3,0,0,0
2022-03-25 02:45,1,1,0,0,0,0
2022-03-25 03:00,5,2,3,0,0,0
2022-03-25 03:15,4,1,3,0,0,0
2022-03-25 03:30,4,1,3,0,0,0
2022-03-25 03:45,1,0,1,0,0,0
2022-03-25 04:00,1,0,1,0,0,0
2022-03-25 04:15,5,2,3,0,0,0
2022-03-25 04:30,9,4,5,0,0,0
2022-03-25 04:45,6,5,1,0,0,0
2022-03-25 05:00,8,4,4,0,0,0
2022-03-25 05:15,15,7,8,0,0,0
2022-03-25 05:30,27,19,8,0,0,0
2022-03-25 05:45,18,15,3,0,0,0
2022-03-25 06:00,26,14,12,0,0,0
2022-03-25 06:15,40,34,6,0,0,0
2022-03-25 06:30,49,32,17,0,0,0
2022-03-25 06:45,84,54,30,0,0,0
2022-03-25 07:00,97,65,32,0,0,0
2022-03-25 07:15,135,100,35,0,0,0
2022-03-25 07:30,256,179,77,0,0,0
2022-03-25 07:45,244,152,92,0,0,0
2022-03-25 08:00,165,96,69,0,0,0
2022-03-25 08:15,148,92,56,0,0,0
2022-03-25 08:30,159,101,58,0,0,0
2022-03-25 08:45,170,92,78,0,0,0
2022-03-25 09:00,150,103,47,0,0,0
2022-03-25 09:15,125,82,43,0,0,0
2022-03-25 09:30,114,72,42,0,0,0
2022-03-25 09:45,153,93,60,0,0,0
2022-03-25 10:00,115,70,45,0,0,0
2022-03-25 10:15,141,79,62,0,0,0
2022-03-25 10:30,105,62,43,0,0,0
2022-03-25 10:45,134,75,59,0,0,0
2022-03-25 11:00,124,92,32,0,0,0
2022-03-25 11:15,127,65,62,0,0,0
2022-03-25 11:30,144,77,67,0,0,0
2022-03-25 11:45,156,75,81,0,0,0
2022-03-25 12:00,144,65,79,0,0,0
2022-03-25 12:15,144,80,64,0,0,0
2022-03-25 12:30,163,93,70,0,0,0
2022-03-25 12:45,182,102,80,0,0,0
2022-03-25 13:00,236,109,127,0,0,0
2022-03-25 13:15,206,83,123,0,0,0
2022-03-25 13:30,209,98,111,0,0,0
2022-03-25 13:45,245,158,87,0,0,0
2022-03-25 14:00,241,144,97,0,0,0
2022-03-25 14:15,205,103,102,0,0,0
2022-03-25 14:30,213,111,102,0,0,0
2022-03-25 14:45,206,113,93,0,0,0
2022-03-25 15:00,226,116,110,0,0,0
2022-03-25 15:15,195,101,94,0,0,0
2022-03-25 15:30,212,103,109,0,0,0
2022-03-25 15:45,228,119,109,0,0,0
2022-03-25 16:00,249,110,139,0,0,0
2022-03-25 16:15,234,105,129,0,0,0
2022-03-25 16:30,232,118,114,0,0,0
2022-03-25 16:45,260,138,122,0,0,0
2022-03-25 17:00,222,113,109,0,0,0
2022-03-25 17:15,209,99,110,0,0,0
2022-03-25 17:30,215,92,123,0,0,0
2022-03-25 17:45,219,112,107,0,0,0
2022-03-25 18:00,232,113,119,0,0,0
2022-03-25 18:15,193,88,105,0,0,0
2022-03-25 18:30,190,93,97,0,0,0
2022-03-25 18:45,239,116,123,0,0,0
2022-03-25 19:00,199,111,88,0,0,0
2022-03-25 19:15,170,86,84,0,0,0
2022-03-25 19:30,201,92,109,0,0,0
2022-03-25 19:45,142,68,74,0,0,0
2022-03-25 20:00,161,85,76,0,0,0
2022-03-25 20:15,107,51,56,0,0,0
2022-03-25 20:30,103,43,60,0,0,0
2022-03-25 20:45,147,62,85,0,0,0
2022-03-25 21:00,101,37,64,0,0,0
2022-03-25 21:15,111,48,63,0,0,0
2022-03-25 21:30,99,47,52,0,0,0
2022-03-25 21:45,116,57,59,0,0,0
2022-03-25 22:00,73,26,47,0,0,0
2022-03-25 22:15,86,32,54,0,0,0
2022-03-25 22:30,84,35,49,0,0,0
2022-03-25 22:45,91,21,70,0,0,0
2022-03-25 23:00,71,14,57,0,0,0
2022-03-25 23:15,53,20,33,0,0,0
2022-03-25 23:30,62,16,46,0,0,0
2022-03-25 23:45,66,19,47,0,0,0
2022-03-26 00:00,57,21,36,0,0,0
2022-03-26 00:15,45,17,28,0,0,0
2022-03-26 00:30,43,7,36,0,0,0
2022-03-26 00:45,59,19,40,0,0,0
2022-03-26 01:00,51,11,40,0,0,0
2022-03-26 01:15,36,5,31,0,0,0
2022-03-26 01:30,31,12,19,0,0,0
2022-03-26 01:45,40,5,35,0,0,0
2022-03-26 02:00,39,7,32,0,0,0
2022-03-26 02:15,29,9,20,0,0,0
2022-03-26 02:30,20,9,11,0,0,0
2022-03-26 02:45,21,7,14,0,0,0
2022-03-26 03:00,20,6,14,0,0,0
2022-03-26 03:15,25,3,22,0,0,0
2022-03-26 03:30,34,12,22,0,0,0
2022-03-26 03:45,12,2,10,0,0,0
2022-03-26 04:00,12,5,7,0,0,0
2022-03-26 04:15,9,1,8,0,0,0
2022-03-26 04:30,7,1,6,0,0,0
2022-03-26 04:45,10,4,6,0,0,0
2022-03-26 05:00,13,7,6,0,0,0
2022-03-26 05:15,10,2,8,0,0,0
2022-03-26 05:30,19,6,13,0,0,0
2022-03-26 05:45,16,8,8,0,0,0
2022-03-26 06:00,9,3,6,0,0,0
2022-03-26 06:15,11,6,5,0,0,0
2022-03-26 06:30,9,4,5,0,0,0
2022-03-26 06:45,16,8,8,0,0,0
2022-03-26 07:00,14,10,4,0,0,0
2022-03-26 07:15,20,16,4,0,0,0
2022-03-26 07:30,33,24,9,0,0,0
2022-03-26 07:45,37,16,21,0,0,0
2022-03-26 08:00,42,25,17,0,0,0
2022-03-26 08:15,55,35,20,0,0,0
2022-03-26 08:30,48,31,17,0,0,0
2022-03-26 08:45,65,40,25,0,0,0
2022-03-26 09:00,76,49,27,0,0,0
2022-03-26 09:15,78,49,29,0,0,0
2022-03-26 09:30,132,98,34,0,0,0
2022-03-26 09:45,153,113,40,0,0,0
2022-03-26 10:00,137,91,46,0,0,0
2022-03-26 10:15,127,77,50,0,0,0
2022-03-26 10:30,93,55,38,0,0,0
2022-03-26 10:45,118,78,40,0,0,0
2022-03-26 11:00,143,92,51,0,0,0
2022-03-26 11:15,140,88,52,0,0,0
2022-03-26 11:30,131,77,54,0,0,0
2022-03-26 11:45,167,100,67,0,0,0
2022-03-26 12:00,138,78,60,0,0,0
2022-03-26 12:15,164,100,64,0,0,0
2022-03-26 12:30,180,103,77,0,0,0
2022-03-26 12:45,166,109,57,0,0,0
2022-03-26 13:00,169,81,88,0,0,0
2022-03-26 13:15,191,113,78,0,0,0
2022-03-26 13:30,175,100,75,0,0,0
2022-03-26 13:45,181,90,91,0,0,0
2022-03-26 14:00,179,110,69,0,0,0
2022-03-26 14:15,187,88,99,0,0,0
2022-03-26 14:30,184,93,91,0,0,0
2022-03-26 14:45,216,124,92,0,0,0
2022-03-26 15:00,195,112,83,0,0,0
2022-03-26 15:15,159,97,62,0,0,0
2022-03-26 15:30,211,105,106,0,0,0
2022-03-26 15:45,211,123,88,0,0,0
2022-03-26 16:00,176,87,89,0,0,0
2022-03-26 16:15,188,85,103,0,0,0
2022-03-26 16:30,188,98,90,0,0,0
2022-03-26 16:45,169,78,91,0,0,0
2022-03-26 17:00,146,65,81,0,0,0
2022-03-26 17:15,191,105,86,0,0,0
2022-03-26 17:30,163,72,91,0,0,0
2022-03-26 17:45,181,70,111,0,0,0
2022-03-26 18:00,196,107,89,0,0,0
2022-03-26 18:15,192,86,106,0,0,0
2022-03-26 18:30,178,85,93,0,0,0
2022-03-26 18:45,191,126,65,0,0,0
2022-03-26 19:00,176,82,94,0,0,0
2022-03-26 19:15,131,51,80,0,0,0
2022-03-26 19:30,156,54,102,0,0,0
2022-03-26 19:45,166,72,94,0,0,0
2022-03-26 20:00,146,60,86,0,0,0
2022-03-26 20:15,123,55,68,0,0,0
2022-03-26 20:30,106,46,60,0,0,0
2022-03-26 20:45,91,44,47,0,0,0
2022-03-26 21:00,89,33,56,0,0,0
2022-03-26 21:15,67,27,40,0,0,0
2022-03-26 21:30,69,19,50,0,0,0
2022-03-26 21:45,75,31,44,0,0,0
2022-03-26 22:00,78,22,56,0,0,0
2022-03-26 22:15,75,26,49,0,0,0
2022-03-26 22:30,62,21,41,0,0,0
2022-03-26 22:45,79,35,44,0,0,0
2022-03-26 23:00,61,19,42,0,0,0
2022-03-26 23:15,80,30,50,0,0,0
2022-03-26 23:30,66,21,45,0,0,0
2022-03-26 23:45,74,20,54,0,0,0
2022-03-27 00:00,64,24,40,0,0,0
2022-03-27 00:15,71,29,42,0,0,0
2022-03-27 00:30,48,7,41,0,0,0
2022-03-27 00:45,56,20,36,0,0,0
2022-03-27 01:00,44,20,24,0,0,0
2022-03-27 01:15,40,7,33,0,0,0
2022-03-27 01:30,38,21,17,0,0,0
2022-03-27 01:45,20,10,10,0,0,0
2022-03-27 03:00,24,8,16,0,0,0
2022-03-27 03:15,29,6,23,0,0,0
2022-03-27 03:30,27,13,14,0,0,0
2022-03-27 03:45,35,11,24,0,0,0
2022-03-27 04:00,25,12,13,0,0,0
2022-03-27 04:15,14,6,8,0,0,0
2022-03-27 04:30,24,6,18,0,0,0
2022-03-27 04:45,16,2,14,0,0,0
2022-03-27 05:00,13,2,11,0,0,0
2022-03-27 05:15,20,4,16,0,0,0
2022-03-27 05:30,17,1,16,0,0,0
2022-03-27 05:45,23,2,21,0,0,0
2022-03-27 06:00,12,2,10,0,0,0
2022-03-27 06:15,10,1,9,0,0,0
2022-03-27 06:30,11,5,6,0,0,0
2022-03-27 06:45,11,3,8,0,0,0
2022-03-27 07:00,8,4,4,0,0,0
2022-03-27 07:15,10,5,5,0,0,0
2022-03-27 07:30,12,7,5,0,0,0
2022-03-27 07:45,15,8,7,0,0,0
2022-03-27 08:00,9,5,4,0,0,0
2022-03-27 08:15,19,13,6,0,0,0
2022-03-27 08:30,16,9,7,0,0,0
2022-03-27 08:45,30,23,7,0,0,0
2022-03-27 09:00,20,12,8,0,0,0
2022-03-27 09:15,28,16,12,0,0,0
2022-03-27 09:30,50,38,12,0,0,0
2022-03-27 09:45,68,56,12,0,0,0
2022-03-27 10:00,56,24,32,0,0,0
2022-03-27 10:15,65,47,18,0,0,0
2022-03-27 10:30,61,35,26,0,0,0
2022-03-27 10:45,92,68,24,0,0,0
2022-03-27 11:00,83,57,26,0,0,0
2022-03-27 11:15,84,53,31,0,0,0
2022-03-27 11:30,101,46,55,0,0,0
2022-03-27 11:45,124,66,58,0,0,0
2022-03-27 12:00,107,47,60,0,0,0
2022-03-27 12:15,116,70,46,0,0,0
2022-03-27 12:30,109,57,52,0,0,0
2022-03-27 12:45,141,68,73,0,0,0
2022-03-27 13:00,122,61,61,0,0,0
2022-03-27 13:15,165,78,87,0,0,0
2022-03-27 13:30,146,63,83,0,0,0
2022-03-27 13:45,187,99,88,0,0,0
2022-03-27 14:00,195,96,99,0,0,0
2022-03-27 14:15,153,94,59,0,0,0
2022-03-27 14:30,218,132,86,0,0,0
2022-03-27 14:45,176,108,68,0,0,0
2022-03-27 15:00,174,100,74,0,0,0
2022-03-27 15:15,194,116,78,0,0,0
2022-03-27 15:30,186,103,83,0,0,0
2022-03-27 15:45,188,118,70,0,0,0
2022-03-27 16:00,180,98,82,0,0,0
2022-03-27 16:15,157,76,81,0,0,0
2022-03-27 16:30,174,84,90,0,0,0
2022-03-27 16:45,198,110,88,0,0,0
2022-03-27 17:00,161,85,76,0,0,0
2022-03-27 17:15,223,132,91,0,0,0
2022-03-27 17:30,172,92,80,0,0,0
2022-03-27 17:45,217,90,127,0,0,0
2022-03-27 18:00,169,91,78,0,0,0
2022-03-27 18:15,176,83,93,0,0,0
2022-03-27 18:30,161,79,82,0,0,0
2022-03-27 18:45,184,81,103,0,0,0
2022-03-27 19:00,141,67,74,0,0,0
2022-03-27 19:15,148,68,80,0,0,0
2022-03-27 19:30,109,52,57,0,0,0
2022-03-27 19:45,146,62,84,0,0,0
2022-03-27 20:00,124,48,76,0,0,0
2022-03-27 20:15,129,49,80,0,0,0
2022-03-27 20:30,89,26,63,0,0,0
2022-03-27 20:45,89,27,62,0,0,0
2022-03-27 21:00,62,20,42,0,0,0
2022-03-27 21:15,95,24,71,0,0,0
2022-03-27 21:30,73,21,52,0,0,0
2022-03-27 21:45,53,17,36,0,0,0
2022-03-27 22:00,72,18,54,0,0,0
2022-03-27 22:15,54,14,40,0,0,0
2022-03-27 22:30,31,8,23,0,0,0
2022-03-27 22:45,43,8,35,0,0,0
2022-03-27 23:00,38,11,27,0,0,0
2022-03-27 23:15,23,7,16,0,0,0
2022-03-27 23:30,14,8,6,0,0,0
2022-03-27 23:45,12,4,8,0,0,0
2022-03-28 00:00,12,5,7,0,0,0
2022-03-28 00:15,7,5,2,0,0,0
2022-03-28 00:30,6,1,5,0,0,0
2022-03-28 00:45,2,0,2,0,0,0
2022-03-28 01:00,9,0,9,0,0,0
2022-03-28 01:15,9,5,4,0,0,0
2022-03-28 01:30,7,2,5,0,0,0
2022-03-28 01:45,7,2,5,0,0,0
2022-03-28 02:00,2,1,1,0,0,0
2022-03-28 02:15,2,1,1,0,0,0
2022-03-28 02:30,1,0,1,0,0,0
2022-03-28 02:45,2,2,0,0,0,0
2022-03-28 03:00,1,0,1,0,0,0
2022-03-28 03:15,0,0,0,0,0,0
2022-03-28 03:30,1,0,1,0,0,0
2022-03-28 03:45,0,0,0,0,0,0
2022-03-28 04:00,2,1,1,0,0,0
2022-03-28 04:15,5,2,3,0,0,0
2022-03-28 04:30,3,2,1,0,0,0
2022-03-28 04:45,8,6,2,0,0,0
2022-03-28 05:00,11,7,4,0,0,0
2022-03-28 05:15,11,5,6,0,0,0
2022-03-28 05:30,24,20,4,0,0,0
2022-03-28 05:45,19,12,7,0,0,0
2022-03-28 06:00,36,21,15,0,0,0
2022-03-28 06:15,29,15,14,0,0,0
2022-03-28 06:30,47,29,18,0,0,0
2022-03-28 06:45,77,50,27,0,0,0
2022-03-28 07:00,109,74,35,0,0,0
2022-03-28 07:15,154,102,52,0,0,0
2022-03-28 07:30,276,217,59,0,0,0
2022-03-28 07:45,271,163,108,0,0,0
2022-03-28 08:00,186,110,76,0,0,0
2022-03-28 08:15,190,125,65,0,0,0
2022-03-28 08:30,174,102,72,0,0,0
2022-03-28 08:45,254,149,105,0,0,0
2022-03-28 09:00,165,84,81,0,0,0
2022-03-28 09:15,142,94,48,0,0,0
2022-03-28 09:30,142,83,59,0,0,0
2022-03-28 09:45,139,79,60,0,0,0
2022-03-28 10:00,98,56,42,0,0,0
2022-03-28 10:15,106,57,49,0,0,0
2022-03-28 10:30,103,63,40,0,0,0
2022-03-28 10:45,127,70,57,0,0,0
2022-03-28 11:00,116,62,54,0,0,0
2022-03-28 11:15,119,64,55,0,0,0
2022-03-28 11:30,104,62,42,0,0,0
2022-03-28 11:45,143,81,62,0,0,0
2022-03-28 12:00,140,64,76,0,0,0
2022-03-28 12:15,142,73,69,0,0,0
2022-03-28 12:30,147,62,85,0,0,0
2022-03-28 12:45,135,81,54,0,0,0
2022-03-28 13:00,174,66,108,0,0,0
2022-03-28 13:15,176,99,77,0,0,0
2022-03-28 13:30,148,65,83,0,0,0
2022-03-28 13:45,210,103,107,0,0,0
2022-03-28 14:00,172,86,86,0,0,0
2022-03-28 14:15,127,67,60,0,0,0
2022-03-28 14:30,179,77,102,0,0,0
2022-03-28 14:45,216,104,112,0,0,0
2022-03-28 15:00,195,77,118,0,0,0
2022-03-28 15:15,170,85,85,0,0,0
2022-03-28 15:30,256,98,158,0,0,0
2022-03-28 15:45,232,112,120,0,0,0
2022-03-28 16:00,226,97,129,0,0,0
2022-03-28 16:15,250,123,127,0,0,0
2022-03-28 16:30,238,124,114,0,0,0
2022-03-28 16:45,230,113,117,0,0,0
2022-03-28 17:00,248,123,125,0,0,0
2022-03-28 17:15,269,127,142,0,0,0
2022-03-28 17:30,254,111,143,0,0,0
2022-03-28 17:45,283,145,138,0,0,0
2022-03-28 18:00,235,97,138,0,0,0
2022-03-28 18:15,205,96,109,0,0,0
2022-03-28 18:30,196,108,88,0,0,0
2022-03-28 18:45,221,107,114,0,0,0
2022-03-28 19:00,203,87,116,0,0,0
2022-03-28 19:15,181,90,91,0,0,0
2022-03-28 19:30,156,64,92,0,0,0
2022-03-28 19:45,154,67,87,0,0,0
2022-03-28 20:00,183,73,110,0,0,0
2022-03-28 20:15,109,37,72,0,0,0
2022-03-28 20:30,91,32,59,0,0,0
2022-03-28 20:45,78,34,44,0,0,0
2022-03-28 21:00,81,39,42,0,0,0
2022-03-28 21:15,89,32,57,0,0,0
2022-03-28 21:30,71,25,46,0,0,0
2022-03-28 21:45,68,20,48,0,0,0
2022-03-28 22:00,72,22,50,0,0,0
2022-03-28 22:15,46,17,29,0,0,0
2022-03-28 22:30,45,20,25,0,0,0
2022-03-28 22:45,57,20,37,0,0,0
2022-03-28 23:00,51,13,38,0,0,0
2022-03-28 23:15,46,7,39,0,0,0
2022-03-28 23:30,24,15,9,0,0,0
2022-03-28 23:45,26,6,20,0,0,0
2022-03-29 00:00,22,8,14,0,0,0
2022-03-29 00:15,31,12,19,0,0,0
2022-03-29 00:30,7,1,6,0,0,0
2022-03-29 00:45,15,6,9,0,0,0
2022-03-29 01:00,2,0,2,0,0,0
2022-03-29 01:15,14,4,10,0,0,0
2022-03-29 01:30,10,1,9,0,0,0
2022-03-29 01:45,10,6,4,0,0,0
2022-03-29 02:00,10,3,7,0,0,0
2022-03-29 02:15,12,2,10,0,0,0
2022-03-29 02:30,7,1,6,0,0,0
2022-03-29 02:45,4,1,3,0,0,0
2022-03-29 03:00,3,0,3,0,0,0
2022-03-29 03:15,5,0,5,0,0,0
2022-03-29 03:30,7,4,3,0,0,0
2022-03-29 03:45,8,1,7,0,0,0
2022-03-29 04:00,5,3,2,0,0,0
2022-03-29 04:15,7,1,6,0,0,0
2022-03-29 04:30,9,2,7,0,0,0
2022-03-29 04:45,6,4,2,0,0,0
2022-03-29 05:00,7,5,2,0,0,0
2022-03-29 05:15,14,8,6,0,0,0
2022-03-29 05:30,30,20,10,0,0,0
2022-03-29 05:45,21,18,3,0,0,0
2022-03-29 06:00,33,20,13,0,0,0
2022-03-29 06:15,38,26,12,0,0,0
2022-03-29 06:30,49,29,20,0,0,0
2022-03-29 06:45,84,52,32,0,0,0
2022-03-29 07:00,103,69,34,0,0,0
2022-03-29 07:15,161,104,57,0,0,0
2022-03-29 07:30,243,178,65,0,0,0
2022-03-29 07:45,285,177,108,0,0,0
2022-03-29 08:00,231,145,86,0,0,0
2022-03-29 08:15,196,116,80,0,0,0
2022-03-29 08:30,186,114,72,0,0,0
2022-03-29 08:45,246,147,99,0,0,0
2022-03-29 09:00,163,86,77,0,0,0
2022-03-29 09:15,134,91,43,0,0,0
2022-03-29 09:30,137,93,44,0,0,0
2022-03-29 09:45,171,99,72,0,0,0
2022-03-29 10:00,107,67,40,0,0,0
2022-03-29 10:15,85,50,35,0,0,0
2022-03-29 10:30,96,62,34,0,0,0
2022-03-29 10:45,111,65,46,0,0,0
2022-03-29 11:00,94,55,39,0,0,0
2022-03-29 11:15,118,46,72,0,0,0
2022-03-29 11:30,140,69,71,0,0,0
2022-03-29 11:45,142,89,53,0,0,0
2022-03-29 12:00,141,81,60,0,0,0
2022-03-29 12:15,148,97,51,0,0,0
2022-03-29 12:30,157,74,83,0,0,0
2022-03-29 12:45,167,86,81,0,0,0
2022-03-29 13:00,223,96,127,0,0,0
2022-03-29 13:15,171,73,98,0,0,0
2022-03-29 13:30,167,88,79,0,0,0
2022-03-29 13:45,196,102,94,0,0,0
2022-03-29 14:00,168,76,92,0,0,0
2022-03-29 14:15,158,85,73,0,0,0
2022-03-29 14:30,160,71,89,0,0,0
2022-03-29 14:45,189,88,101,0,0,0
2022-03-29 15:00,180,72,108,0,0,0
2022-03-29 15:15,165,70,95,0,0,0
2022-03-29 15:30,168,88,80,0,0,0
2022-03-29 15:45,214,123,91,0,0,0
2022-03-29 16:00,228,109,119,0,0,0
2022-03-29 16:15,203,85,118,0,0,0
2022-03-29 16:30,247,111,136,0,0,0
2022-03-29 16:45,236,132,104,0,0,0
2022-03-29 17:00,240,114,126,0,0,0
2022-03-29 17:15,268,123,145,0,0,0
2022-03-29 17:30,241,121,120,0,0,0
2022-03-29 17:45,260,116,144,0,0,0
2022-03-29 18:00,226,108,118,0,0,0
2022-03-29 18:15,241,93,148,0,0,0
2022-03-29 18:30,215,88,127,0,0,0
2022-03-29 18:45,211,95,116,0,0,0
2022-03-29 19:00,130,65,65,0,0,0
2022-03-29 19:15,180,76,104,0,0,0
2022-03-29 19:30,187,81,106,0,0,0
2022-03-29 19:45,174,79,95,0,0,0
2022-03-29 20:00,137,63,74,0,0,0
2022-03-29 20:15,125,64,61,0,0,0
2022-03-29 20:30,85,37,48,0,0,0
2022-03-29 20:45,91,42,49,0,0,0
2022-03-29 21:00,84,27,57,0,0,0
2022-03-29 21:15,106,53,53,0,0,0
2022-03-29 21:30,69,31,38,0,0,0
2022-03-29 21:45,95,19,76,0,0,0
2022-03-29 22:00,79,17,62,0,0,0
2022-03-29 22:15,78,39,39,0,0,0
2022-03-29 22:30,83,25,58,0,0,0
2022-03-29 22:45,71,26,45,0,0,0
2022-03-29 23:00,46,18,28,0,0,0
2022-03-29 23:15,47,18,29,0,0,0
2022-03-29 23:30,30,8,22,0,0,0
2022-03-29 23:45,41,7,34,0,0,0
2022-03-30 00:00,23,10,13,0,0,0
2022-03-30 00:15,22,9,13,0,0,0
2022-03-30 00:30,23,11,12,0,0,0
2022-03-30 00:45,13,3,10,0,0,0
2022-03-30 01:00,16,6,10,0,0,0
2022-03-30 01:15,11,3,8,0,0,0
2022-03-30 01:30,24,5,19,0,0,0
2022-03-30 01:45,11,2,9,0,0,0
2022-03-30 02:00,8,5,3,0,0,0
2022-03-30 02:15,2,0,2,0,0,0
2022-03-30 02:30,2,1,1,0,0,0
2022-03-30 02:45,3,0,3,0,0,0
2022-03-30 03:00,2,1,1,0,0,0
2022-03-30 03:15,1,1,0,0,0,0
2022-03-30 03:30,3,3,0,0,0,0
2022-03-30 03:45,3,0,3,0,0,0
2022-03-30 04:00,4,0,4,0,0,0
2022-03-30 04:15,5,2,3,0,0,0
2022-03-30 04:30,7,5,2,0,0,0
2022-03-30 04:45,8,6,2,0,0,0
2022-03-30 05:00,7,5,2,0,0,0
2022-03-30 05:15,7,5,2,0,0,0
2022-03-30 05:30,19,15,4,0,0,0
2022-03-30 05:45,23,17,6,0,0,0
2022-03-30 06:00,25,14,11,0,0,0
2022-03-30 06:15,33,25,8,0,0,0
2022-03-30 06:30,58,36,22,0,0,0
2022-03-30 06:45,83,61,22,0,0,0
2022-03-30 07:00,101,63,38,0,0,0
2022-03-30 07:15,159,110,49,0,0,0
2022-03-30 07:30,284,208,76,0,0,0
2022-03-30 07:45,269,181,88,0,0,0
2022-03-30 08:00,196,126,70,0,0,0
2022-03-30 08:15,198,120,78,0,0,0
2022-03-30 08:30,192,108,84,0,0,0
2022-03-30 08:45,224,140,84,0,0,0
2022-03-30 09:00,155,85,70,0,0,0
2022-03-30 09:15,160,92,68,0,0,0
2022-03-30 09:30,153,99,54,0,0,0
2022-03-30 09:45,171,108,63,0,0,0
2022-03-30 10:00,136,89,47,0,0,0
2022-03-30 10:15,124,86,38,0,0,0
2022-03-30 10:30,121,80,41,0,0,0
2022-03-30 10:45,157,98,59,0,0,0
2022-03-30 11:00,127,70,57,0,0,0
2022-03-30 11:15,145,80,65,0,0,0
2022-03-30 11:30,153,86,67,0,0,0
2022-03-30 11:45,175,101,74,0,0,0
2022-03-30 12:00,158,94,64,0,0,0
2022-03-30 12:15,188,101,87,0,0,0
2022-03-30 12:30,195,94,101,0,0,0
2022-03-30 12:45,204,108,96,0,0,0
2022-03-30 13:00,198,88,110,0,0,0
2022-03-30 13:15,172,66,106,0,0,0
2022-03-30 13:30,167,75,92,0,0,0
2022-03-30 13:45,182,85,97,0,0,0
2022-03-30 14:00,205,68,137,0,0,0
2022-03-30 14:15,188,80,108,0,0,0
2022-03-30 14:30,191,80,111,0,0,0
2022-03-30 14:45,215,102,113,0,0,0
2022-03-30 15:00,194,83,111,0,0,0
2022-03-30 15:15,173,82,91,0,0,0
2022-03-30 15:30,186,73,113,0,0,0
2022-03-30 15:45,220,97,123,0,0,0
2022-03-30 16:00,215,95,120,0,0,0
2022-03-30 16:15,225,96,129,0,0,0
2022-03-30 16:30,213,92,121,0,0,0
2022-03-30 16:45,216,92,124,0,0,0
2022-03-30 17:00,228,96,132,0,0,0
2022-03-30 17:15,214,109,105,0,0,0
2022-03-30 17:30,254,116,138,0,0,0
2022-03-30 17:45,236,99,137,0,0,0
2022-03-30 18:00,219,99,120,0,0,0
2022-03-30 18:15,223,105,118,0,0,0
2022-03-30 18:30,202,98,104,0,0,0
2022-03-30 18:45,205,116,89,0,0,0
2022-03-30 19:00,166,76,90,0,0,0
2022-03-30 19:15,163,86,77,0,0,0
2022-03-30 19:30,177,85,92,0,0,0
2022-03-30 19:45,177,97,80,0,0,0
2022-03-30 20:00,162,77,85,0,0,0
2022-03-30 20:15,133,69,64,0,0,0
2022-03-30 20:30,112,55,57,0,0,0
2022-03-30 20:45,111,63,48,0,0,0
2022-03-30 21:00,84,45,39,0,0,0
2022-03-30 21:15,70,26,44,0,0,0
2022-03-30 21:30,77,37,40,0,0,0
2022-03-30 21:45,91,38,53,0,0,0
2022-03-30 22:00,84,34,50,0,0,0
2022-03-30 22:15,82,33,49,0,0,0
2022-03-30 22:30,72,24,48,0,0,0
2022-03-30 22:45,59,20,39,0,0,0
2022-03-30 23:00,59,14,45,0,0,0
2022-03-30 23:15,53,21,32,0,0,0
2022-03-30 23:30,66,40,26,0,0,0
2022-03-30 23:45,42,9,33,0,0,0
