Datetime,100035541 (Neutor),101035541 (Neutor stadteinwÃ¤rts),102035541 (Neutor stadtauswÃ¤rts),100035541-status,101035541-status,102035541-status
2022-07-01 00:00,27,9,18,0,0,0
2022-07-01 00:15,21,8,13,0,0,0
2022-07-01 00:30,18,7,11,0,0,0
2022-07-01 00:45,35,14,21,0,0,0
2022-07-01 01:00,21,10,11,0,0,0
2022-07-01 01:15,15,6,9,0,0,0
2022-07-01 01:30,27,7,20,0,0,0
2022-07-01 01:45,11,3,8,0,0,0
2022-07-01 02:00,15,3,12,0,0,0
2022-07-01 02:15,14,4,10,0,0,0
2022-07-01 02:30,4,2,2,0,0,0
2022-07-01 02:45,8,1,7,0,0,0
2022-07-01 03:00,9,1,8,0,0,0
2022-07-01 03:15,5,0,5,0,0,0
2022-07-01 03:30,7,1,6,0,0,0
2022-07-01 03:45,10,2,8,0,0,0
2022-07-01 04:00,7,1,6,0,0,0
2022-07-01 04:15,5,2,3,0,0,0
2022-07-01 04:30,7,5,2,0,0,0
2022-07-01 04:45,8,4,4,0,0,0
2022-07-01 05:00,5,5,0,0,0,0
2022-07-01 05:15,8,5,3,0,0,0
2022-07-01 05:30,19,13,6,0,0,0
2022-07-01 05:45,16,9,7,0,0,0
2022-07-01 06:00,28,20,8,0,0,0
2022-07-01 06:15,28,19,9,0,0,0
2022-07-01 06:30,36,22,14,0,0,0
2022-07-01 06:45,69,49,20,0,0,0
2022-07-01 07:00,73,45,28,0,0,0
2022-07-01 07:15,90,54,36,0,0,0
2022-07-01 07:30,117,61,56,0,0,0
2022-07-01 07:45,214,109,105,0,0,0
2022-07-01 08:00,271,155,116,0,0,0
2022-07-01 08:15,184,114,70,0,0,0
2022-07-01 08:30,188,111,77,0,0,0
2022-07-01 08:45,202,109,93,0,0,0
2022-07-01 09:00,169,97,72,0,0,0
2022-07-01 09:15,155,82,73,0,0,0
2022-07-01 09:30,167,100,67,0,0,0
2022-07-01 09:45,219,118,101,0,0,0
2022-07-01 10:00,247,136,111,0,0,0
2022-07-01 10:15,121,61,60,0,0,0
2022-07-01 10:30,117,68,49,0,0,0
2022-07-01 10:45,144,78,66,0,0,0
2022-07-01 11:00,137,70,67,0,0,0
2022-07-01 11:15,134,59,75,0,0,0
2022-07-01 11:30,162,68,94,0,0,0
2022-07-01 11:45,196,109,87,0,0,0
2022-07-01 12:00,226,115,111,0,0,0
2022-07-01 12:15,162,91,71,0,0,0
2022-07-01 12:30,190,101,89,0,0,0
2022-07-01 12:45,220,119,101,0,0,0
2022-07-01 13:00,185,92,93,0,0,0
2022-07-01 13:15,202,104,98,0,0,0
2022-07-01 13:30,192,111,81,0,0,0
2022-07-01 13:45,307,180,127,0,0,0
2022-07-01 14:00,225,121,104,0,0,0
2022-07-01 14:15,196,95,101,0,0,0
2022-07-01 14:30,190,99,91,0,0,0
2022-07-01 14:45,208,100,108,0,0,0
2022-07-01 15:00,173,89,84,0,0,0
2022-07-01 15:15,181,88,93,0,0,0
2022-07-01 15:30,200,91,109,0,0,0
2022-07-01 15:45,234,104,130,0,0,0
2022-07-01 16:00,231,109,122,0,0,0
2022-07-01 16:15,213,102,111,0,0,0
2022-07-01 16:30,226,122,104,0,0,0
2022-07-01 16:45,208,110,98,0,0,0
2022-07-01 17:00,224,105,119,0,0,0
2022-07-01 17:15,212,118,94,0,0,0
2022-07-01 17:30,239,114,125,0,0,0
2022-07-01 17:45,240,110,130,0,0,0
2022-07-01 18:00,236,128,108,0,0,0
2022-07-01 18:15,205,120,85,0,0,0
2022-07-01 18:30,219,121,98,0,0,0
2022-07-01 18:45,205,127,78,0,0,0
2022-07-01 19:00,187,101,86,0,0,0
2022-07-01 19:15,200,116,84,0,0,0
2022-07-01 19:30,191,97,94,0,0,0
2022-07-01 19:45,213,124,89,0,0,0
2022-07-01 20:00,181,82,99,0,0,0
2022-07-01 20:15,148,70,78,0,0,0
2022-07-01 20:30,151,84,67,0,0,0
2022-07-01 20:45,127,61,66,0,0,0
2022-07-01 21:00,128,64,64,0,0,0
2022-07-01 21:15,121,42,79,0,0,0
2022-07-01 21:30,139,55,84,0,0,0
2022-07-01 21:45,117,35,82,0,0,0
2022-07-01 22:00,124,43,81,0,0,0
2022-07-01 22:15,96,32,64,0,0,0
2022-07-01 22:30,100,39,61,0,0,0
2022-07-01 22:45,101,30,71,0,0,0
2022-07-01 23:00,98,35,63,0,0,0
2022-07-01 23:15,117,35,82,0,0,0
2022-07-01 23:30,66,17,49,0,0,0
2022-07-01 23:45,70,35,35,0,0,0
2022-07-02 00:00,87,22,65,0,0,0
2022-07-02 00:15,68,15,53,0,0,0
2022-07-02 00:30,59,20,39,0,0,0
2022-07-02 00:45,76,19,57,0,0,0
2022-07-02 01:00,56,20,36,0,0,0
2022-07-02 01:15,59,17,42,0,0,0
2022-07-02 01:30,57,18,39,0,0,0
2022-07-02 01:45,34,22,12,0,0,0
2022-07-02 02:00,43,13,30,0,0,0
2022-07-02 02:15,49,26,23,0,0,0
2022-07-02 02:30,38,16,22,0,0,0
2022-07-02 02:45,33,14,19,0,0,0
2022-07-02 03:00,36,10,26,0,0,0
2022-07-02 03:15,25,8,17,0,0,0
2022-07-02 03:30,23,9,14,0,0,0
2022-07-02 03:45,25,15,10,0,0,0
2022-07-02 04:00,23,11,12,0,0,0
2022-07-02 04:15,20,8,12,0,0,0
2022-07-02 04:30,20,12,8,0,0,0
2022-07-02 04:45,6,2,4,0,0,0
2022-07-02 05:00,10,7,3,0,0,0
2022-07-02 05:15,16,13,3,0,0,0
2022-07-02 05:30,18,9,9,0,0,0
2022-07-02 05:45,12,11,1,0,0,0
2022-07-02 06:00,13,9,4,0,0,0
2022-07-02 06:15,12,1,11,0,0,0
2022-07-02 06:30,8,4,4,0,0,0
2022-07-02 06:45,20,13,7,0,0,0
2022-07-02 07:00,13,12,1,0,0,0
2022-07-02 07:15,29,18,11,0,0,0
2022-07-02 07:30,37,27,10,0,0,0
2022-07-02 07:45,40,33,7,0,0,0
2022-07-02 08:00,48,39,9,0,0,0
2022-07-02 08:15,56,37,19,0,0,0
2022-07-02 08:30,72,44,28,0,0,0
2022-07-02 08:45,91,49,42,0,0,0
2022-07-02 09:00,75,50,25,0,0,0
2022-07-02 09:15,91,64,27,0,0,0
2022-07-02 09:30,104,98,6,0,0,0
2022-07-02 09:45,170,104,66,0,0,0
2022-07-02 10:00,131,102,29,0,0,0
2022-07-02 10:15,133,81,52,0,0,0
2022-07-02 10:30,115,77,38,0,0,0
2022-07-02 10:45,179,115,64,0,0,0
2022-07-02 11:00,116,72,44,0,0,0
2022-07-02 11:15,136,88,48,0,0,0
2022-07-02 11:30,157,106,51,0,0,0
2022-07-02 11:45,170,91,79,0,0,0
2022-07-02 12:00,170,111,59,0,0,0
2022-07-02 12:15,170,96,74,0,0,0
2022-07-02 12:30,181,110,71,0,0,0
2022-07-02 12:45,176,98,78,0,0,0
2022-07-02 13:00,178,100,78,0,0,0
2022-07-02 13:15,166,103,63,0,0,0
2022-07-02 13:30,191,101,90,0,0,0
2022-07-02 13:45,191,109,82,0,0,0
2022-07-02 14:00,204,106,98,0,0,0
2022-07-02 14:15,187,94,93,0,0,0
2022-07-02 14:30,168,88,80,0,0,0
2022-07-02 14:45,191,103,88,0,0,0
2022-07-02 15:00,164,86,78,0,0,0
2022-07-02 15:15,170,100,70,0,0,0
2022-07-02 15:30,192,85,107,0,0,0
2022-07-02 15:45,161,86,75,0,0,0
2022-07-02 16:00,169,75,94,0,0,0
2022-07-02 16:15,183,74,109,0,0,0
2022-07-02 16:30,169,80,89,0,0,0
2022-07-02 16:45,168,81,87,0,0,0
2022-07-02 17:00,180,88,92,0,0,0
2022-07-02 17:15,169,85,84,0,0,0
2022-07-02 17:30,175,91,84,0,0,0
2022-07-02 17:45,176,92,84,0,0,0
2022-07-02 18:00,202,109,93,0,0,0
2022-07-02 18:15,208,117,91,0,0,0
2022-07-02 18:30,143,65,78,0,0,0
2022-07-02 18:45,171,99,72,0,0,0
2022-07-02 19:00,162,75,87,0,0,0
2022-07-02 19:15,177,104,73,0,0,0
2022-07-02 19:30,154,81,73,0,0,0
2022-07-02 19:45,150,77,73,0,0,0
2022-07-02 20:00,132,70,62,0,0,0
2022-07-02 20:15,148,77,71,0,0,0
2022-07-02 20:30,152,69,83,0,0,0
2022-07-02 20:45,153,75,78,0,0,0
2022-07-02 21:00,144,62,82,0,0,0
2022-07-02 21:15,118,58,60,0,0,0
2022-07-02 21:30,119,60,59,0,0,0
2022-07-02 21:45,105,30,75,0,0,0
2022-07-02 22:00,98,43,55,0,0,0
2022-07-02 22:15,111,37,74,0,0,0
2022-07-02 22:30,71,28,43,0,0,0
2022-07-02 22:45,84,27,57,0,0,0
2022-07-02 23:00,81,19,62,0,0,0
2022-07-02 23:15,92,19,73,0,0,0
2022-07-02 23:30,117,42,75,0,0,0
2022-07-02 23:45,73,23,50,0,0,0
2022-07-03 00:00,75,32,43,0,0,0
2022-07-03 00:15,72,21,51,0,0,0
2022-07-03 00:30,76,28,48,0,0,0
2022-07-03 00:45,48,9,39,0,0,0
2022-07-03 01:00,52,15,37,0,0,0
2022-07-03 01:15,50,23,27,0,0,0
2022-07-03 01:30,47,13,34,0,0,0
2022-07-03 01:45,56,25,31,0,0,0
2022-07-03 02:00,56,17,39,0,0,0
2022-07-03 02:15,41,18,23,0,0,0
2022-07-03 02:30,22,9,13,0,0,0
2022-07-03 02:45,29,14,15,0,0,0
2022-07-03 03:00,30,6,24,0,0,0
2022-07-03 03:15,22,2,20,0,0,0
2022-07-03 03:30,26,5,21,0,0,0
2022-07-03 03:45,29,5,24,0,0,0
2022-07-03 04:00,17,2,15,0,0,0
2022-07-03 04:15,16,3,13,0,0,0
2022-07-03 04:30,9,0,9,0,0,0
2022-07-03 04:45,12,2,10,0,0,0
2022-07-03 05:00,8,3,5,0,0,0
2022-07-03 05:15,13,5,8,0,0,0
2022-07-03 05:30,16,4,12,0,0,0
2022-07-03 05:45,10,8,2,0,0,0
2022-07-03 06:00,6,1,5,0,0,0
2022-07-03 06:15,13,1,12,0,0,0
2022-07-03 06:30,14,8,6,0,0,0
2022-07-03 06:45,10,5,5,0,0,0
2022-07-03 07:00,6,4,2,0,0,0
2022-07-03 07:15,13,4,9,0,0,0
2022-07-03 07:30,16,11,5,0,0,0
2022-07-03 07:45,26,16,10,0,0,0
2022-07-03 08:00,23,16,7,0,0,0
2022-07-03 08:15,29,26,3,0,0,0
2022-07-03 08:30,36,25,11,0,0,0
2022-07-03 08:45,43,24,19,0,0,0
2022-07-03 09:00,70,47,23,0,0,0
2022-07-03 09:15,68,52,16,0,0,0
2022-07-03 09:30,56,39,17,0,0,0
2022-07-03 09:45,78,47,31,0,0,0
2022-07-03 10:00,87,55,32,0,0,0
2022-07-03 10:15,78,56,22,0,0,0
2022-07-03 10:30,69,51,18,0,0,0
2022-07-03 10:45,89,57,32,0,0,0
2022-07-03 11:00,105,58,47,0,0,0
2022-07-03 11:15,95,59,36,0,0,0
2022-07-03 11:30,79,51,28,0,0,0
2022-07-03 11:45,116,72,44,0,0,0
2022-07-03 12:00,94,47,47,0,0,0
2022-07-03 12:15,98,47,51,0,0,0
2022-07-03 12:30,95,38,57,0,0,0
2022-07-03 12:45,116,57,59,0,0,0
2022-07-03 13:00,118,62,56,0,0,0
2022-07-03 13:15,112,62,50,0,0,0
2022-07-03 13:30,97,49,48,0,0,0
2022-07-03 13:45,126,78,48,0,0,0
2022-07-03 14:00,158,82,76,0,0,0
2022-07-03 14:15,135,73,62,0,0,0
2022-07-03 14:30,147,69,78,0,0,0
2022-07-03 14:45,134,89,45,0,0,0
2022-07-03 15:00,138,75,63,0,0,0
2022-07-03 15:15,134,70,64,0,0,0
2022-07-03 15:30,161,87,74,0,0,0
2022-07-03 15:45,137,70,67,0,0,0
2022-07-03 16:00,115,54,61,0,0,0
2022-07-03 16:15,111,59,52,0,0,0
2022-07-03 16:30,114,57,57,0,0,0
2022-07-03 16:45,147,86,61,0,0,0
2022-07-03 17:00,119,56,63,0,0,0
2022-07-03 17:15,139,78,61,0,0,0
2022-07-03 17:30,136,70,66,0,0,0
2022-07-03 17:45,183,99,84,0,0,0
2022-07-03 18:00,170,99,71,0,0,0
2022-07-03 18:15,160,96,64,0,0,0
2022-07-03 18:30,156,83,73,0,0,0
2022-07-03 18:45,180,94,86,0,0,0
2022-07-03 19:00,148,67,81,0,0,0
2022-07-03 19:15,132,70,62,0,0,0
2022-07-03 19:30,144,69,75,0,0,0
2022-07-03 19:45,171,63,108,0,0,0
2022-07-03 20:00,156,75,81,0,0,0
2022-07-03 20:15,108,44,64,0,0,0
2022-07-03 20:30,131,48,83,0,0,0
2022-07-03 20:45,94,35,59,0,0,0
2022-07-03 21:00,87,27,60,0,0,0
2022-07-03 21:15,78,27,51,0,0,0
2022-07-03 21:30,77,29,48,0,0,0
2022-07-03 21:45,67,14,53,0,0,0
2022-07-03 22:00,78,16,62,0,0,0
2022-07-03 22:15,72,27,45,0,0,0
2022-07-03 22:30,64,25,39,0,0,0
2022-07-03 22:45,53,10,43,0,0,0
2022-07-03 23:00,34,11,23,0,0,0
2022-07-03 23:15,37,8,29,0,0,0
2022-07-03 23:30,24,11,13,0,0,0
2022-07-03 23:45,26,5,21,0,0,0
2022-07-04 00:00,13,5,8,0,0,0
2022-07-04 00:15,15,4,11,0,0,0
2022-07-04 00:30,11,0,11,0,0,0
2022-07-04 00:45,11,3,8,0,0,0
2022-07-04 01:00,4,1,3,0,0,0
2022-07-04 01:15,8,2,6,0,0,0
2022-07-04 01:30,5,3,2,0,0,0
2022-07-04 01:45,4,1,3,0,0,0
2022-07-04 02:00,8,4,4,0,0,0
2022-07-04 02:15,7,4,3,0,0,0
2022-07-04 02:30,2,1,1,0,0,0
2022-07-04 02:45,2,1,1,0,0,0
2022-07-04 03:00,3,2,1,0,0,0
2022-07-04 03:15,0,0,0,0,0,0
2022-07-04 03:30,1,0,1,0,0,0
2022-07-04 03:45,4,4,0,0,0,0
2022-07-04 04:00,2,1,1,0,0,0
2022-07-04 04:15,10,6,4,0,0,0
2022-07-04 04:30,4,2,2,0,0,0
2022-07-04 04:45,4,2,2,0,0,0
2022-07-04 05:00,4,4,0,0,0,0
2022-07-04 05:15,10,9,1,0,0,0
2022-07-04 05:30,18,11,7,0,0,0
2022-07-04 05:45,23,15,8,0,0,0
2022-07-04 06:00,38,27,11,0,0,0
2022-07-04 06:15,34,26,8,0,0,0
2022-07-04 06:30,91,50,41,0,0,0
2022-07-04 06:45,94,63,31,0,0,0
2022-07-04 07:00,93,53,40,0,0,0
2022-07-04 07:15,118,66,52,0,0,0
2022-07-04 07:30,155,87,68,0,0,0
2022-07-04 07:45,219,128,91,0,0,0
2022-07-04 08:00,275,153,122,0,0,0
2022-07-04 08:15,210,103,107,0,0,0
2022-07-04 08:30,221,121,100,0,0,0
2022-07-04 08:45,233,119,114,0,0,0
2022-07-04 09:00,185,105,80,0,0,0
2022-07-04 09:15,157,102,55,0,0,0
2022-07-04 09:30,188,115,73,0,0,0
2022-07-04 09:45,278,164,114,0,0,0
2022-07-04 10:00,310,201,109,0,0,0
2022-07-04 10:15,151,77,74,0,0,0
2022-07-04 10:30,170,87,83,0,0,0
2022-07-04 10:45,145,86,59,0,0,0
2022-07-04 11:00,154,61,93,0,0,0
2022-07-04 11:15,143,70,73,0,0,0
2022-07-04 11:30,173,92,81,0,0,0
2022-07-04 11:45,301,156,145,0,0,0
2022-07-04 12:00,294,159,135,0,0,0
2022-07-04 12:15,195,113,82,0,0,0
2022-07-04 12:30,196,93,103,0,0,0
2022-07-04 12:45,234,122,112,0,0,0
2022-07-04 13:00,214,112,102,0,0,0
2022-07-04 13:15,200,112,88,0,0,0
2022-07-04 13:30,229,116,113,0,0,0
2022-07-04 13:45,344,164,180,0,0,0
2022-07-04 14:00,325,203,122,0,0,0
2022-07-04 14:15,187,97,90,0,0,0
2022-07-04 14:30,188,93,95,0,0,0
2022-07-04 14:45,222,101,121,0,0,0
2022-07-04 15:00,189,84,105,0,0,0
2022-07-04 15:15,173,91,82,0,0,0
2022-07-04 15:30,243,108,135,0,0,0
2022-07-04 15:45,376,202,174,0,0,0
2022-07-04 16:00,360,182,178,0,0,0
2022-07-04 16:15,280,151,129,0,0,0
2022-07-04 16:30,234,89,145,0,0,0
2022-07-04 16:45,315,152,163,0,0,0
2022-07-04 17:00,287,125,162,0,0,0
2022-07-04 17:15,315,145,170,0,0,0
2022-07-04 17:30,345,146,199,0,0,0
2022-07-04 17:45,450,200,250,0,0,0
2022-07-04 18:00,395,197,198,0,0,0
2022-07-04 18:15,316,132,184,0,0,0
2022-07-04 18:30,262,128,134,0,0,0
2022-07-04 18:45,242,123,119,0,0,0
2022-07-04 19:00,255,119,136,0,0,0
2022-07-04 19:15,193,84,109,0,0,0
2022-07-04 19:30,227,97,130,0,0,0
2022-07-04 19:45,269,113,156,0,0,0
2022-07-04 20:00,230,114,116,0,0,0
2022-07-04 20:15,191,107,84,0,0,0
2022-07-04 20:30,156,79,77,0,0,0
2022-07-04 20:45,121,56,65,0,0,0
2022-07-04 21:00,156,87,69,0,0,0
2022-07-04 21:15,129,56,73,0,0,0
2022-07-04 21:30,131,68,63,0,0,0
2022-07-04 21:45,158,99,59,0,0,0
2022-07-04 22:00,124,68,56,0,0,0
2022-07-04 22:15,115,58,57,0,0,0
2022-07-04 22:30,106,61,45,0,0,0
2022-07-04 22:45,82,30,52,0,0,0
2022-07-04 23:00,80,35,45,0,0,0
2022-07-04 23:15,87,53,34,0,0,0
2022-07-04 23:30,66,34,32,0,0,0
2022-07-04 23:45,29,13,16,0,0,0
2022-07-05 00:00,27,11,16,0,0,0
2022-07-05 00:15,22,6,16,0,0,0
2022-07-05 00:30,23,4,19,0,0,0
2022-07-05 00:45,15,4,11,0,0,0
2022-07-05 01:00,17,6,11,0,0,0
2022-07-05 01:15,16,1,15,0,0,0
2022-07-05 01:30,22,2,20,0,0,0
2022-07-05 01:45,12,2,10,0,0,0
2022-07-05 02:00,9,2,7,0,0,0
2022-07-05 02:15,2,1,1,0,0,0
2022-07-05 02:30,2,1,1,0,0,0
2022-07-05 02:45,2,1,1,0,0,0
2022-07-05 03:00,2,1,1,0,0,0
2022-07-05 03:15,1,1,0,0,0,0
2022-07-05 03:30,5,1,4,0,0,0
2022-07-05 03:45,3,2,1,0,0,0
2022-07-05 04:00,0,0,0,0,0,0
2022-07-05 04:15,5,2,3,0,0,0
2022-07-05 04:30,8,2,6,0,0,0
2022-07-05 04:45,7,4,3,0,0,0
2022-07-05 05:00,8,6,2,0,0,0
2022-07-05 05:15,7,7,0,0,0,0
2022-07-05 05:30,22,11,11,0,0,0
2022-07-05 05:45,28,21,7,0,0,0
2022-07-05 06:00,40,27,13,0,0,0
2022-07-05 06:15,50,33,17,0,0,0
2022-07-05 06:30,73,46,27,0,0,0
2022-07-05 06:45,109,66,43,0,0,0
2022-07-05 07:00,88,60,28,0,0,0
2022-07-05 07:15,140,82,58,0,0,0
2022-07-05 07:30,189,104,85,0,0,0
2022-07-05 07:45,281,155,126,0,0,0
2022-07-05 08:00,389,250,139,0,0,0
2022-07-05 08:15,245,142,103,0,0,0
2022-07-05 08:30,222,127,95,0,0,0
2022-07-05 08:45,247,133,114,0,0,0
2022-07-05 09:00,211,118,93,0,0,0
2022-07-05 09:15,163,103,60,0,0,0
2022-07-05 09:30,177,99,78,0,0,0
2022-07-05 09:45,365,184,181,0,0,0
2022-07-05 10:00,362,211,151,0,0,0
2022-07-05 10:15,167,93,74,0,0,0
2022-07-05 10:30,140,77,63,0,0,0
2022-07-05 10:45,146,71,75,0,0,0
2022-07-05 11:00,147,75,72,0,0,0
2022-07-05 11:15,168,88,80,0,0,0
2022-07-05 11:30,174,91,83,0,0,0
2022-07-05 11:45,312,159,153,0,0,0
2022-07-05 12:00,373,231,142,0,0,0
2022-07-05 12:15,173,95,78,0,0,0
2022-07-05 12:30,186,87,99,0,0,0
2022-07-05 12:45,226,121,105,0,0,0
2022-07-05 13:00,205,111,94,0,0,0
2022-07-05 13:15,209,106,103,0,0,0
2022-07-05 13:30,251,132,119,0,0,0
2022-07-05 13:45,365,168,197,0,0,0
2022-07-05 14:00,353,188,165,0,0,0
2022-07-05 14:15,229,117,112,0,0,0
2022-07-05 14:30,195,106,89,0,0,0
2022-07-05 14:45,215,109,106,0,0,0
2022-07-05 15:00,216,101,115,0,0,0
2022-07-05 15:15,218,93,125,0,0,0
2022-07-05 15:30,218,107,111,0,0,0
2022-07-05 15:45,412,204,208,0,0,0
2022-07-05 16:00,370,165,205,0,0,0
2022-07-05 16:15,302,143,159,0,0,0
2022-07-05 16:30,242,117,125,0,0,0
2022-07-05 16:45,292,138,154,0,0,0
2022-07-05 17:00,290,151,139,0,0,0
2022-07-05 17:15,299,134,165,0,0,0
2022-07-05 17:30,289,145,144,0,0,0
2022-07-05 17:45,417,191,226,0,0,0
2022-07-05 18:00,374,204,170,0,0,0
2022-07-05 18:15,299,140,159,0,0,0
2022-07-05 18:30,264,129,135,0,0,0
2022-07-05 18:45,270,128,142,0,0,0
2022-07-05 19:00,236,116,120,0,0,0
2022-07-05 19:15,238,106,132,0,0,0
2022-07-05 19:30,242,100,142,0,0,0
2022-07-05 19:45,241,102,139,0,0,0
2022-07-05 20:00,203,102,101,0,0,0
2022-07-05 20:15,161,76,85,0,0,0
2022-07-05 20:30,169,75,94,0,0,0
2022-07-05 20:45,137,48,89,0,0,0
2022-07-05 21:00,146,64,82,0,0,0
2022-07-05 21:15,131,53,78,0,0,0
2022-07-05 21:30,158,60,98,0,0,0
2022-07-05 21:45,148,50,98,0,0,0
2022-07-05 22:00,112,52,60,0,0,0
2022-07-05 22:15,112,53,59,0,0,0
2022-07-05 22:30,94,40,54,0,0,0
2022-07-05 22:45,90,41,49,0,0,0
2022-07-05 23:00,89,20,69,0,0,0
2022-07-05 23:15,73,31,42,0,0,0
2022-07-05 23:30,76,22,54,0,0,0
2022-07-05 23:45,42,15,27,0,0,0
2022-07-06 00:00,31,7,24,0,0,0
2022-07-06 00:15,34,16,18,0,0,0
2022-07-06 00:30,38,11,27,0,0,0
2022-07-06 00:45,20,15,5,0,0,0
2022-07-06 01:00,31,13,18,0,0,0
2022-07-06 01:15,10,5,5,0,0,0
2022-07-06 01:30,20,8,12,0,0,0
2022-07-06 01:45,16,3,13,0,0,0
2022-07-06 02:00,9,4,5,0,0,0
2022-07-06 02:15,9,6,3,0,0,0
2022-07-06 02:30,4,4,0,0,0,0
2022-07-06 02:45,12,6,6,0,0,0
2022-07-06 03:00,3,1,2,0,0,0
2022-07-06 03:15,3,0,3,0,0,0
2022-07-06 03:30,0,0,0,0,0,0
2022-07-06 03:45,3,2,1,0,0,0
2022-07-06 04:00,0,0,0,0,0,0
2022-07-06 04:15,5,2,3,0,0,0
2022-07-06 04:30,6,2,4,0,0,0
2022-07-06 04:45,4,2,2,0,0,0
2022-07-06 05:00,6,6,0,0,0,0
2022-07-06 05:15,9,7,2,0,0,0
2022-07-06 05:30,22,13,9,0,0,0
2022-07-06 05:45,24,22,2,0,0,0
2022-07-06 06:00,36,24,12,0,0,0
2022-07-06 06:15,47,29,18,0,0,0
2022-07-06 06:30,77,50,27,0,0,0
2022-07-06 06:45,101,58,43,0,0,0
2022-07-06 07:00,98,63,35,0,0,0
2022-07-06 07:15,153,105,48,0,0,0
2022-07-06 07:30,182,109,73,0,0,0
2022-07-06 07:45,278,176,102,0,0,0
2022-07-06 08:00,283,164,119,0,0,0
2022-07-06 08:15,219,126,93,0,0,0
2022-07-06 08:30,191,109,82,0,0,0
2022-07-06 08:45,244,134,110,0,0,0
2022-07-06 09:00,221,122,99,0,0,0
2022-07-06 09:15,155,86,69,0,0,0
2022-07-06 09:30,201,111,90,0,0,0
2022-07-06 09:45,284,168,116,0,0,0
2022-07-06 10:00,328,167,161,0,0,0
2022-07-06 10:15,137,71,66,0,0,0
2022-07-06 10:30,151,74,77,0,0,0
2022-07-06 10:45,179,103,76,0,0,0
2022-07-06 11:00,147,72,75,0,0,0
2022-07-06 11:15,136,69,67,0,0,0
2022-07-06 11:30,203,130,73,0,0,0
2022-07-06 11:45,302,157,145,0,0,0
2022-07-06 12:00,288,129,159,0,0,0
2022-07-06 12:15,205,108,97,0,0,0
2022-07-06 12:30,173,87,86,0,0,0
2022-07-06 12:45,267,122,145,0,0,0
2022-07-06 13:00,225,108,117,0,0,0
2022-07-06 13:15,224,111,113,0,0,0
2022-07-06 13:30,222,112,110,0,0,0
2022-07-06 13:45,315,163,152,0,0,0
2022-07-06 14:00,257,139,118,0,0,0
2022-07-06 14:15,214,110,104,0,0,0
2022-07-06 14:30,198,95,103,0,0,0
2022-07-06 14:45,198,90,108,0,0,0
2022-07-06 15:00,189,83,106,0,0,0
2022-07-06 15:15,183,91,92,0,0,0
2022-07-06 15:30,239,97,142,0,0,0
2022-07-06 15:45,338,154,184,0,0,0
2022-07-06 16:00,331,173,158,0,0,0
2022-07-06 16:15,283,131,152,0,0,0
2022-07-06 16:30,267,137,130,0,0,0
2022-07-06 16:45,273,149,124,0,0,0
2022-07-06 17:00,276,129,147,0,0,0
2022-07-06 17:15,263,134,129,0,0,0
2022-07-06 17:30,298,136,162,0,0,0
2022-07-06 17:45,381,157,224,0,0,0
2022-07-06 18:00,382,179,203,0,0,0
2022-07-06 18:15,331,154,177,0,0,0
2022-07-06 18:30,274,139,135,0,0,0
2022-07-06 18:45,298,147,151,0,0,0
2022-07-06 19:00,240,118,122,0,0,0
2022-07-06 19:15,253,117,136,0,0,0
2022-07-06 19:30,236,124,112,0,0,0
2022-07-06 19:45,243,119,124,0,0,0
2022-07-06 20:00,181,78,103,0,0,0
2022-07-06 20:15,176,69,107,0,0,0
2022-07-06 20:30,169,63,106,0,0,0
2022-07-06 20:45,159,75,84,0,0,0
2022-07-06 21:00,122,55,67,0,0,0
2022-07-06 21:15,117,40,77,0,0,0
2022-07-06 21:30,123,41,82,0,0,0
2022-07-06 21:45,134,54,80,0,0,0
2022-07-06 22:00,132,54,78,0,0,0
2022-07-06 22:15,106,44,62,0,0,0
2022-07-06 22:30,97,32,65,0,0,0
2022-07-06 22:45,77,23,54,0,0,0
2022-07-06 23:00,103,37,66,0,0,0
2022-07-06 23:15,71,17,54,0,0,0
2022-07-06 23:30,74,19,55,0,0,0
2022-07-06 23:45,74,24,50,0,0,0
2022-07-07 00:00,50,22,28,0,0,0
2022-07-07 00:15,53,15,38,0,0,0
2022-07-07 00:30,55,32,23,0,0,0
2022-07-07 00:45,38,6,32,0,0,0
2022-07-07 01:00,20,4,16,0,0,0
2022-07-07 01:15,36,21,15,0,0,0
2022-07-07 01:30,31,9,22,0,0,0
2022-07-07 01:45,22,0,22,0,0,0
2022-07-07 02:00,23,5,18,0,0,0
2022-07-07 02:15,26,4,22,0,0,0
2022-07-07 02:30,7,3,4,0,0,0
2022-07-07 02:45,10,1,9,0,0,0
2022-07-07 03:00,16,0,16,0,0,0
2022-07-07 03:15,5,0,5,0,0,0
2022-07-07 03:30,6,1,5,0,0,0
2022-07-07 03:45,12,3,9,0,0,0
2022-07-07 04:00,2,1,1,0,0,0
2022-07-07 04:15,8,4,4,0,0,0
2022-07-07 04:30,5,2,3,0,0,0
2022-07-07 04:45,6,4,2,0,0,0
2022-07-07 05:00,6,6,0,0,0,0
2022-07-07 05:15,10,7,3,0,0,0
2022-07-07 05:30,27,18,9,0,0,0
2022-07-07 05:45,17,7,10,0,0,0
2022-07-07 06:00,25,17,8,0,0,0
2022-07-07 06:15,36,24,12,0,0,0
2022-07-07 06:30,54,32,22,0,0,0
2022-07-07 06:45,68,40,28,0,0,0
2022-07-07 07:00,63,40,23,0,0,0
2022-07-07 07:15,94,51,43,0,0,0
2022-07-07 07:30,141,77,64,0,0,0
2022-07-07 07:45,212,126,86,0,0,0
2022-07-07 08:00,247,138,109,0,0,0
2022-07-07 08:15,187,116,71,0,0,0
2022-07-07 08:30,147,88,59,0,0,0
2022-07-07 08:45,158,99,59,0,0,0
2022-07-07 09:00,114,77,37,0,0,0
2022-07-07 09:15,137,79,58,0,0,0
2022-07-07 09:30,165,78,87,0,0,0
2022-07-07 09:45,240,146,94,0,0,0
2022-07-07 10:00,290,178,112,0,0,0
2022-07-07 10:15,112,60,52,0,0,0
2022-07-07 10:30,112,64,48,0,0,0
2022-07-07 10:45,128,83,45,0,0,0
2022-07-07 11:00,140,80,60,0,0,0
2022-07-07 11:15,130,57,73,0,0,0
2022-07-07 11:30,140,68,72,0,0,0
2022-07-07 11:45,250,111,139,0,0,0
2022-07-07 12:00,255,142,113,0,0,0
2022-07-07 12:15,153,81,72,0,0,0
2022-07-07 12:30,161,90,71,0,0,0
2022-07-07 12:45,165,84,81,0,0,0
2022-07-07 13:00,169,78,91,0,0,0
2022-07-07 13:15,199,103,96,0,0,0
2022-07-07 13:30,196,94,102,0,0,0
2022-07-07 13:45,280,131,149,0,0,0
2022-07-07 14:00,257,159,98,0,0,0
2022-07-07 14:15,178,99,79,0,0,0
2022-07-07 14:30,176,78,98,0,0,0
2022-07-07 14:45,181,89,92,0,0,0
2022-07-07 15:00,179,70,109,0,0,0
2022-07-07 15:15,172,88,84,0,0,0
2022-07-07 15:30,175,84,91,0,0,0
2022-07-07 15:45,261,132,129,0,0,0
2022-07-07 16:00,267,134,133,0,0,0
2022-07-07 16:15,233,115,118,0,0,0
2022-07-07 16:30,199,95,104,0,0,0
2022-07-07 16:45,227,116,111,0,0,0
2022-07-07 17:00,223,101,122,0,0,0
2022-07-07 17:15,221,118,103,0,0,0
2022-07-07 17:30,226,112,114,0,0,0
2022-07-07 17:45,364,170,194,0,0,0
2022-07-07 18:00,314,151,163,0,0,0
2022-07-07 18:15,216,94,122,0,0,0
2022-07-07 18:30,193,99,94,0,0,0
2022-07-07 18:45,237,108,129,0,0,0
2022-07-07 19:00,201,99,102,0,0,0
2022-07-07 19:15,204,102,102,0,0,0
2022-07-07 19:30,198,99,99,0,0,0
2022-07-07 19:45,186,82,104,0,0,0
2022-07-07 20:00,169,93,76,0,0,0
2022-07-07 20:15,141,65,76,0,0,0
2022-07-07 20:30,108,47,61,0,0,0
2022-07-07 20:45,106,43,63,0,0,0
2022-07-07 21:00,125,50,75,0,0,0
2022-07-07 21:15,90,44,46,0,0,0
2022-07-07 21:30,84,42,42,0,0,0
2022-07-07 21:45,107,39,68,0,0,0
2022-07-07 22:00,108,34,74,0,0,0
2022-07-07 22:15,80,37,43,0,0,0
2022-07-07 22:30,69,32,37,0,0,0
2022-07-07 22:45,86,26,60,0,0,0
2022-07-07 23:00,62,20,42,0,0,0
2022-07-07 23:15,86,32,54,0,0,0
2022-07-07 23:30,62,14,48,0,0,0
2022-07-07 23:45,45,15,30,0,0,0
2022-07-08 00:00,70,18,52,0,0,0
2022-07-08 00:15,43,11,32,0,0,0
2022-07-08 00:30,26,7,19,0,0,0
2022-07-08 00:45,36,3,33,0,0,0
2022-07-08 01:00,37,6,31,0,0,0
2022-07-08 01:15,30,2,28,0,0,0
2022-07-08 01:30,22,2,20,0,0,0
2022-07-08 01:45,18,6,12,0,0,0
2022-07-08 02:00,14,2,12,0,0,0
2022-07-08 02:15,16,0,16,0,0,0
2022-07-08 02:30,12,2,10,0,0,0
2022-07-08 02:45,10,2,8,0,0,0
2022-07-08 03:00,9,3,6,0,0,0
2022-07-08 03:15,3,0,3,0,0,0
2022-07-08 03:30,1,1,0,0,0,0
2022-07-08 03:45,9,4,5,0,0,0
2022-07-08 04:00,6,2,4,0,0,0
2022-07-08 04:15,3,1,2,0,0,0
2022-07-08 04:30,3,3,0,0,0,0
2022-07-08 04:45,6,5,1,0,0,0
2022-07-08 05:00,2,2,0,0,0,0
2022-07-08 05:15,11,8,3,0,0,0
2022-07-08 05:30,17,12,5,0,0,0
2022-07-08 05:45,18,13,5,0,0,0
2022-07-08 06:00,34,21,13,0,0,0
2022-07-08 06:15,29,16,13,0,0,0
2022-07-08 06:30,52,27,25,0,0,0
2022-07-08 06:45,67,40,27,0,0,0
2022-07-08 07:00,82,49,33,0,0,0
2022-07-08 07:15,85,40,45,0,0,0
2022-07-08 07:30,127,59,68,0,0,0
2022-07-08 07:45,187,100,87,0,0,0
2022-07-08 08:00,230,132,98,0,0,0
2022-07-08 08:15,246,142,104,0,0,0
2022-07-08 08:30,179,106,73,0,0,0
2022-07-08 08:45,198,110,88,0,0,0
2022-07-08 09:00,161,94,67,0,0,0
2022-07-08 09:15,118,61,57,0,0,0
2022-07-08 09:30,158,86,72,0,0,0
2022-07-08 09:45,254,154,100,0,0,0
2022-07-08 10:00,245,137,108,0,0,0
2022-07-08 10:15,157,91,66,0,0,0
2022-07-08 10:30,147,83,64,0,0,0
2022-07-08 10:45,162,93,69,0,0,0
2022-07-08 11:00,123,64,59,0,0,0
2022-07-08 11:15,132,74,58,0,0,0
2022-07-08 11:30,154,74,80,0,0,0
2022-07-08 11:45,228,128,100,0,0,0
2022-07-08 12:00,217,132,85,0,0,0
2022-07-08 12:15,232,122,110,0,0,0
2022-07-08 12:30,201,107,94,0,0,0
2022-07-08 12:45,224,119,105,0,0,0
2022-07-08 13:00,215,114,101,0,0,0
2022-07-08 13:15,196,93,103,0,0,0
2022-07-08 13:30,199,109,90,0,0,0
2022-07-08 13:45,261,154,107,0,0,0
2022-07-08 14:00,216,105,111,0,0,0
2022-07-08 14:15,171,84,87,0,0,0
2022-07-08 14:30,201,107,94,0,0,0
2022-07-08 14:45,230,122,108,0,0,0
2022-07-08 15:00,180,79,101,0,0,0
2022-07-08 15:15,213,104,109,0,0,0
2022-07-08 15:30,209,100,109,0,0,0
2022-07-08 15:45,208,109,99,0,0,0
2022-07-08 16:00,209,114,95,0,0,0
2022-07-08 16:15,203,118,85,0,0,0
2022-07-08 16:30,172,92,80,0,0,0
2022-07-08 16:45,194,99,95,0,0,0
2022-07-08 17:00,189,95,94,0,0,0
2022-07-08 17:15,206,89,117,0,0,0
2022-07-08 17:30,218,95,123,0,0,0
2022-07-08 17:45,258,140,118,0,0,0
2022-07-08 18:00,195,84,111,0,0,0
2022-07-08 18:15,221,121,100,0,0,0
2022-07-08 18:30,199,102,97,0,0,0
2022-07-08 18:45,207,121,86,0,0,0
2022-07-08 19:00,223,115,108,0,0,0
2022-07-08 19:15,218,127,91,0,0,0
2022-07-08 19:30,188,109,79,0,0,0
2022-07-08 19:45,200,108,92,0,0,0
2022-07-08 20:00,172,103,69,0,0,0
2022-07-08 20:15,149,98,51,0,0,0
2022-07-08 20:30,122,68,54,0,0,0
2022-07-08 20:45,123,68,55,0,0,0
2022-07-08 21:00,109,54,55,0,0,0
2022-07-08 21:15,99,43,56,0,0,0
2022-07-08 21:30,96,46,50,0,0,0
2022-07-08 21:45,114,39,75,0,0,0
2022-07-08 22:00,96,32,64,0,0,0
2022-07-08 22:15,108,44,64,0,0,0
2022-07-08 22:30,104,37,67,0,0,0
2022-07-08 22:45,99,33,66,0,0,0
2022-07-08 23:00,102,41,61,0,0,0
2022-07-08 23:15,85,30,55,0,0,0
2022-07-08 23:30,107,37,70,0,0,0
2022-07-08 23:45,96,35,61,0,0,0
2022-07-09 00:00,66,19,47,0,0,0
2022-07-09 00:15,110,32,78,0,0,0
2022-07-09 00:30,68,23,45,0,0,0
2022-07-09 00:45,71,26,45,0,0,0
2022-07-09 01:00,78,30,48,0,0,0
2022-07-09 01:15,67,19,48,0,0,0
2022-07-09 01:30,59,15,44,0,0,0
2022-07-09 01:45,49,10,39,0,0,0
2022-07-09 02:00,42,13,29,0,0,0
2022-07-09 02:15,32,9,23,0,0,0
2022-07-09 02:30,20,2,18,0,0,0
2022-07-09 02:45,30,4,26,0,0,0
2022-07-09 03:00,29,8,21,0,0,0
2022-07-09 03:15,34,5,29,0,0,0
2022-07-09 03:30,10,5,5,0,0,0
2022-07-09 03:45,26,5,21,0,0,0
2022-07-09 04:00,35,5,30,0,0,0
2022-07-09 04:15,15,3,12,0,0,0
2022-07-09 04:30,31,2,29,0,0,0
2022-07-09 04:45,19,4,15,0,0,0
2022-07-09 05:00,24,9,15,0,0,0
2022-07-09 05:15,12,6,6,0,0,0
2022-07-09 05:30,36,15,21,0,0,0
2022-07-09 05:45,11,9,2,0,0,0
2022-07-09 06:00,9,4,5,0,0,0
2022-07-09 06:15,15,6,9,0,0,0
2022-07-09 06:30,11,7,4,0,0,0
2022-07-09 06:45,15,6,9,0,0,0
2022-07-09 07:00,21,14,7,0,0,0
2022-07-09 07:15,24,18,6,0,0,0
2022-07-09 07:30,21,12,9,0,0,0
2022-07-09 07:45,67,53,14,0,0,0
2022-07-09 08:00,47,32,15,0,0,0
2022-07-09 08:15,63,48,15,0,0,0
2022-07-09 08:30,55,40,15,0,0,0
2022-07-09 08:45,96,76,20,0,0,0
2022-07-09 09:00,75,55,20,0,0,0
2022-07-09 09:15,86,66,20,0,0,0
2022-07-09 09:30,84,66,18,0,0,0
2022-07-09 09:45,128,101,27,0,0,0
2022-07-09 10:00,120,79,41,0,0,0
2022-07-09 10:15,109,73,36,0,0,0
2022-07-09 10:30,112,74,38,0,0,0
2022-07-09 10:45,143,99,44,0,0,0
2022-07-09 11:00,155,86,69,0,0,0
2022-07-09 11:15,140,89,51,0,0,0
2022-07-09 11:30,164,106,58,0,0,0
2022-07-09 11:45,144,80,64,0,0,0
2022-07-09 12:00,130,62,68,0,0,0
2022-07-09 12:15,162,84,78,0,0,0
2022-07-09 12:30,119,63,56,0,0,0
2022-07-09 12:45,158,88,70,0,0,0
2022-07-09 13:00,122,79,43,0,0,0
2022-07-09 13:15,163,96,67,0,0,0
2022-07-09 13:30,155,92,63,0,0,0
2022-07-09 13:45,161,88,73,0,0,0
2022-07-09 14:00,169,86,83,0,0,0
2022-07-09 14:15,162,75,87,0,0,0
2022-07-09 14:30,131,62,69,0,0,0
2022-07-09 14:45,160,75,85,0,0,0
2022-07-09 15:00,159,80,79,0,0,0
2022-07-09 15:15,152,68,84,0,0,0
2022-07-09 15:30,147,68,79,0,0,0
2022-07-09 15:45,160,83,77,0,0,0
2022-07-09 16:00,163,65,98,0,0,0
2022-07-09 16:15,143,51,92,0,0,0
2022-07-09 16:30,148,61,87,0,0,0
2022-07-09 16:45,135,72,63,0,0,0
2022-07-09 17:00,137,64,73,0,0,0
2022-07-09 17:15,151,63,88,0,0,0
2022-07-09 17:30,135,67,68,0,0,0
2022-07-09 17:45,173,90,83,0,0,0
2022-07-09 18:00,153,68,85,0,0,0
2022-07-09 18:15,131,57,74,0,0,0
2022-07-09 18:30,125,69,56,0,0,0
2022-07-09 18:45,166,80,86,0,0,0
2022-07-09 19:00,121,58,63,0,0,0
2022-07-09 19:15,152,62,90,0,0,0
2022-07-09 19:30,132,62,70,0,0,0
2022-07-09 19:45,128,60,68,0,0,0
2022-07-09 20:00,140,79,61,0,0,0
2022-07-09 20:15,130,68,62,0,0,0
2022-07-09 20:30,113,60,53,0,0,0
2022-07-09 20:45,116,54,62,0,0,0
2022-07-09 21:00,91,45,46,0,0,0
2022-07-09 21:15,99,46,53,0,0,0
2022-07-09 21:30,76,38,38,0,0,0
2022-07-09 21:45,100,26,74,0,0,0
2022-07-09 22:00,92,35,57,0,0,0
2022-07-09 22:15,86,33,53,0,0,0
2022-07-09 22:30,67,25,42,0,0,0
2022-07-09 22:45,68,23,45,0,0,0
2022-07-09 23:00,70,26,44,0,0,0
2022-07-09 23:15,64,26,38,0,0,0
2022-07-09 23:30,66,35,31,0,0,0
2022-07-09 23:45,65,25,40,0,0,0
2022-07-10 00:00,66,27,39,0,0,0
2022-07-10 00:15,47,7,40,0,0,0
2022-07-10 00:30,47,15,32,0,0,0
2022-07-10 00:45,30,8,22,0,0,0
2022-07-10 01:00,55,8,47,0,0,0
2022-07-10 01:15,35,4,31,0,0,0
2022-07-10 01:30,36,7,29,0,0,0
2022-07-10 01:45,45,13,32,0,0,0
2022-07-10 02:00,33,12,21,0,0,0
2022-07-10 02:15,41,12,29,0,0,0
2022-07-10 02:30,29,7,22,0,0,0
2022-07-10 02:45,34,6,28,0,0,0
2022-07-10 03:00,41,2,39,0,0,0
2022-07-10 03:15,34,4,30,0,0,0
2022-07-10 03:30,21,3,18,0,0,0
2022-07-10 03:45,37,5,32,0,0,0
2022-07-10 04:00,10,2,8,0,0,0
2022-07-10 04:15,22,3,19,0,0,0
2022-07-10 04:30,10,3,7,0,0,0
2022-07-10 04:45,12,3,9,0,0,0
2022-07-10 05:00,11,3,8,0,0,0
2022-07-10 05:15,15,7,8,0,0,0
2022-07-10 05:30,18,3,15,0,0,0
2022-07-10 05:45,5,3,2,0,0,0
2022-07-10 06:00,17,4,13,0,0,0
2022-07-10 06:15,10,5,5,0,0,0
2022-07-10 06:30,12,6,6,0,0,0
2022-07-10 06:45,6,3,3,0,0,0
2022-07-10 07:00,6,3,3,0,0,0
2022-07-10 07:15,7,4,3,0,0,0
2022-07-10 07:30,14,3,11,0,0,0
2022-07-10 07:45,31,24,7,0,0,0
2022-07-10 08:00,33,27,6,0,0,0
2022-07-10 08:15,28,22,6,0,0,0
2022-07-10 08:30,32,21,11,0,0,0
2022-07-10 08:45,67,41,26,0,0,0
2022-07-10 09:00,44,27,17,0,0,0
2022-07-10 09:15,44,32,12,0,0,0
2022-07-10 09:30,40,23,17,0,0,0
2022-07-10 09:45,70,53,17,0,0,0
2022-07-10 10:00,76,54,22,0,0,0
2022-07-10 10:15,63,45,18,0,0,0
2022-07-10 10:30,70,41,29,0,0,0
2022-07-10 10:45,75,53,22,0,0,0
2022-07-10 11:00,74,43,31,0,0,0
2022-07-10 11:15,70,27,43,0,0,0
2022-07-10 11:30,71,44,27,0,0,0
2022-07-10 11:45,75,43,32,0,0,0
2022-07-10 12:00,100,46,54,0,0,0
2022-07-10 12:15,82,42,40,0,0,0
2022-07-10 12:30,72,29,43,0,0,0
2022-07-10 12:45,86,34,52,0,0,0
2022-07-10 13:00,70,30,40,0,0,0
2022-07-10 13:15,93,46,47,0,0,0
2022-07-10 13:30,83,44,39,0,0,0
2022-07-10 13:45,81,55,26,0,0,0
2022-07-10 14:00,103,52,51,0,0,0
2022-07-10 14:15,84,31,53,0,0,0
2022-07-10 14:30,101,57,44,0,0,0
2022-07-10 14:45,111,76,35,0,0,0
2022-07-10 15:00,95,34,61,0,0,0
2022-07-10 15:15,69,50,19,0,0,0
2022-07-10 15:30,118,70,48,0,0,0
2022-07-10 15:45,109,56,53,0,0,0
2022-07-10 16:00,67,28,39,0,0,0
2022-07-10 16:15,107,48,59,0,0,0
2022-07-10 16:30,77,34,43,0,0,0
2022-07-10 16:45,112,57,55,0,0,0
2022-07-10 17:00,102,47,55,0,0,0
2022-07-10 17:15,116,57,59,0,0,0
2022-07-10 17:30,91,46,45,0,0,0
2022-07-10 17:45,84,35,49,0,0,0
2022-07-10 18:00,80,28,52,0,0,0
2022-07-10 18:15,106,41,65,0,0,0
2022-07-10 18:30,87,38,49,0,0,0
2022-07-10 18:45,115,42,73,0,0,0
2022-07-10 19:00,73,23,50,0,0,0
2022-07-10 19:15,81,42,39,0,0,0
2022-07-10 19:30,94,32,62,0,0,0
2022-07-10 19:45,83,33,50,0,0,0
2022-07-10 20:00,54,25,29,0,0,0
2022-07-10 20:15,64,29,35,0,0,0
2022-07-10 20:30,79,28,51,0,0,0
2022-07-10 20:45,57,24,33,0,0,0
2022-07-10 21:00,57,18,39,0,0,0
2022-07-10 21:15,65,29,36,0,0,0
2022-07-10 21:30,42,15,27,0,0,0
2022-07-10 21:45,74,25,49,0,0,0
2022-07-10 22:00,35,8,27,0,0,0
2022-07-10 22:15,44,15,29,0,0,0
2022-07-10 22:30,44,11,33,0,0,0
2022-07-10 22:45,47,16,31,0,0,0
2022-07-10 23:00,35,7,28,0,0,0
2022-07-10 23:15,21,7,14,0,0,0
2022-07-10 23:30,23,5,18,0,0,0
2022-07-10 23:45,21,7,14,0,0,0
2022-07-11 00:00,12,2,10,0,0,0
2022-07-11 00:15,19,10,9,0,0,0
2022-07-11 00:30,10,5,5,0,0,0
2022-07-11 00:45,9,3,6,0,0,0
2022-07-11 01:00,12,3,9,0,0,0
2022-07-11 01:15,5,1,4,0,0,0
2022-07-11 01:30,9,3,6,0,0,0
2022-07-11 01:45,3,0,3,0,0,0
2022-07-11 02:00,9,3,6,0,0,0
2022-07-11 02:15,3,0,3,0,0,0
2022-07-11 02:30,2,1,1,0,0,0
2022-07-11 02:45,1,0,1,0,0,0
2022-07-11 03:00,2,1,1,0,0,0
2022-07-11 03:15,0,0,0,0,0,0
2022-07-11 03:30,1,1,0,0,0,0
2022-07-11 03:45,2,2,0,0,0,0
2022-07-11 04:00,0,0,0,0,0,0
2022-07-11 04:15,4,1,3,0,0,0
2022-07-11 04:30,7,3,4,0,0,0
2022-07-11 04:45,10,6,4,0,0,0
2022-07-11 05:00,10,8,2,0,0,0
2022-07-11 05:15,9,9,0,0,0,0
2022-07-11 05:30,17,13,4,0,0,0
2022-07-11 05:45,21,18,3,0,0,0
2022-07-11 06:00,28,20,8,0,0,0
2022-07-11 06:15,40,33,7,0,0,0
2022-07-11 06:30,62,34,28,0,0,0
2022-07-11 06:45,80,47,33,0,0,0
2022-07-11 07:00,77,49,28,0,0,0
2022-07-11 07:15,117,62,55,0,0,0
2022-07-11 07:30,143,77,66,0,0,0
2022-07-11 07:45,215,125,90,0,0,0
2022-07-11 08:00,232,137,95,0,0,0
2022-07-11 08:15,190,113,77,0,0,0
2022-07-11 08:30,206,117,89,0,0,0
2022-07-11 08:45,226,126,100,0,0,0
2022-07-11 09:00,136,75,61,0,0,0
2022-07-11 09:15,139,74,65,0,0,0
2022-07-11 09:30,131,61,70,0,0,0
2022-07-11 09:45,191,92,99,0,0,0
2022-07-11 10:00,183,101,82,0,0,0
2022-07-11 10:15,157,77,80,0,0,0
2022-07-11 10:30,114,67,47,0,0,0
2022-07-11 10:45,144,77,67,0,0,0
2022-07-11 11:00,103,59,44,0,0,0
2022-07-11 11:15,112,57,55,0,0,0
2022-07-11 11:30,135,75,60,0,0,0
2022-07-11 11:45,199,94,105,0,0,0
2022-07-11 12:00,195,92,103,0,0,0
2022-07-11 12:15,168,88,80,0,0,0
2022-07-11 12:30,161,99,62,0,0,0
2022-07-11 12:45,205,117,88,0,0,0
2022-07-11 13:00,166,82,84,0,0,0
2022-07-11 13:15,173,91,82,0,0,0
2022-07-11 13:30,200,115,85,0,0,0
2022-07-11 13:45,268,134,134,0,0,0
2022-07-11 14:00,245,137,108,0,0,0
2022-07-11 14:15,206,113,93,0,0,0
2022-07-11 14:30,217,105,112,0,0,0
2022-07-11 14:45,197,102,95,0,0,0
2022-07-11 15:00,173,88,85,0,0,0
2022-07-11 15:15,203,108,95,0,0,0
2022-07-11 15:30,247,125,122,0,0,0
2022-07-11 15:45,341,192,149,0,0,0
2022-07-11 16:00,298,142,156,0,0,0
2022-07-11 16:15,257,130,127,0,0,0
2022-07-11 16:30,253,115,138,0,0,0
2022-07-11 16:45,227,100,127,0,0,0
2022-07-11 17:00,264,122,142,0,0,0
2022-07-11 17:15,269,118,151,0,0,0
2022-07-11 17:30,284,129,155,0,0,0
2022-07-11 17:45,352,154,198,0,0,0
2022-07-11 18:00,254,120,134,0,0,0
2022-07-11 18:15,278,134,144,0,0,0
2022-07-11 18:30,220,103,117,0,0,0
2022-07-11 18:45,233,122,111,0,0,0
2022-07-11 19:00,196,88,108,0,0,0
2022-07-11 19:15,192,91,101,0,0,0
2022-07-11 19:30,211,81,130,0,0,0
2022-07-11 19:45,191,83,108,0,0,0
2022-07-11 20:00,167,72,95,0,0,0
2022-07-11 20:15,156,63,93,0,0,0
2022-07-11 20:30,141,49,92,0,0,0
2022-07-11 20:45,130,61,69,0,0,0
2022-07-11 21:00,110,63,47,0,0,0
2022-07-11 21:15,91,32,59,0,0,0
2022-07-11 21:30,93,42,51,0,0,0
2022-07-11 21:45,100,28,72,0,0,0
2022-07-11 22:00,86,32,54,0,0,0
2022-07-11 22:15,70,29,41,0,0,0
2022-07-11 22:30,89,26,63,0,0,0
2022-07-11 22:45,68,11,57,0,0,0
2022-07-11 23:00,47,18,29,0,0,0
2022-07-11 23:15,51,20,31,0,0,0
2022-07-11 23:30,33,10,23,0,0,0
2022-07-11 23:45,19,4,15,0,0,0
2022-07-12 00:00,35,7,28,0,0,0
2022-07-12 00:15,31,4,27,0,0,0
2022-07-12 00:30,14,4,10,0,0,0
2022-07-12 00:45,25,7,18,0,0,0
2022-07-12 01:00,19,9,10,0,0,0
2022-07-12 01:15,17,3,14,0,0,0
2022-07-12 01:30,13,5,8,0,0,0
2022-07-12 01:45,12,6,6,0,0,0
2022-07-12 02:00,15,9,6,0,0,0
2022-07-12 02:15,8,4,4,0,0,0
2022-07-12 02:30,6,1,5,0,0,0
2022-07-12 02:45,9,3,6,0,0,0
2022-07-12 03:00,6,2,4,0,0,0
2022-07-12 03:15,1,1,0,0,0,0
2022-07-12 03:30,2,0,2,0,0,0
2022-07-12 03:45,8,4,4,0,0,0
2022-07-12 04:00,0,0,0,0,0,0
2022-07-12 04:15,5,0,5,0,0,0
2022-07-12 04:30,9,5,4,0,0,0
2022-07-12 04:45,12,8,4,0,0,0
2022-07-12 05:00,7,7,0,0,0,0
2022-07-12 05:15,12,11,1,0,0,0
2022-07-12 05:30,18,13,5,0,0,0
2022-07-12 05:45,28,22,6,0,0,0
2022-07-12 06:00,28,18,10,0,0,0
2022-07-12 06:15,38,30,8,0,0,0
2022-07-12 06:30,73,44,29,0,0,0
2022-07-12 06:45,89,56,33,0,0,0
2022-07-12 07:00,87,47,40,0,0,0
2022-07-12 07:15,137,67,70,0,0,0
2022-07-12 07:30,182,95,87,0,0,0
2022-07-12 07:45,262,157,105,0,0,0
2022-07-12 08:00,254,154,100,0,0,0
2022-07-12 08:15,219,144,75,0,0,0
2022-07-12 08:30,188,103,85,0,0,0
2022-07-12 08:45,199,129,70,0,0,0
2022-07-12 09:00,171,110,61,0,0,0
2022-07-12 09:15,147,88,59,0,0,0
2022-07-12 09:30,191,110,81,0,0,0
2022-07-12 09:45,237,132,105,0,0,0
2022-07-12 10:00,225,131,94,0,0,0
2022-07-12 10:15,164,94,70,0,0,0
2022-07-12 10:30,149,91,58,0,0,0
2022-07-12 10:45,166,77,89,0,0,0
2022-07-12 11:00,157,80,77,0,0,0
2022-07-12 11:15,187,107,80,0,0,0
2022-07-12 11:30,218,116,102,0,0,0
2022-07-12 11:45,254,147,107,0,0,0
2022-07-12 12:00,254,136,118,0,0,0
2022-07-12 12:15,226,112,114,0,0,0
2022-07-12 12:30,192,96,96,0,0,0
2022-07-12 12:45,221,105,116,0,0,0
2022-07-12 13:00,212,100,112,0,0,0
2022-07-12 13:15,194,114,80,0,0,0
2022-07-12 13:30,234,129,105,0,0,0
2022-07-12 13:45,279,151,128,0,0,0
2022-07-12 14:00,281,145,136,0,0,0
2022-07-12 14:15,199,96,103,0,0,0
2022-07-12 14:30,237,107,130,0,0,0
2022-07-12 14:45,222,119,103,0,0,0
2022-07-12 15:00,229,107,122,0,0,0
2022-07-12 15:15,223,103,120,0,0,0
2022-07-12 15:30,237,114,123,0,0,0
2022-07-12 15:45,318,167,151,0,0,0
2022-07-12 16:00,266,132,134,0,0,0
2022-07-12 16:15,265,117,148,0,0,0
2022-07-12 16:30,256,123,133,0,0,0
2022-07-12 16:45,295,120,175,0,0,0
2022-07-12 17:00,270,144,126,0,0,0
2022-07-12 17:15,324,134,190,0,0,0
2022-07-12 17:30,301,151,150,0,0,0
2022-07-12 17:45,341,143,198,0,0,0
2022-07-12 18:00,319,166,153,0,0,0
2022-07-12 18:15,291,137,154,0,0,0
2022-07-12 18:30,247,111,136,0,0,0
2022-07-12 18:45,297,139,158,0,0,0
2022-07-12 19:00,271,130,141,0,0,0
2022-07-12 19:15,296,135,161,0,0,0
2022-07-12 19:30,200,96,104,0,0,0
2022-07-12 19:45,219,93,126,0,0,0
2022-07-12 20:00,229,106,123,0,0,0
2022-07-12 20:15,194,91,103,0,0,0
2022-07-12 20:30,142,57,85,0,0,0
2022-07-12 20:45,163,88,75,0,0,0
2022-07-12 21:00,126,56,70,0,0,0
2022-07-12 21:15,155,76,79,0,0,0
2022-07-12 21:30,127,49,78,0,0,0
2022-07-12 21:45,150,51,99,0,0,0
2022-07-12 22:00,115,38,77,0,0,0
2022-07-12 22:15,126,44,82,0,0,0
2022-07-12 22:30,96,33,63,0,0,0
2022-07-12 22:45,97,47,50,0,0,0
2022-07-12 23:00,84,36,48,0,0,0
2022-07-12 23:15,83,31,52,0,0,0
2022-07-12 23:30,64,13,51,0,0,0
2022-07-12 23:45,52,10,42,0,0,0
2022-07-13 00:00,55,23,32,0,0,0
2022-07-13 00:15,50,11,39,0,0,0
2022-07-13 00:30,44,14,30,0,0,0
2022-07-13 00:45,28,9,19,0,0,0
2022-07-13 01:00,20,8,12,0,0,0
2022-07-13 01:15,12,1,11,0,0,0
2022-07-13 01:30,23,7,16,0,0,0
2022-07-13 01:45,16,3,13,0,0,0
2022-07-13 02:00,12,4,8,0,0,0
2022-07-13 02:15,4,1,3,0,0,0
2022-07-13 02:30,4,2,2,0,0,0
2022-07-13 02:45,8,7,1,0,0,0
2022-07-13 03:00,6,2,4,0,0,0
2022-07-13 03:15,5,5,0,0,0,0
2022-07-13 03:30,6,2,4,0,0,0
2022-07-13 03:45,5,4,1,0,0,0
2022-07-13 04:00,7,1,6,0,0,0
2022-07-13 04:15,8,4,4,0,0,0
2022-07-13 04:30,8,4,4,0,0,0
2022-07-13 04:45,8,7,1,0,0,0
2022-07-13 05:00,12,6,6,0,0,0
2022-07-13 05:15,20,19,1,0,0,0
2022-07-13 05:30,22,17,5,0,0,0
2022-07-13 05:45,30,23,7,0,0,0
2022-07-13 06:00,34,25,9,0,0,0
2022-07-13 06:15,42,30,12,0,0,0
2022-07-13 06:30,75,45,30,0,0,0
2022-07-13 06:45,93,69,24,0,0,0
2022-07-13 07:00,107,65,42,0,0,0
2022-07-13 07:15,181,114,67,0,0,0
2022-07-13 07:30,203,123,80,0,0,0
2022-07-13 07:45,283,175,108,0,0,0
2022-07-13 08:00,215,135,80,0,0,0
2022-07-13 08:15,203,120,83,0,0,0
2022-07-13 08:30,215,143,72,0,0,0
2022-07-13 08:45,260,155,105,0,0,0
2022-07-13 09:00,181,108,73,0,0,0
2022-07-13 09:15,163,88,75,0,0,0
2022-07-13 09:30,209,111,98,0,0,0
2022-07-13 09:45,267,168,99,0,0,0
2022-07-13 10:00,272,163,109,0,0,0
2022-07-13 10:15,180,105,75,0,0,0
2022-07-13 10:30,180,106,74,0,0,0
2022-07-13 10:45,183,82,101,0,0,0
2022-07-13 11:00,170,82,88,0,0,0
2022-07-13 11:15,182,106,76,0,0,0
2022-07-13 11:30,215,128,87,0,0,0
2022-07-13 11:45,289,156,133,0,0,0
2022-07-13 12:00,234,114,120,0,0,0
2022-07-13 12:15,228,125,103,0,0,0
2022-07-13 12:30,181,96,85,0,0,0
2022-07-13 12:45,199,113,86,0,0,0
2022-07-13 13:00,193,104,89,0,0,0
2022-07-13 13:15,206,115,91,0,0,0
2022-07-13 13:30,216,113,103,0,0,0
2022-07-13 13:45,240,120,120,0,0,0
2022-07-13 14:00,274,142,132,0,0,0
2022-07-13 14:15,180,93,87,0,0,0
2022-07-13 14:30,227,112,115,0,0,0
2022-07-13 14:45,195,102,93,0,0,0
2022-07-13 15:00,206,91,115,0,0,0
2022-07-13 15:15,246,117,129,0,0,0
2022-07-13 15:30,252,130,122,0,0,0
2022-07-13 15:45,274,144,130,0,0,0
2022-07-13 16:00,300,154,146,0,0,0
2022-07-13 16:15,249,111,138,0,0,0
2022-07-13 16:30,259,116,143,0,0,0
2022-07-13 16:45,297,149,148,0,0,0
2022-07-13 17:00,258,116,142,0,0,0
2022-07-13 17:15,299,163,136,0,0,0
2022-07-13 17:30,258,101,157,0,0,0
2022-07-13 17:45,302,145,157,0,0,0
2022-07-13 18:00,293,134,159,0,0,0
2022-07-13 18:15,282,131,151,0,0,0
2022-07-13 18:30,230,106,124,0,0,0
2022-07-13 18:45,243,128,115,0,0,0
2022-07-13 19:00,236,112,124,0,0,0
2022-07-13 19:15,216,126,90,0,0,0
2022-07-13 19:30,234,138,96,0,0,0
2022-07-13 19:45,232,131,101,0,0,0
2022-07-13 20:00,213,98,115,0,0,0
2022-07-13 20:15,160,77,83,0,0,0
2022-07-13 20:30,183,90,93,0,0,0
2022-07-13 20:45,158,78,80,0,0,0
2022-07-13 21:00,150,68,82,0,0,0
2022-07-13 21:15,135,60,75,0,0,0
2022-07-13 21:30,128,55,73,0,0,0
2022-07-13 21:45,152,55,97,0,0,0
2022-07-13 22:00,135,40,95,0,0,0
2022-07-13 22:15,114,50,64,0,0,0
2022-07-13 22:30,90,21,69,0,0,0
2022-07-13 22:45,137,40,97,0,0,0
2022-07-13 23:00,95,36,59,0,0,0
2022-07-13 23:15,82,30,52,0,0,0
2022-07-13 23:30,97,35,62,0,0,0
2022-07-13 23:45,75,16,59,0,0,0
2022-07-14 00:00,47,13,34,0,0,0
2022-07-14 00:15,47,9,38,0,0,0
2022-07-14 00:30,54,14,40,0,0,0
2022-07-14 00:45,55,18,37,0,0,0
2022-07-14 01:00,45,20,25,0,0,0
2022-07-14 01:15,30,8,22,0,0,0
2022-07-14 01:30,53,8,45,0,0,0
2022-07-14 01:45,26,6,20,0,0,0
2022-07-14 02:00,29,5,24,0,0,0
2022-07-14 02:15,34,3,31,0,0,0
2022-07-14 02:30,24,7,17,0,0,0
2022-07-14 02:45,20,5,15,0,0,0
2022-07-14 03:00,14,1,13,0,0,0
2022-07-14 03:15,15,8,7,0,0,0
2022-07-14 03:30,11,1,10,0,0,0
2022-07-14 03:45,13,4,9,0,0,0
2022-07-14 04:00,14,3,11,0,0,0
2022-07-14 04:15,13,2,11,0,0,0
2022-07-14 04:30,8,2,6,0,0,0
2022-07-14 04:45,13,7,6,0,0,0
2022-07-14 05:00,8,6,2,0,0,0
2022-07-14 05:15,21,16,5,0,0,0
2022-07-14 05:30,16,10,6,0,0,0
2022-07-14 05:45,28,17,11,0,0,0
2022-07-14 06:00,33,25,8,0,0,0
2022-07-14 06:15,30,19,11,0,0,0
2022-07-14 06:30,71,43,28,0,0,0
2022-07-14 06:45,81,47,34,0,0,0
2022-07-14 07:00,76,46,30,0,0,0
2022-07-14 07:15,111,57,54,0,0,0
2022-07-14 07:30,166,92,74,0,0,0
2022-07-14 07:45,241,153,88,0,0,0
2022-07-14 08:00,228,141,87,0,0,0
2022-07-14 08:15,210,118,92,0,0,0
2022-07-14 08:30,180,110,70,0,0,0
2022-07-14 08:45,236,151,85,0,0,0
2022-07-14 09:00,196,128,68,0,0,0
2022-07-14 09:15,171,104,67,0,0,0
2022-07-14 09:30,203,123,80,0,0,0
2022-07-14 09:45,256,159,97,0,0,0
2022-07-14 10:00,230,143,87,0,0,0
2022-07-14 10:15,145,82,63,0,0,0
2022-07-14 10:30,141,77,64,0,0,0
2022-07-14 10:45,161,81,80,0,0,0
2022-07-14 11:00,152,76,76,0,0,0
2022-07-14 11:15,179,95,84,0,0,0
2022-07-14 11:30,196,122,74,0,0,0
2022-07-14 11:45,236,137,99,0,0,0
2022-07-14 12:00,240,125,115,0,0,0
2022-07-14 12:15,212,102,110,0,0,0
2022-07-14 12:30,193,109,84,0,0,0
2022-07-14 12:45,229,129,100,0,0,0
2022-07-14 13:00,204,117,87,0,0,0
2022-07-14 13:15,206,113,93,0,0,0
2022-07-14 13:30,216,108,108,0,0,0
2022-07-14 13:45,254,129,125,0,0,0
2022-07-14 14:00,238,119,119,0,0,0
2022-07-14 14:15,185,91,94,0,0,0
2022-07-14 14:30,206,99,107,0,0,0
2022-07-14 14:45,286,134,152,0,0,0
2022-07-14 15:00,231,125,106,0,0,0
2022-07-14 15:15,218,112,106,0,0,0
2022-07-14 15:30,258,143,115,0,0,0
2022-07-14 15:45,286,146,140,0,0,0
2022-07-14 16:00,297,152,145,0,0,0
2022-07-14 16:15,263,122,141,0,0,0
2022-07-14 16:30,274,145,129,0,0,0
2022-07-14 16:45,277,147,130,0,0,0
2022-07-14 17:00,264,122,142,0,0,0
2022-07-14 17:15,315,165,150,0,0,0
2022-07-14 17:30,305,128,177,0,0,0
2022-07-14 17:45,358,162,196,0,0,0
2022-07-14 18:00,349,188,161,0,0,0
2022-07-14 18:15,330,151,179,0,0,0
2022-07-14 18:30,252,119,133,0,0,0
2022-07-14 18:45,289,143,146,0,0,0
2022-07-14 19:00,230,127,103,0,0,0
2022-07-14 19:15,221,108,113,0,0,0
2022-07-14 19:30,214,124,90,0,0,0
2022-07-14 19:45,240,140,100,0,0,0
2022-07-14 20:00,243,122,121,0,0,0
2022-07-14 20:15,161,74,87,0,0,0
2022-07-14 20:30,179,81,98,0,0,0
2022-07-14 20:45,153,86,67,0,0,0
2022-07-14 21:00,140,68,72,0,0,0
2022-07-14 21:15,118,46,72,0,0,0
2022-07-14 21:30,147,56,91,0,0,0
2022-07-14 21:45,142,65,77,0,0,0
2022-07-14 22:00,150,47,103,0,0,0
2022-07-14 22:15,143,59,84,0,0,0
2022-07-14 22:30,111,36,75,0,0,0
2022-07-14 22:45,108,29,79,0,0,0
2022-07-14 23:00,92,19,73,0,0,0
2022-07-14 23:15,103,43,60,0,0,0
2022-07-14 23:30,80,21,59,0,0,0
2022-07-14 23:45,52,17,35,0,0,0
2022-07-15 00:00,66,22,44,0,0,0
2022-07-15 00:15,46,14,32,0,0,0
2022-07-15 00:30,44,14,30,0,0,0
2022-07-15 00:45,25,6,19,0,0,0
2022-07-15 01:00,19,7,12,0,0,0
2022-07-15 01:15,32,5,27,0,0,0
2022-07-15 01:30,16,5,11,0,0,0
2022-07-15 01:45,23,7,16,0,0,0
2022-07-15 02:00,23,11,12,0,0,0
2022-07-15 02:15,21,11,10,0,0,0
2022-07-15 02:30,6,1,5,0,0,0
2022-07-15 02:45,13,2,11,0,0,0
2022-07-15 03:00,15,7,8,0,0,0
2022-07-15 03:15,7,1,6,0,0,0
2022-07-15 03:30,12,4,8,0,0,0
2022-07-15 03:45,5,3,2,0,0,0
2022-07-15 04:00,5,0,5,0,0,0
2022-07-15 04:15,4,1,3,0,0,0
2022-07-15 04:30,4,1,3,0,0,0
2022-07-15 04:45,11,7,4,0,0,0
2022-07-15 05:00,16,6,10,0,0,0
2022-07-15 05:15,14,8,6,0,0,0
2022-07-15 05:30,21,12,9,0,0,0
2022-07-15 05:45,21,14,7,0,0,0
2022-07-15 06:00,44,20,24,0,0,0
2022-07-15 06:15,33,22,11,0,0,0
2022-07-15 06:30,56,30,26,0,0,0
2022-07-15 06:45,69,42,27,0,0,0
2022-07-15 07:00,75,47,28,0,0,0
2022-07-15 07:15,90,43,47,0,0,0
2022-07-15 07:30,120,57,63,0,0,0
2022-07-15 07:45,203,125,78,0,0,0
2022-07-15 08:00,195,130,65,0,0,0
2022-07-15 08:15,149,83,66,0,0,0
2022-07-15 08:30,176,103,73,0,0,0
2022-07-15 08:45,197,133,64,0,0,0
2022-07-15 09:00,153,104,49,0,0,0
2022-07-15 09:15,169,97,72,0,0,0
2022-07-15 09:30,158,90,68,0,0,0
2022-07-15 09:45,241,124,117,0,0,0
2022-07-15 10:00,146,87,59,0,0,0
2022-07-15 10:15,170,102,68,0,0,0
2022-07-15 10:30,119,59,60,0,0,0
2022-07-15 10:45,163,93,70,0,0,0
2022-07-15 11:00,156,92,64,0,0,0
2022-07-15 11:15,141,80,61,0,0,0
2022-07-15 11:30,159,91,68,0,0,0
2022-07-15 11:45,197,122,75,0,0,0
2022-07-15 12:00,199,91,108,0,0,0
2022-07-15 12:15,188,90,98,0,0,0
2022-07-15 12:30,159,79,80,0,0,0
2022-07-15 12:45,194,109,85,0,0,0
2022-07-15 13:00,223,109,114,0,0,0
2022-07-15 13:15,212,114,98,0,0,0
2022-07-15 13:30,228,132,96,0,0,0
2022-07-15 13:45,241,133,108,0,0,0
2022-07-15 14:00,239,123,116,0,0,0
2022-07-15 14:15,237,107,130,0,0,0
2022-07-15 14:30,232,117,115,0,0,0
2022-07-15 14:45,226,128,98,0,0,0
2022-07-15 15:00,219,128,91,0,0,0
2022-07-15 15:15,225,107,118,0,0,0
2022-07-15 15:30,242,122,120,0,0,0
2022-07-15 15:45,234,127,107,0,0,0
2022-07-15 16:00,226,112,114,0,0,0
2022-07-15 16:15,220,116,104,0,0,0
2022-07-15 16:30,194,84,110,0,0,0
2022-07-15 16:45,210,113,97,0,0,0
2022-07-15 17:00,210,104,106,0,0,0
2022-07-15 17:15,220,93,127,0,0,0
2022-07-15 17:30,269,118,151,0,0,0
2022-07-15 17:45,256,110,146,0,0,0
2022-07-15 18:00,236,120,116,0,0,0
2022-07-15 18:15,239,106,133,0,0,0
2022-07-15 18:30,227,114,113,0,0,0
2022-07-15 18:45,221,100,121,0,0,0
2022-07-15 19:00,211,119,92,0,0,0
2022-07-15 19:15,224,140,84,0,0,0
2022-07-15 19:30,217,113,104,0,0,0
2022-07-15 19:45,228,128,100,0,0,0
2022-07-15 20:00,214,109,105,0,0,0
2022-07-15 20:15,195,122,73,0,0,0
2022-07-15 20:30,193,108,85,0,0,0
2022-07-15 20:45,198,110,88,0,0,0
2022-07-15 21:00,211,125,86,0,0,0
2022-07-15 21:15,161,90,71,0,0,0
2022-07-15 21:30,164,87,77,0,0,0
2022-07-15 21:45,143,66,77,0,0,0
2022-07-15 22:00,148,99,49,0,0,0
2022-07-15 22:15,138,55,83,0,0,0
2022-07-15 22:30,115,64,51,0,0,0
2022-07-15 22:45,188,36,152,0,0,0
2022-07-15 23:00,170,58,112,0,0,0
2022-07-15 23:15,132,30,102,0,0,0
2022-07-15 23:30,115,32,83,0,0,0
2022-07-15 23:45,96,18,78,0,0,0
2022-07-16 00:00,124,40,84,0,0,0
2022-07-16 00:15,126,36,90,0,0,0
2022-07-16 00:30,74,22,52,0,0,0
2022-07-16 00:45,90,26,64,0,0,0
2022-07-16 01:00,60,13,47,0,0,0
2022-07-16 01:15,76,21,55,0,0,0
2022-07-16 01:30,47,23,24,0,0,0
2022-07-16 01:45,55,19,36,0,0,0
2022-07-16 02:00,48,20,28,0,0,0
2022-07-16 02:15,35,13,22,0,0,0
2022-07-16 02:30,35,12,23,0,0,0
2022-07-16 02:45,46,18,28,0,0,0
2022-07-16 03:00,46,21,25,0,0,0
2022-07-16 03:15,43,15,28,0,0,0
2022-07-16 03:30,45,21,24,0,0,0
2022-07-16 03:45,46,16,30,0,0,0
2022-07-16 04:00,29,10,19,0,0,0
2022-07-16 04:15,36,8,28,0,0,0
2022-07-16 04:30,23,7,16,0,0,0
2022-07-16 04:45,19,13,6,0,0,0
2022-07-16 05:00,34,17,17,0,0,0
2022-07-16 05:15,27,10,17,0,0,0
2022-07-16 05:30,16,11,5,0,0,0
2022-07-16 05:45,20,11,9,0,0,0
2022-07-16 06:00,17,6,11,0,0,0
2022-07-16 06:15,9,1,8,0,0,0
2022-07-16 06:30,17,9,8,0,0,0
2022-07-16 06:45,23,11,12,0,0,0
2022-07-16 07:00,16,11,5,0,0,0
2022-07-16 07:15,34,21,13,0,0,0
2022-07-16 07:30,43,24,19,0,0,0
2022-07-16 07:45,57,46,11,0,0,0
2022-07-16 08:00,49,38,11,0,0,0
2022-07-16 08:15,55,42,13,0,0,0
2022-07-16 08:30,64,44,20,0,0,0
2022-07-16 08:45,87,67,20,0,0,0
2022-07-16 09:00,71,53,18,0,0,0
2022-07-16 09:15,67,46,21,0,0,0
2022-07-16 09:30,85,63,22,0,0,0
2022-07-16 09:45,102,74,28,0,0,0
2022-07-16 10:00,94,58,36,0,0,0
2022-07-16 10:15,149,92,57,0,0,0
2022-07-16 10:30,142,77,65,0,0,0
2022-07-16 10:45,169,103,66,0,0,0
2022-07-16 11:00,112,58,54,0,0,0
2022-07-16 11:15,140,82,58,0,0,0
2022-07-16 11:30,140,91,49,0,0,0
2022-07-16 11:45,168,102,66,0,0,0
2022-07-16 12:00,152,84,68,0,0,0
2022-07-16 12:15,169,98,71,0,0,0
2022-07-16 12:30,135,84,51,0,0,0
2022-07-16 12:45,163,92,71,0,0,0
2022-07-16 13:00,188,108,80,0,0,0
2022-07-16 13:15,184,79,105,0,0,0
2022-07-16 13:30,176,104,72,0,0,0
2022-07-16 13:45,212,133,79,0,0,0
2022-07-16 14:00,170,86,84,0,0,0
2022-07-16 14:15,176,71,105,0,0,0
2022-07-16 14:30,167,76,91,0,0,0
2022-07-16 14:45,176,91,85,0,0,0
2022-07-16 15:00,164,82,82,0,0,0
2022-07-16 15:15,141,76,65,0,0,0
2022-07-16 15:30,181,83,98,0,0,0
2022-07-16 15:45,176,87,89,0,0,0
2022-07-16 16:00,179,93,86,0,0,0
2022-07-16 16:15,156,83,73,0,0,0
2022-07-16 16:30,163,78,85,0,0,0
2022-07-16 16:45,180,85,95,0,0,0
2022-07-16 17:00,173,94,79,0,0,0
2022-07-16 17:15,160,66,94,0,0,0
2022-07-16 17:30,135,62,73,0,0,0
2022-07-16 17:45,172,91,81,0,0,0
2022-07-16 18:00,182,93,89,0,0,0
2022-07-16 18:15,169,94,75,0,0,0
2022-07-16 18:30,151,82,69,0,0,0
2022-07-16 18:45,190,100,90,0,0,0
2022-07-16 19:00,171,90,81,0,0,0
2022-07-16 19:15,169,98,71,0,0,0
2022-07-16 19:30,176,88,88,0,0,0
2022-07-16 19:45,177,100,77,0,0,0
2022-07-16 20:00,165,93,72,0,0,0
2022-07-16 20:15,143,91,52,0,0,0
2022-07-16 20:30,161,74,87,0,0,0
2022-07-16 20:45,138,68,70,0,0,0
2022-07-16 21:00,113,62,51,0,0,0
2022-07-16 21:15,142,60,82,0,0,0
2022-07-16 21:30,120,48,72,0,0,0
2022-07-16 21:45,113,46,67,0,0,0
2022-07-16 22:00,115,45,70,0,0,0
2022-07-16 22:15,131,47,84,0,0,0
2022-07-16 22:30,76,26,50,0,0,0
2022-07-16 22:45,98,35,63,0,0,0
2022-07-16 23:00,93,28,65,0,0,0
2022-07-16 23:15,79,34,45,0,0,0
2022-07-16 23:30,64,18,46,0,0,0
2022-07-16 23:45,109,43,66,0,0,0
2022-07-17 00:00,67,16,51,0,0,0
2022-07-17 00:15,58,19,39,0,0,0
2022-07-17 00:30,43,11,32,0,0,0
2022-07-17 00:45,73,31,42,0,0,0
2022-07-17 01:00,55,13,42,0,0,0
2022-07-17 01:15,51,12,39,0,0,0
2022-07-17 01:30,51,17,34,0,0,0
2022-07-17 01:45,40,12,28,0,0,0
2022-07-17 02:00,33,7,26,0,0,0
2022-07-17 02:15,38,13,25,0,0,0
2022-07-17 02:30,25,4,21,0,0,0
2022-07-17 02:45,33,10,23,0,0,0
2022-07-17 03:00,26,8,18,0,0,0
2022-07-17 03:15,32,8,24,0,0,0
2022-07-17 03:30,17,2,15,0,0,0
2022-07-17 03:45,21,3,18,0,0,0
2022-07-17 04:00,25,5,20,0,0,0
2022-07-17 04:15,16,6,10,0,0,0
2022-07-17 04:30,18,3,15,0,0,0
2022-07-17 04:45,14,3,11,0,0,0
2022-07-17 05:00,8,1,7,0,0,0
2022-07-17 05:15,17,4,13,0,0,0
2022-07-17 05:30,13,6,7,0,0,0
2022-07-17 05:45,5,3,2,0,0,0
2022-07-17 06:00,11,4,7,0,0,0
2022-07-17 06:15,5,1,4,0,0,0
2022-07-17 06:30,16,4,12,0,0,0
2022-07-17 06:45,11,7,4,0,0,0
2022-07-17 07:00,10,4,6,0,0,0
2022-07-17 07:15,10,5,5,0,0,0
2022-07-17 07:30,17,6,11,0,0,0
2022-07-17 07:45,37,28,9,0,0,0
2022-07-17 08:00,31,25,6,0,0,0
2022-07-17 08:15,46,30,16,0,0,0
2022-07-17 08:30,42,31,11,0,0,0
2022-07-17 08:45,55,41,14,0,0,0
2022-07-17 09:00,48,23,25,0,0,0
2022-07-17 09:15,47,32,15,0,0,0
2022-07-17 09:30,49,25,24,0,0,0
2022-07-17 09:45,92,67,25,0,0,0
2022-07-17 10:00,61,44,17,0,0,0
2022-07-17 10:15,62,33,29,0,0,0
2022-07-17 10:30,74,40,34,0,0,0
2022-07-17 10:45,100,55,45,0,0,0
2022-07-17 11:00,104,58,46,0,0,0
2022-07-17 11:15,87,59,28,0,0,0
2022-07-17 11:30,115,68,47,0,0,0
2022-07-17 11:45,92,49,43,0,0,0
2022-07-17 12:00,126,64,62,0,0,0
2022-07-17 12:15,110,68,42,0,0,0
2022-07-17 12:30,95,64,31,0,0,0
2022-07-17 12:45,158,77,81,0,0,0
2022-07-17 13:00,129,64,65,0,0,0
2022-07-17 13:15,115,74,41,0,0,0
2022-07-17 13:30,161,101,60,0,0,0
2022-07-17 13:45,146,82,64,0,0,0
2022-07-17 14:00,113,55,58,0,0,0
2022-07-17 14:15,168,96,72,0,0,0
2022-07-17 14:30,151,87,64,0,0,0
2022-07-17 14:45,175,96,79,0,0,0
2022-07-17 15:00,162,92,70,0,0,0
2022-07-17 15:15,164,92,72,0,0,0
2022-07-17 15:30,176,115,61,0,0,0
2022-07-17 15:45,155,83,72,0,0,0
2022-07-17 16:00,176,92,84,0,0,0
2022-07-17 16:15,165,99,66,0,0,0
2022-07-17 16:30,150,69,81,0,0,0
2022-07-17 16:45,156,80,76,0,0,0
2022-07-17 17:00,136,70,66,0,0,0
2022-07-17 17:15,126,66,60,0,0,0
2022-07-17 17:30,158,81,77,0,0,0
2022-07-17 17:45,167,83,84,0,0,0
2022-07-17 18:00,176,80,96,0,0,0
2022-07-17 18:15,167,85,82,0,0,0
2022-07-17 18:30,150,63,87,0,0,0
2022-07-17 18:45,189,107,82,0,0,0
2022-07-17 19:00,171,83,88,0,0,0
2022-07-17 19:15,162,80,82,0,0,0
2022-07-17 19:30,179,78,101,0,0,0
2022-07-17 19:45,126,56,70,0,0,0
2022-07-17 20:00,133,72,61,0,0,0
2022-07-17 20:15,110,40,70,0,0,0
2022-07-17 20:30,120,48,72,0,0,0
2022-07-17 20:45,96,40,56,0,0,0
2022-07-17 21:00,116,43,73,0,0,0
2022-07-17 21:15,97,36,61,0,0,0
2022-07-17 21:30,80,40,40,0,0,0
2022-07-17 21:45,78,20,58,0,0,0
2022-07-17 22:00,79,22,57,0,0,0
2022-07-17 22:15,74,20,54,0,0,0
2022-07-17 22:30,52,20,32,0,0,0
2022-07-17 22:45,62,11,51,0,0,0
2022-07-17 23:00,72,22,50,0,0,0
2022-07-17 23:15,60,18,42,0,0,0
2022-07-17 23:30,52,15,37,0,0,0
2022-07-17 23:45,21,5,16,0,0,0
2022-07-18 00:00,17,7,10,0,0,0
2022-07-18 00:15,22,6,16,0,0,0
2022-07-18 00:30,15,9,6,0,0,0
2022-07-18 00:45,6,2,4,0,0,0
2022-07-18 01:00,10,1,9,0,0,0
2022-07-18 01:15,7,0,7,0,0,0
2022-07-18 01:30,20,7,13,0,0,0
2022-07-18 01:45,7,2,5,0,0,0
2022-07-18 02:00,7,4,3,0,0,0
2022-07-18 02:15,7,2,5,0,0,0
2022-07-18 02:30,1,0,1,0,0,0
2022-07-18 02:45,5,1,4,0,0,0
2022-07-18 03:00,4,1,3,0,0,0
2022-07-18 03:15,4,4,0,0,0,0
2022-07-18 03:30,3,2,1,0,0,0
2022-07-18 03:45,2,1,1,0,0,0
2022-07-18 04:00,5,4,1,0,0,0
2022-07-18 04:15,4,1,3,0,0,0
2022-07-18 04:30,8,3,5,0,0,0
2022-07-18 04:45,9,7,2,0,0,0
2022-07-18 05:00,15,8,7,0,0,0
2022-07-18 05:15,10,9,1,0,0,0
2022-07-18 05:30,22,16,6,0,0,0
2022-07-18 05:45,24,16,8,0,0,0
2022-07-18 06:00,34,27,7,0,0,0
2022-07-18 06:15,31,15,16,0,0,0
2022-07-18 06:30,60,38,22,0,0,0
2022-07-18 06:45,96,59,37,0,0,0
2022-07-18 07:00,89,60,29,0,0,0
2022-07-18 07:15,99,54,45,0,0,0
2022-07-18 07:30,165,103,62,0,0,0
2022-07-18 07:45,241,157,84,0,0,0
2022-07-18 08:00,201,135,66,0,0,0
2022-07-18 08:15,194,124,70,0,0,0
2022-07-18 08:30,194,110,84,0,0,0
2022-07-18 08:45,202,124,78,0,0,0
2022-07-18 09:00,156,97,59,0,0,0
2022-07-18 09:15,132,76,56,0,0,0
2022-07-18 09:30,158,92,66,0,0,0
2022-07-18 09:45,174,99,75,0,0,0
2022-07-18 10:00,140,71,69,0,0,0
2022-07-18 10:15,134,59,75,0,0,0
2022-07-18 10:30,118,61,57,0,0,0
2022-07-18 10:45,137,63,74,0,0,0
2022-07-18 11:00,132,67,65,0,0,0
2022-07-18 11:15,158,71,87,0,0,0
2022-07-18 11:30,182,85,97,0,0,0
2022-07-18 11:45,150,83,67,0,0,0
2022-07-18 12:00,161,89,72,0,0,0
2022-07-18 12:15,155,85,70,0,0,0
2022-07-18 12:30,170,105,65,0,0,0
2022-07-18 12:45,179,93,86,0,0,0
2022-07-18 13:00,162,82,80,0,0,0
2022-07-18 13:15,155,69,86,0,0,0
2022-07-18 13:30,184,93,91,0,0,0
2022-07-18 13:45,173,84,89,0,0,0
2022-07-18 14:00,178,111,67,0,0,0
2022-07-18 14:15,171,90,81,0,0,0
2022-07-18 14:30,184,100,84,0,0,0
2022-07-18 14:45,211,119,92,0,0,0
2022-07-18 15:00,178,80,98,0,0,0
2022-07-18 15:15,172,88,84,0,0,0
2022-07-18 15:30,201,98,103,0,0,0
2022-07-18 15:45,200,107,93,0,0,0
2022-07-18 16:00,224,99,125,0,0,0
2022-07-18 16:15,182,96,86,0,0,0
2022-07-18 16:30,236,107,129,0,0,0
2022-07-18 16:45,231,121,110,0,0,0
2022-07-18 17:00,248,111,137,0,0,0
2022-07-18 17:15,229,119,110,0,0,0
2022-07-18 17:30,266,127,139,0,0,0
2022-07-18 17:45,250,129,121,0,0,0
2022-07-18 18:00,261,122,139,0,0,0
2022-07-18 18:15,225,125,100,0,0,0
2022-07-18 18:30,218,107,111,0,0,0
2022-07-18 18:45,224,122,102,0,0,0
2022-07-18 19:00,163,84,79,0,0,0
2022-07-18 19:15,199,89,110,0,0,0
2022-07-18 19:30,186,87,99,0,0,0
2022-07-18 19:45,196,110,86,0,0,0
2022-07-18 20:00,189,78,111,0,0,0
2022-07-18 20:15,194,84,110,0,0,0
2022-07-18 20:30,139,69,70,0,0,0
2022-07-18 20:45,112,57,55,0,0,0
2022-07-18 21:00,113,56,57,0,0,0
2022-07-18 21:15,154,51,103,0,0,0
2022-07-18 21:30,131,48,83,0,0,0
2022-07-18 21:45,146,56,90,0,0,0
2022-07-18 22:00,127,45,82,0,0,0
2022-07-18 22:15,77,23,54,0,0,0
2022-07-18 22:30,84,14,70,0,0,0
2022-07-18 22:45,72,18,54,0,0,0
2022-07-18 23:00,88,21,67,0,0,0
2022-07-18 23:15,90,24,66,0,0,0
2022-07-18 23:30,48,8,40,0,0,0
2022-07-18 23:45,41,7,34,0,0,0
2022-07-19 00:00,36,9,27,0,0,0
2022-07-19 00:15,35,14,21,0,0,0
2022-07-19 00:30,21,7,14,0,0,0
2022-07-19 00:45,31,5,26,0,0,0
2022-07-19 01:00,27,6,21,0,0,0
2022-07-19 01:15,33,7,26,0,0,0
2022-07-19 01:30,16,7,9,0,0,0
2022-07-19 01:45,10,2,8,0,0,0
2022-07-19 02:00,9,6,3,0,0,0
2022-07-19 02:15,14,5,9,0,0,0
2022-07-19 02:30,3,0,3,0,0,0
2022-07-19 02:45,6,2,4,0,0,0
2022-07-19 03:00,8,0,8,0,0,0
2022-07-19 03:15,1,0,1,0,0,0
2022-07-19 03:30,1,0,1,0,0,0
2022-07-19 03:45,5,4,1,0,0,0
2022-07-19 04:00,3,1,2,0,0,0
2022-07-19 04:15,4,2,2,0,0,0
2022-07-19 04:30,6,4,2,0,0,0
2022-07-19 04:45,9,5,4,0,0,0
2022-07-19 05:00,8,7,1,0,0,0
2022-07-19 05:15,12,10,2,0,0,0
2022-07-19 05:30,23,16,7,0,0,0
2022-07-19 05:45,26,22,4,0,0,0
2022-07-19 06:00,40,27,13,0,0,0
2022-07-19 06:15,49,29,20,0,0,0
2022-07-19 06:30,70,43,27,0,0,0
2022-07-19 06:45,102,53,49,0,0,0
2022-07-19 07:00,103,59,44,0,0,0
2022-07-19 07:15,122,77,45,0,0,0
2022-07-19 07:30,183,110,73,0,0,0
2022-07-19 07:45,235,143,92,0,0,0
2022-07-19 08:00,190,121,69,0,0,0
2022-07-19 08:15,189,128,61,0,0,0
2022-07-19 08:30,201,137,64,0,0,0
2022-07-19 08:45,201,129,72,0,0,0
2022-07-19 09:00,171,115,56,0,0,0
2022-07-19 09:15,156,79,77,0,0,0
2022-07-19 09:30,143,81,62,0,0,0
2022-07-19 09:45,152,94,58,0,0,0
2022-07-19 10:00,125,70,55,0,0,0
2022-07-19 10:15,109,63,46,0,0,0
2022-07-19 10:30,134,73,61,0,0,0
2022-07-19 10:45,151,79,72,0,0,0
2022-07-19 11:00,124,61,63,0,0,0
2022-07-19 11:15,126,55,71,0,0,0
2022-07-19 11:30,119,51,68,0,0,0
2022-07-19 11:45,120,61,59,0,0,0
2022-07-19 12:00,154,79,75,0,0,0
2022-07-19 12:15,145,78,67,0,0,0
2022-07-19 12:30,158,80,78,0,0,0
2022-07-19 12:45,127,60,67,0,0,0
2022-07-19 13:00,152,93,59,0,0,0
2022-07-19 13:15,146,79,67,0,0,0
2022-07-19 13:30,153,80,73,0,0,0
2022-07-19 13:45,152,98,54,0,0,0
2022-07-19 14:00,170,89,81,0,0,0
2022-07-19 14:15,147,80,67,0,0,0
2022-07-19 14:30,162,75,87,0,0,0
2022-07-19 14:45,156,79,77,0,0,0
2022-07-19 15:00,147,73,74,0,0,0
2022-07-19 15:15,171,97,74,0,0,0
2022-07-19 15:30,163,88,75,0,0,0
2022-07-19 15:45,193,119,74,0,0,0
2022-07-19 16:00,188,95,93,0,0,0
2022-07-19 16:15,184,77,107,0,0,0
2022-07-19 16:30,188,93,95,0,0,0
2022-07-19 16:45,209,116,93,0,0,0
2022-07-19 17:00,181,83,98,0,0,0
2022-07-19 17:15,229,120,109,0,0,0
2022-07-19 17:30,185,102,83,0,0,0
2022-07-19 17:45,228,123,105,0,0,0
2022-07-19 18:00,224,110,114,0,0,0
2022-07-19 18:15,185,97,88,0,0,0
2022-07-19 18:30,157,80,77,0,0,0
2022-07-19 18:45,194,103,91,0,0,0
2022-07-19 19:00,146,76,70,0,0,0
2022-07-19 19:15,166,88,78,0,0,0
2022-07-19 19:30,126,71,55,0,0,0
2022-07-19 19:45,204,99,105,0,0,0
2022-07-19 20:00,182,92,90,0,0,0
2022-07-19 20:15,115,52,63,0,0,0
2022-07-19 20:30,120,51,69,0,0,0
2022-07-19 20:45,117,47,70,0,0,0
2022-07-19 21:00,143,58,85,0,0,0
2022-07-19 21:15,91,30,61,0,0,0
2022-07-19 21:30,120,45,75,0,0,0
2022-07-19 21:45,119,34,85,0,0,0
2022-07-19 22:00,104,31,73,0,0,0
2022-07-19 22:15,133,32,101,0,0,0
2022-07-19 22:30,105,31,74,0,0,0
2022-07-19 22:45,85,21,64,0,0,0
2022-07-19 23:00,70,15,55,0,0,0
2022-07-19 23:15,75,21,54,0,0,0
2022-07-19 23:30,55,10,45,0,0,0
2022-07-19 23:45,49,8,41,0,0,0
2022-07-20 00:00,46,5,41,0,0,0
2022-07-20 00:15,34,7,27,0,0,0
2022-07-20 00:30,18,4,14,0,0,0
2022-07-20 00:45,21,5,16,0,0,0
2022-07-20 01:00,34,7,27,0,0,0
2022-07-20 01:15,16,4,12,0,0,0
2022-07-20 01:30,19,1,18,0,0,0
2022-07-20 01:45,15,4,11,0,0,0
2022-07-20 02:00,13,3,10,0,0,0
2022-07-20 02:15,13,3,10,0,0,0
2022-07-20 02:30,4,1,3,0,0,0
2022-07-20 02:45,6,4,2,0,0,0
2022-07-20 03:00,6,2,4,0,0,0
2022-07-20 03:15,2,0,2,0,0,0
2022-07-20 03:30,1,0,1,0,0,0
2022-07-20 03:45,7,4,3,0,0,0
2022-07-20 04:00,3,2,1,0,0,0
2022-07-20 04:15,6,3,3,0,0,0
2022-07-20 04:30,8,1,7,0,0,0
2022-07-20 04:45,20,7,13,0,0,0
2022-07-20 05:00,11,4,7,0,0,0
2022-07-20 05:15,12,9,3,0,0,0
2022-07-20 05:30,21,15,6,0,0,0
2022-07-20 05:45,27,19,8,0,0,0
2022-07-20 06:00,37,22,15,0,0,0
2022-07-20 06:15,46,31,15,0,0,0
2022-07-20 06:30,61,37,24,0,0,0
2022-07-20 06:45,92,68,24,0,0,0
2022-07-20 07:00,83,53,30,0,0,0
2022-07-20 07:15,124,70,54,0,0,0
2022-07-20 07:30,155,96,59,0,0,0
2022-07-20 07:45,244,157,87,0,0,0
2022-07-20 08:00,188,126,62,0,0,0
2022-07-20 08:15,213,133,80,0,0,0
2022-07-20 08:30,201,136,65,0,0,0
2022-07-20 08:45,265,157,108,0,0,0
2022-07-20 09:00,148,89,59,0,0,0
2022-07-20 09:15,150,87,63,0,0,0
2022-07-20 09:30,159,91,68,0,0,0
2022-07-20 09:45,182,118,64,0,0,0
2022-07-20 10:00,107,63,44,0,0,0
2022-07-20 10:15,150,92,58,0,0,0
2022-07-20 10:30,130,68,62,0,0,0
2022-07-20 10:45,128,76,52,0,0,0
2022-07-20 11:00,132,64,68,0,0,0
2022-07-20 11:15,135,67,68,0,0,0
2022-07-20 11:30,156,77,79,0,0,0
2022-07-20 11:45,166,98,68,0,0,0
2022-07-20 12:00,155,85,70,0,0,0
2022-07-20 12:15,152,96,56,0,0,0
2022-07-20 12:30,160,74,86,0,0,0
2022-07-20 12:45,143,77,66,0,0,0
2022-07-20 13:00,155,54,101,0,0,0
2022-07-20 13:15,142,78,64,0,0,0
2022-07-20 13:30,177,111,66,0,0,0
2022-07-20 13:45,180,92,88,0,0,0
2022-07-20 14:00,149,79,70,0,0,0
2022-07-20 14:15,128,60,68,0,0,0
2022-07-20 14:30,152,56,96,0,0,0
2022-07-20 14:45,159,71,88,0,0,0
2022-07-20 15:00,162,70,92,0,0,0
2022-07-20 15:15,167,79,88,0,0,0
2022-07-20 15:30,180,72,108,0,0,0
2022-07-20 15:45,180,94,86,0,0,0
2022-07-20 16:00,218,108,110,0,0,0
2022-07-20 16:15,195,96,99,0,0,0
2022-07-20 16:30,218,107,111,0,0,0
2022-07-20 16:45,263,123,140,0,0,0
2022-07-20 17:00,199,88,111,0,0,0
2022-07-20 17:15,208,103,105,0,0,0
2022-07-20 17:30,224,113,111,0,0,0
2022-07-20 17:45,268,123,145,0,0,0
2022-07-20 18:00,222,102,120,0,0,0
2022-07-20 18:15,200,88,112,0,0,0
2022-07-20 18:30,243,109,134,0,0,0
2022-07-20 18:45,221,90,131,0,0,0
2022-07-20 19:00,188,77,111,0,0,0
2022-07-20 19:15,227,105,122,0,0,0
2022-07-20 19:30,169,79,90,0,0,0
2022-07-20 19:45,182,90,92,0,0,0
2022-07-20 20:00,149,68,81,0,0,0
2022-07-20 20:15,101,36,65,0,0,0
2022-07-20 20:30,94,46,48,0,0,0
2022-07-20 20:45,102,53,49,0,0,0
2022-07-20 21:00,102,40,62,0,0,0
2022-07-20 21:15,113,40,73,0,0,0
2022-07-20 21:30,178,114,64,0,0,0
2022-07-20 21:45,148,41,107,0,0,0
2022-07-20 22:00,81,37,44,0,0,0
2022-07-20 22:15,67,26,41,0,0,0
2022-07-20 22:30,64,17,47,0,0,0
2022-07-20 22:45,54,26,28,0,0,0
2022-07-20 23:00,70,39,31,0,0,0
2022-07-20 23:15,59,25,34,0,0,0
2022-07-20 23:30,52,27,25,0,0,0
2022-07-20 23:45,55,35,20,0,0,0
2022-07-21 00:00,40,22,18,0,0,0
2022-07-21 00:15,34,17,17,0,0,0
2022-07-21 00:30,41,18,23,0,0,0
2022-07-21 00:45,44,13,31,0,0,0
2022-07-21 01:00,35,9,26,0,0,0
2022-07-21 01:15,28,8,20,0,0,0
2022-07-21 01:30,31,9,22,0,0,0
2022-07-21 01:45,23,3,20,0,0,0
2022-07-21 02:00,16,4,12,0,0,0
2022-07-21 02:15,21,5,16,0,0,0
2022-07-21 02:30,6,2,4,0,0,0
2022-07-21 02:45,26,8,18,0,0,0
2022-07-21 03:00,17,11,6,0,0,0
2022-07-21 03:15,12,6,6,0,0,0
2022-07-21 03:30,13,7,6,0,0,0
2022-07-21 03:45,12,6,6,0,0,0
2022-07-21 04:00,10,5,5,0,0,0
2022-07-21 04:15,5,3,2,0,0,0
2022-07-21 04:30,7,2,5,0,0,0
2022-07-21 04:45,13,6,7,0,0,0
2022-07-21 05:00,6,3,3,0,0,0
2022-07-21 05:15,11,8,3,0,0,0
2022-07-21 05:30,9,7,2,0,0,0
2022-07-21 05:45,12,4,8,0,0,0
2022-07-21 06:00,13,7,6,0,0,0
2022-07-21 06:15,34,20,14,0,0,0
2022-07-21 06:30,35,21,14,0,0,0
2022-07-21 06:45,51,26,25,0,0,0
2022-07-21 07:00,67,46,21,0,0,0
2022-07-21 07:15,88,55,33,0,0,0
2022-07-21 07:30,132,78,54,0,0,0
2022-07-21 07:45,163,100,63,0,0,0
2022-07-21 08:00,133,88,45,0,0,0
2022-07-21 08:15,146,83,63,0,0,0
2022-07-21 08:30,129,86,43,0,0,0
2022-07-21 08:45,180,99,81,0,0,0
2022-07-21 09:00,120,71,49,0,0,0
2022-07-21 09:15,122,64,58,0,0,0
2022-07-21 09:30,109,59,50,0,0,0
2022-07-21 09:45,142,92,50,0,0,0
2022-07-21 10:00,112,66,46,0,0,0
2022-07-21 10:15,83,47,36,0,0,0
2022-07-21 10:30,89,60,29,0,0,0
2022-07-21 10:45,117,67,50,0,0,0
2022-07-21 11:00,99,48,51,0,0,0
2022-07-21 11:15,109,53,56,0,0,0
2022-07-21 11:30,116,56,60,0,0,0
2022-07-21 11:45,118,69,49,0,0,0
2022-07-21 12:00,120,76,44,0,0,0
2022-07-21 12:15,126,71,55,0,0,0
2022-07-21 12:30,125,66,59,0,0,0
2022-07-21 12:45,153,89,64,0,0,0
2022-07-21 13:00,138,66,72,0,0,0
2022-07-21 13:15,152,62,90,0,0,0
2022-07-21 13:30,159,99,60,0,0,0
2022-07-21 13:45,155,105,50,0,0,0
2022-07-21 14:00,138,72,66,0,0,0
2022-07-21 14:15,122,74,48,0,0,0
2022-07-21 14:30,162,104,58,0,0,0
2022-07-21 14:45,141,58,83,0,0,0
2022-07-21 15:00,139,59,80,0,0,0
2022-07-21 15:15,156,73,83,0,0,0
2022-07-21 15:30,154,87,67,0,0,0
2022-07-21 15:45,135,67,68,0,0,0
2022-07-21 16:00,185,100,85,0,0,0
2022-07-21 16:15,149,63,86,0,0,0
2022-07-21 16:30,172,86,86,0,0,0
2022-07-21 16:45,181,88,93,0,0,0
2022-07-21 17:00,201,97,104,0,0,0
2022-07-21 17:15,173,78,95,0,0,0
2022-07-21 17:30,191,89,102,0,0,0
2022-07-21 17:45,226,111,115,0,0,0
2022-07-21 18:00,226,105,121,0,0,0
2022-07-21 18:15,198,76,122,0,0,0
2022-07-21 18:30,163,76,87,0,0,0
2022-07-21 18:45,165,78,87,0,0,0
2022-07-21 19:00,146,59,87,0,0,0
2022-07-21 19:15,155,77,78,0,0,0
2022-07-21 19:30,122,67,55,0,0,0
2022-07-21 19:45,139,83,56,0,0,0
2022-07-21 20:00,122,55,67,0,0,0
2022-07-21 20:15,95,44,51,0,0,0
2022-07-21 20:30,92,45,47,0,0,0
2022-07-21 20:45,109,56,53,0,0,0
2022-07-21 21:00,88,42,46,0,0,0
2022-07-21 21:15,72,34,38,0,0,0
2022-07-21 21:30,69,25,44,0,0,0
2022-07-21 21:45,94,30,64,0,0,0
2022-07-21 22:00,66,27,39,0,0,0
2022-07-21 22:15,71,23,48,0,0,0
2022-07-21 22:30,58,19,39,0,0,0
2022-07-21 22:45,72,25,47,0,0,0
2022-07-21 23:00,49,19,30,0,0,0
2022-07-21 23:15,49,22,27,0,0,0
2022-07-21 23:30,38,12,26,0,0,0
2022-07-21 23:45,74,15,59,0,0,0
2022-07-22 00:00,36,9,27,0,0,0
2022-07-22 00:15,31,8,23,0,0,0
2022-07-22 00:30,35,12,23,0,0,0
2022-07-22 00:45,21,4,17,0,0,0
2022-07-22 01:00,22,5,17,0,0,0
2022-07-22 01:15,12,2,10,0,0,0
2022-07-22 01:30,19,5,14,0,0,0
2022-07-22 01:45,17,7,10,0,0,0
2022-07-22 02:00,25,10,15,0,0,0
2022-07-22 02:15,9,1,8,0,0,0
2022-07-22 02:30,3,0,3,0,0,0
2022-07-22 02:45,8,1,7,0,0,0
2022-07-22 03:00,4,2,2,0,0,0
2022-07-22 03:15,11,0,11,0,0,0
2022-07-22 03:30,5,3,2,0,0,0
2022-07-22 03:45,10,7,3,0,0,0
2022-07-22 04:00,7,3,4,0,0,0
2022-07-22 04:15,7,1,6,0,0,0
2022-07-22 04:30,8,3,5,0,0,0
2022-07-22 04:45,10,3,7,0,0,0
2022-07-22 05:00,10,9,1,0,0,0
2022-07-22 05:15,13,8,5,0,0,0
2022-07-22 05:30,16,10,6,0,0,0
2022-07-22 05:45,27,16,11,0,0,0
2022-07-22 06:00,32,19,13,0,0,0
2022-07-22 06:15,33,21,12,0,0,0
2022-07-22 06:30,45,27,18,0,0,0
2022-07-22 06:45,91,66,25,0,0,0
2022-07-22 07:00,68,40,28,0,0,0
2022-07-22 07:15,81,48,33,0,0,0
2022-07-22 07:30,124,76,48,0,0,0
2022-07-22 07:45,206,132,74,0,0,0
2022-07-22 08:00,129,88,41,0,0,0
2022-07-22 08:15,115,62,53,0,0,0
2022-07-22 08:30,127,73,54,0,0,0
2022-07-22 08:45,156,97,59,0,0,0
2022-07-22 09:00,127,73,54,0,0,0
2022-07-22 09:15,127,76,51,0,0,0
2022-07-22 09:30,123,62,61,0,0,0
2022-07-22 09:45,130,77,53,0,0,0
2022-07-22 10:00,95,70,25,0,0,0
2022-07-22 10:15,132,75,57,0,0,0
2022-07-22 10:30,94,41,53,0,0,0
2022-07-22 10:45,158,92,66,0,0,0
2022-07-22 11:00,123,67,56,0,0,0
2022-07-22 11:15,158,82,76,0,0,0
2022-07-22 11:30,147,85,62,0,0,0
2022-07-22 11:45,169,85,84,0,0,0
2022-07-22 12:00,139,75,64,0,0,0
2022-07-22 12:15,138,73,65,0,0,0
2022-07-22 12:30,157,70,87,0,0,0
2022-07-22 12:45,158,77,81,0,0,0
2022-07-22 13:00,148,77,71,0,0,0
2022-07-22 13:15,178,88,90,0,0,0
2022-07-22 13:30,148,80,68,0,0,0
2022-07-22 13:45,174,102,72,0,0,0
2022-07-22 14:00,166,92,74,0,0,0
2022-07-22 14:15,162,82,80,0,0,0
2022-07-22 14:30,172,82,90,0,0,0
2022-07-22 14:45,185,108,77,0,0,0
2022-07-22 15:00,190,95,95,0,0,0
2022-07-22 15:15,159,81,78,0,0,0
2022-07-22 15:30,174,86,88,0,0,0
2022-07-22 15:45,165,90,75,0,0,0
2022-07-22 16:00,176,83,93,0,0,0
2022-07-22 16:15,153,74,79,0,0,0
2022-07-22 16:30,151,60,91,0,0,0
2022-07-22 16:45,205,103,102,0,0,0
2022-07-22 17:00,183,91,92,0,0,0
2022-07-22 17:15,199,98,101,0,0,0
2022-07-22 17:30,180,95,85,0,0,0
2022-07-22 17:45,211,118,93,0,0,0
2022-07-22 18:00,209,83,126,0,0,0
2022-07-22 18:15,200,106,94,0,0,0
2022-07-22 18:30,162,74,88,0,0,0
2022-07-22 18:45,177,107,70,0,0,0
2022-07-22 19:00,159,71,88,0,0,0
2022-07-22 19:15,189,102,87,0,0,0
2022-07-22 19:30,153,81,72,0,0,0
2022-07-22 19:45,189,112,77,0,0,0
2022-07-22 20:00,151,90,61,0,0,0
2022-07-22 20:15,150,80,70,0,0,0
2022-07-22 20:30,135,61,74,0,0,0
2022-07-22 20:45,115,68,47,0,0,0
2022-07-22 21:00,121,65,56,0,0,0
2022-07-22 21:15,84,39,45,0,0,0
2022-07-22 21:30,116,63,53,0,0,0
2022-07-22 21:45,81,38,43,0,0,0
2022-07-22 22:00,85,31,54,0,0,0
2022-07-22 22:15,94,44,50,0,0,0
2022-07-22 22:30,91,43,48,0,0,0
2022-07-22 22:45,80,36,44,0,0,0
2022-07-22 23:00,50,9,41,0,0,0
2022-07-22 23:15,69,27,42,0,0,0
2022-07-22 23:30,65,33,32,0,0,0
2022-07-22 23:45,69,28,41,0,0,0
2022-07-23 00:00,82,34,48,0,0,0
2022-07-23 00:15,120,44,76,0,0,0
2022-07-23 00:30,169,48,121,0,0,0
2022-07-23 00:45,69,12,57,0,0,0
2022-07-23 01:00,54,20,34,0,0,0
2022-07-23 01:15,48,16,32,0,0,0
2022-07-23 01:30,46,16,30,0,0,0
2022-07-23 01:45,33,6,27,0,0,0
2022-07-23 02:00,44,9,35,0,0,0
2022-07-23 02:15,27,9,18,0,0,0
2022-07-23 02:30,18,5,13,0,0,0
2022-07-23 02:45,35,9,26,0,0,0
2022-07-23 03:00,36,12,24,0,0,0
2022-07-23 03:15,25,5,20,0,0,0
2022-07-23 03:30,33,6,27,0,0,0
2022-07-23 03:45,39,17,22,0,0,0
2022-07-23 04:00,32,2,30,0,0,0
2022-07-23 04:15,22,13,9,0,0,0
2022-07-23 04:30,14,3,11,0,0,0
2022-07-23 04:45,7,2,5,0,0,0
2022-07-23 05:00,9,2,7,0,0,0
2022-07-23 05:15,18,6,12,0,0,0
2022-07-23 05:30,14,10,4,0,0,0
2022-07-23 05:45,13,6,7,0,0,0
2022-07-23 06:00,10,4,6,0,0,0
2022-07-23 06:15,20,9,11,0,0,0
2022-07-23 06:30,14,11,3,0,0,0
2022-07-23 06:45,20,10,10,0,0,0
2022-07-23 07:00,14,11,3,0,0,0
2022-07-23 07:15,19,9,10,0,0,0
2022-07-23 07:30,37,28,9,0,0,0
2022-07-23 07:45,46,38,8,0,0,0
2022-07-23 08:00,50,39,11,0,0,0
2022-07-23 08:15,31,18,13,0,0,0
2022-07-23 08:30,65,48,17,0,0,0
2022-07-23 08:45,71,42,29,0,0,0
2022-07-23 09:00,36,33,3,0,0,0
2022-07-23 09:15,72,53,19,0,0,0
2022-07-23 09:30,67,58,9,0,0,0
2022-07-23 09:45,134,96,38,0,0,0
2022-07-23 10:00,92,58,34,0,0,0
2022-07-23 10:15,100,68,32,0,0,0
2022-07-23 10:30,131,88,43,0,0,0
2022-07-23 10:45,139,104,35,0,0,0
2022-07-23 11:00,142,91,51,0,0,0
2022-07-23 11:15,119,93,26,0,0,0
2022-07-23 11:30,142,87,55,0,0,0
2022-07-23 11:45,167,100,67,0,0,0
2022-07-23 12:00,154,103,51,0,0,0
2022-07-23 12:15,166,101,65,0,0,0
2022-07-23 12:30,140,90,50,0,0,0
2022-07-23 12:45,181,122,59,0,0,0
2022-07-23 13:00,160,120,40,0,0,0
2022-07-23 13:15,179,101,78,0,0,0
2022-07-23 13:30,174,108,66,0,0,0
2022-07-23 13:45,149,71,78,0,0,0
2022-07-23 14:00,145,79,66,0,0,0
2022-07-23 14:15,130,62,68,0,0,0
2022-07-23 14:30,128,63,65,0,0,0
2022-07-23 14:45,160,71,89,0,0,0
2022-07-23 15:00,154,74,80,0,0,0
2022-07-23 15:15,124,46,78,0,0,0
2022-07-23 15:30,123,62,61,0,0,0
2022-07-23 15:45,134,61,73,0,0,0
2022-07-23 16:00,142,61,81,0,0,0
2022-07-23 16:15,150,61,89,0,0,0
2022-07-23 16:30,140,57,83,0,0,0
2022-07-23 16:45,132,64,68,0,0,0
2022-07-23 17:00,143,83,60,0,0,0
2022-07-23 17:15,125,62,63,0,0,0
2022-07-23 17:30,145,63,82,0,0,0
2022-07-23 17:45,146,70,76,0,0,0
2022-07-23 18:00,162,76,86,0,0,0
2022-07-23 18:15,175,73,102,0,0,0
2022-07-23 18:30,140,74,66,0,0,0
2022-07-23 18:45,139,67,72,0,0,0
2022-07-23 19:00,139,59,80,0,0,0
2022-07-23 19:15,142,60,82,0,0,0
2022-07-23 19:30,138,74,64,0,0,0
2022-07-23 19:45,163,86,77,0,0,0
2022-07-23 20:00,140,74,66,0,0,0
2022-07-23 20:15,124,61,63,0,0,0
2022-07-23 20:30,113,49,64,0,0,0
2022-07-23 20:45,104,53,51,0,0,0
2022-07-23 21:00,115,50,65,0,0,0
2022-07-23 21:15,77,38,39,0,0,0
2022-07-23 21:30,85,32,53,0,0,0
2022-07-23 21:45,88,46,42,0,0,0
2022-07-23 22:00,104,53,51,0,0,0
2022-07-23 22:15,79,27,52,0,0,0
2022-07-23 22:30,91,41,50,0,0,0
2022-07-23 22:45,65,21,44,0,0,0
2022-07-23 23:00,58,17,41,0,0,0
2022-07-23 23:15,73,20,53,0,0,0
2022-07-23 23:30,65,25,40,0,0,0
2022-07-23 23:45,67,32,35,0,0,0
2022-07-24 00:00,49,22,27,0,0,0
2022-07-24 00:15,58,29,29,0,0,0
2022-07-24 00:30,127,18,109,0,0,0
2022-07-24 00:45,56,19,37,0,0,0
2022-07-24 01:00,52,24,28,0,0,0
2022-07-24 01:15,57,26,31,0,0,0
2022-07-24 01:30,43,17,26,0,0,0
2022-07-24 01:45,48,24,24,0,0,0
2022-07-24 02:00,42,20,22,0,0,0
2022-07-24 02:15,40,8,32,0,0,0
2022-07-24 02:30,28,12,16,0,0,0
2022-07-24 02:45,36,9,27,0,0,0
2022-07-24 03:00,29,6,23,0,0,0
2022-07-24 03:15,23,9,14,0,0,0
2022-07-24 03:30,20,7,13,0,0,0
2022-07-24 03:45,16,3,13,0,0,0
2022-07-24 04:00,25,5,20,0,0,0
2022-07-24 04:15,16,3,13,0,0,0
2022-07-24 04:30,22,7,15,0,0,0
2022-07-24 04:45,9,2,7,0,0,0
2022-07-24 05:00,13,3,10,0,0,0
2022-07-24 05:15,13,3,10,0,0,0
2022-07-24 05:30,6,3,3,0,0,0
2022-07-24 05:45,8,6,2,0,0,0
2022-07-24 06:00,11,6,5,0,0,0
2022-07-24 06:15,11,4,7,0,0,0
2022-07-24 06:30,8,3,5,0,0,0
2022-07-24 06:45,8,5,3,0,0,0
2022-07-24 07:00,15,8,7,0,0,0
2022-07-24 07:15,12,7,5,0,0,0
2022-07-24 07:30,17,6,11,0,0,0
2022-07-24 07:45,18,13,5,0,0,0
2022-07-24 08:00,25,17,8,0,0,0
2022-07-24 08:15,30,17,13,0,0,0
2022-07-24 08:30,24,13,11,0,0,0
2022-07-24 08:45,30,18,12,0,0,0
2022-07-24 09:00,31,16,15,0,0,0
2022-07-24 09:15,52,35,17,0,0,0
2022-07-24 09:30,64,38,26,0,0,0
2022-07-24 09:45,67,38,29,0,0,0
2022-07-24 10:00,67,52,15,0,0,0
2022-07-24 10:15,76,42,34,0,0,0
2022-07-24 10:30,66,34,32,0,0,0
2022-07-24 10:45,96,54,42,0,0,0
2022-07-24 11:00,85,46,39,0,0,0
2022-07-24 11:15,98,53,45,0,0,0
2022-07-24 11:30,90,59,31,0,0,0
2022-07-24 11:45,102,58,44,0,0,0
2022-07-24 12:00,71,41,30,0,0,0
2022-07-24 12:15,107,57,50,0,0,0
2022-07-24 12:30,110,54,56,0,0,0
2022-07-24 12:45,120,67,53,0,0,0
2022-07-24 13:00,85,48,37,0,0,0
2022-07-24 13:15,88,49,39,0,0,0
2022-07-24 13:30,128,70,58,0,0,0
2022-07-24 13:45,117,71,46,0,0,0
2022-07-24 14:00,123,66,57,0,0,0
2022-07-24 14:15,103,62,41,0,0,0
2022-07-24 14:30,102,64,38,0,0,0
2022-07-24 14:45,112,63,49,0,0,0
2022-07-24 15:00,112,59,53,0,0,0
2022-07-24 15:15,109,66,43,0,0,0
2022-07-24 15:30,157,88,69,0,0,0
2022-07-24 15:45,159,93,66,0,0,0
2022-07-24 16:00,120,74,46,0,0,0
2022-07-24 16:15,114,60,54,0,0,0
2022-07-24 16:30,96,48,48,0,0,0
2022-07-24 16:45,111,61,50,0,0,0
2022-07-24 17:00,129,60,69,0,0,0
2022-07-24 17:15,131,54,77,0,0,0
2022-07-24 17:30,109,62,47,0,0,0
2022-07-24 17:45,125,63,62,0,0,0
2022-07-24 18:00,125,48,77,0,0,0
2022-07-24 18:15,133,65,68,0,0,0
2022-07-24 18:30,121,60,61,0,0,0
2022-07-24 18:45,169,91,78,0,0,0
2022-07-24 19:00,118,56,62,0,0,0
2022-07-24 19:15,117,56,61,0,0,0
2022-07-24 19:30,111,65,46,0,0,0
2022-07-24 19:45,144,70,74,0,0,0
2022-07-24 20:00,137,64,73,0,0,0
2022-07-24 20:15,100,46,54,0,0,0
2022-07-24 20:30,119,39,80,0,0,0
2022-07-24 20:45,90,27,63,0,0,0
2022-07-24 21:00,100,33,67,0,0,0
2022-07-24 21:15,76,21,55,0,0,0
2022-07-24 21:30,80,33,47,0,0,0
2022-07-24 21:45,63,23,40,0,0,0
2022-07-24 22:00,82,28,54,0,0,0
2022-07-24 22:15,57,22,35,0,0,0
2022-07-24 22:30,55,22,33,0,0,0
2022-07-24 22:45,55,13,42,0,0,0
2022-07-24 23:00,45,10,35,0,0,0
2022-07-24 23:15,28,8,20,0,0,0
2022-07-24 23:30,33,11,22,0,0,0
2022-07-24 23:45,25,14,11,0,0,0
2022-07-25 00:00,23,10,13,0,0,0
2022-07-25 00:15,38,9,29,0,0,0
2022-07-25 00:30,19,6,13,0,0,0
2022-07-25 00:45,15,5,10,0,0,0
2022-07-25 01:00,13,2,11,0,0,0
2022-07-25 01:15,18,10,8,0,0,0
2022-07-25 01:30,6,4,2,0,0,0
2022-07-25 01:45,10,3,7,0,0,0
2022-07-25 02:00,15,5,10,0,0,0
2022-07-25 02:15,9,5,4,0,0,0
2022-07-25 02:30,2,2,0,0,0,0
2022-07-25 02:45,13,4,9,0,0,0
2022-07-25 03:00,12,1,11,0,0,0
2022-07-25 03:15,6,4,2,0,0,0
2022-07-25 03:30,8,3,5,0,0,0
2022-07-25 03:45,8,2,6,0,0,0
2022-07-25 04:00,13,1,12,0,0,0
2022-07-25 04:15,9,3,6,0,0,0
2022-07-25 04:30,12,6,6,0,0,0
2022-07-25 04:45,13,9,4,0,0,0
2022-07-25 05:00,12,4,8,0,0,0
2022-07-25 05:15,15,10,5,0,0,0
2022-07-25 05:30,21,16,5,0,0,0
2022-07-25 05:45,28,17,11,0,0,0
2022-07-25 06:00,31,23,8,0,0,0
2022-07-25 06:15,38,26,12,0,0,0
2022-07-25 06:30,67,47,20,0,0,0
2022-07-25 06:45,88,56,32,0,0,0
2022-07-25 07:00,88,53,35,0,0,0
2022-07-25 07:15,105,68,37,0,0,0
2022-07-25 07:30,134,78,56,0,0,0
2022-07-25 07:45,182,115,67,0,0,0
2022-07-25 08:00,181,132,49,0,0,0
2022-07-25 08:15,183,114,69,0,0,0
2022-07-25 08:30,151,86,65,0,0,0
2022-07-25 08:45,199,115,84,0,0,0
2022-07-25 09:00,127,74,53,0,0,0
2022-07-25 09:15,112,60,52,0,0,0
2022-07-25 09:30,130,69,61,0,0,0
2022-07-25 09:45,152,84,68,0,0,0
2022-07-25 10:00,141,67,74,0,0,0
2022-07-25 10:15,129,78,51,0,0,0
2022-07-25 10:30,114,54,60,0,0,0
2022-07-25 10:45,131,67,64,0,0,0
2022-07-25 11:00,109,52,57,0,0,0
2022-07-25 11:15,114,68,46,0,0,0
2022-07-25 11:30,117,70,47,0,0,0
2022-07-25 11:45,128,86,42,0,0,0
2022-07-25 12:00,122,63,59,0,0,0
2022-07-25 12:15,136,77,59,0,0,0
2022-07-25 12:30,141,85,56,0,0,0
2022-07-25 12:45,172,93,79,0,0,0
2022-07-25 13:00,180,82,98,0,0,0
2022-07-25 13:15,148,65,83,0,0,0
2022-07-25 13:30,136,70,66,0,0,0
2022-07-25 13:45,155,75,80,0,0,0
2022-07-25 14:00,140,57,83,0,0,0
2022-07-25 14:15,127,64,63,0,0,0
2022-07-25 14:30,120,58,62,0,0,0
2022-07-25 14:45,163,85,78,0,0,0
2022-07-25 15:00,132,81,51,0,0,0
2022-07-25 15:15,170,92,78,0,0,0
2022-07-25 15:30,139,64,75,0,0,0
2022-07-25 15:45,190,94,96,0,0,0
2022-07-25 16:00,205,88,117,0,0,0
2022-07-25 16:15,195,107,88,0,0,0
2022-07-25 16:30,191,97,94,0,0,0
2022-07-25 16:45,232,107,125,0,0,0
2022-07-25 17:00,241,117,124,0,0,0
2022-07-25 17:15,223,97,126,0,0,0
2022-07-25 17:30,209,105,104,0,0,0
2022-07-25 17:45,234,130,104,0,0,0
2022-07-25 18:00,185,65,120,0,0,0
2022-07-25 18:15,177,70,107,0,0,0
2022-07-25 18:30,196,90,106,0,0,0
2022-07-25 18:45,201,110,91,0,0,0
2022-07-25 19:00,174,88,86,0,0,0
2022-07-25 19:15,172,77,95,0,0,0
2022-07-25 19:30,134,68,66,0,0,0
2022-07-25 19:45,143,84,59,0,0,0
2022-07-25 20:00,139,72,67,0,0,0
2022-07-25 20:15,126,64,62,0,0,0
2022-07-25 20:30,102,44,58,0,0,0
2022-07-25 20:45,87,37,50,0,0,0
2022-07-25 21:00,86,52,34,0,0,0
2022-07-25 21:15,80,39,41,0,0,0
2022-07-25 21:30,82,23,59,0,0,0
2022-07-25 21:45,82,31,51,0,0,0
2022-07-25 22:00,84,38,46,0,0,0
2022-07-25 22:15,82,38,44,0,0,0
2022-07-25 22:30,57,22,35,0,0,0
2022-07-25 22:45,63,16,47,0,0,0
2022-07-25 23:00,49,19,30,0,0,0
2022-07-25 23:15,53,13,40,0,0,0
2022-07-25 23:30,61,11,50,0,0,0
2022-07-25 23:45,56,11,45,0,0,0
2022-07-26 00:00,29,3,26,0,0,0
2022-07-26 00:15,24,9,15,0,0,0
2022-07-26 00:30,20,9,11,0,0,0
2022-07-26 00:45,24,11,13,0,0,0
2022-07-26 01:00,18,6,12,0,0,0
2022-07-26 01:15,9,5,4,0,0,0
2022-07-26 01:30,11,1,10,0,0,0
2022-07-26 01:45,9,1,8,0,0,0
2022-07-26 02:00,10,1,9,0,0,0
2022-07-26 02:15,4,2,2,0,0,0
2022-07-26 02:30,3,1,2,0,0,0
2022-07-26 02:45,13,3,10,0,0,0
2022-07-26 03:00,4,1,3,0,0,0
2022-07-26 03:15,9,6,3,0,0,0
2022-07-26 03:30,3,3,0,0,0,0
2022-07-26 03:45,3,3,0,0,0,0
2022-07-26 04:00,5,3,2,0,0,0
2022-07-26 04:15,6,1,5,0,0,0
2022-07-26 04:30,4,3,1,0,0,0
2022-07-26 04:45,9,7,2,0,0,0
2022-07-26 05:00,8,8,0,0,0,0
2022-07-26 05:15,5,3,2,0,0,0
2022-07-26 05:30,19,11,8,0,0,0
2022-07-26 05:45,27,15,12,0,0,0
2022-07-26 06:00,41,28,13,0,0,0
2022-07-26 06:15,45,31,14,0,0,0
2022-07-26 06:30,49,28,21,0,0,0
2022-07-26 06:45,68,47,21,0,0,0
2022-07-26 07:00,73,41,32,0,0,0
2022-07-26 07:15,93,51,42,0,0,0
2022-07-26 07:30,144,81,63,0,0,0
2022-07-26 07:45,193,113,80,0,0,0
2022-07-26 08:00,182,113,69,0,0,0
2022-07-26 08:15,156,87,69,0,0,0
2022-07-26 08:30,179,104,75,0,0,0
2022-07-26 08:45,194,115,79,0,0,0
2022-07-26 09:00,133,94,39,0,0,0
2022-07-26 09:15,121,74,47,0,0,0
2022-07-26 09:30,118,69,49,0,0,0
2022-07-26 09:45,155,91,64,0,0,0
2022-07-26 10:00,114,53,61,0,0,0
2022-07-26 10:15,113,55,58,0,0,0
2022-07-26 10:30,84,52,32,0,0,0
2022-07-26 10:45,78,39,39,0,0,0
2022-07-26 11:00,50,15,35,0,0,0
2022-07-26 11:15,70,28,42,0,0,0
2022-07-26 11:30,94,59,35,0,0,0
2022-07-26 11:45,103,59,44,0,0,0
2022-07-26 12:00,72,41,31,0,0,0
2022-07-26 12:15,63,33,30,0,0,0
2022-07-26 12:30,109,62,47,0,0,0
2022-07-26 12:45,88,50,38,0,0,0
2022-07-26 13:00,118,61,57,0,0,0
2022-07-26 13:15,122,48,74,0,0,0
2022-07-26 13:30,89,48,41,0,0,0
2022-07-26 13:45,145,83,62,0,0,0
2022-07-26 14:00,130,77,53,0,0,0
2022-07-26 14:15,163,94,69,0,0,0
2022-07-26 14:30,77,46,31,0,0,0
2022-07-26 14:45,110,57,53,0,0,0
2022-07-26 15:00,108,41,67,0,0,0
2022-07-26 15:15,127,56,71,0,0,0
2022-07-26 15:30,140,69,71,0,0,0
2022-07-26 15:45,157,71,86,0,0,0
2022-07-26 16:00,187,90,97,0,0,0
2022-07-26 16:15,197,77,120,0,0,0
2022-07-26 16:30,210,94,116,0,0,0
2022-07-26 16:45,208,92,116,0,0,0
2022-07-26 17:00,190,93,97,0,0,0
2022-07-26 17:15,230,101,129,0,0,0
2022-07-26 17:30,204,94,110,0,0,0
2022-07-26 17:45,205,101,104,0,0,0
2022-07-26 18:00,180,79,101,0,0,0
2022-07-26 18:15,207,105,102,0,0,0
2022-07-26 18:30,197,89,108,0,0,0
2022-07-26 18:45,187,99,88,0,0,0
2022-07-26 19:00,162,76,86,0,0,0
2022-07-26 19:15,163,97,66,0,0,0
2022-07-26 19:30,133,71,62,0,0,0
2022-07-26 19:45,131,71,60,0,0,0
2022-07-26 20:00,140,72,68,0,0,0
2022-07-26 20:15,109,45,64,0,0,0
2022-07-26 20:30,103,55,48,0,0,0
2022-07-26 20:45,84,37,47,0,0,0
2022-07-26 21:00,90,48,42,0,0,0
2022-07-26 21:15,80,40,40,0,0,0
2022-07-26 21:30,79,32,47,0,0,0
2022-07-26 21:45,86,36,50,0,0,0
2022-07-26 22:00,68,21,47,0,0,0
2022-07-26 22:15,68,26,42,0,0,0
2022-07-26 22:30,66,21,45,0,0,0
2022-07-26 22:45,42,10,32,0,0,0
2022-07-26 23:00,42,11,31,0,0,0
2022-07-26 23:15,45,20,25,0,0,0
2022-07-26 23:30,53,11,42,0,0,0
2022-07-26 23:45,50,8,42,0,0,0
2022-07-27 00:00,48,7,41,0,0,0
2022-07-27 00:15,29,9,20,0,0,0
2022-07-27 00:30,19,2,17,0,0,0
2022-07-27 00:45,19,6,13,0,0,0
2022-07-27 01:00,21,10,11,0,0,0
2022-07-27 01:15,16,2,14,0,0,0
2022-07-27 01:30,13,5,8,0,0,0
2022-07-27 01:45,11,5,6,0,0,0
2022-07-27 02:00,11,6,5,0,0,0
2022-07-27 02:15,3,1,2,0,0,0
2022-07-27 02:30,7,4,3,0,0,0
2022-07-27 02:45,5,5,0,0,0,0
2022-07-27 03:00,6,1,5,0,0,0
2022-07-27 03:15,6,3,3,0,0,0
2022-07-27 03:30,4,2,2,0,0,0
2022-07-27 03:45,5,3,2,0,0,0
2022-07-27 04:00,3,1,2,0,0,0
2022-07-27 04:15,9,5,4,0,0,0
2022-07-27 04:30,5,2,3,0,0,0
2022-07-27 04:45,11,8,3,0,0,0
2022-07-27 05:00,6,5,1,0,0,0
2022-07-27 05:15,9,5,4,0,0,0
2022-07-27 05:30,21,16,5,0,0,0
2022-07-27 05:45,25,14,11,0,0,0
2022-07-27 06:00,36,23,13,0,0,0
2022-07-27 06:15,40,30,10,0,0,0
2022-07-27 06:30,61,40,21,0,0,0
2022-07-27 06:45,71,50,21,0,0,0
2022-07-27 07:00,74,47,27,0,0,0
2022-07-27 07:15,66,59,7,0,0,0
2022-07-27 07:30,121,71,50,0,0,0
2022-07-27 07:45,171,101,70,0,0,0
2022-07-27 08:00,145,93,52,0,0,0
2022-07-27 08:15,175,103,72,0,0,0
2022-07-27 08:30,172,111,61,0,0,0
2022-07-27 08:45,200,127,73,0,0,0
2022-07-27 09:00,143,79,64,0,0,0
2022-07-27 09:15,137,92,45,0,0,0
2022-07-27 09:30,148,104,44,0,0,0
2022-07-27 09:45,189,121,68,0,0,0
2022-07-27 10:00,155,85,70,0,0,0
2022-07-27 10:15,136,70,66,0,0,0
2022-07-27 10:30,142,80,62,0,0,0
2022-07-27 10:45,170,113,57,0,0,0
2022-07-27 11:00,114,60,54,0,0,0
2022-07-27 11:15,123,62,61,0,0,0
2022-07-27 11:30,145,78,67,0,0,0
2022-07-27 11:45,163,92,71,0,0,0
2022-07-27 12:00,170,70,100,0,0,0
2022-07-27 12:15,146,80,66,0,0,0
2022-07-27 12:30,184,97,87,0,0,0
2022-07-27 12:45,183,94,89,0,0,0
2022-07-27 13:00,197,95,102,0,0,0
2022-07-27 13:15,159,86,73,0,0,0
2022-07-27 13:30,181,102,79,0,0,0
2022-07-27 13:45,167,98,69,0,0,0
2022-07-27 14:00,176,73,103,0,0,0
2022-07-27 14:15,167,77,90,0,0,0
2022-07-27 14:30,163,70,93,0,0,0
2022-07-27 14:45,185,77,108,0,0,0
2022-07-27 15:00,145,69,76,0,0,0
2022-07-27 15:15,154,65,89,0,0,0
2022-07-27 15:30,164,76,88,0,0,0
2022-07-27 15:45,192,89,103,0,0,0
2022-07-27 16:00,215,89,126,0,0,0
2022-07-27 16:15,208,97,111,0,0,0
2022-07-27 16:30,209,102,107,0,0,0
2022-07-27 16:45,239,123,116,0,0,0
2022-07-27 17:00,227,98,129,0,0,0
2022-07-27 17:15,258,118,140,0,0,0
2022-07-27 17:30,240,114,126,0,0,0
2022-07-27 17:45,228,107,121,0,0,0
2022-07-27 18:00,207,110,97,0,0,0
2022-07-27 18:15,228,103,125,0,0,0
2022-07-27 18:30,210,93,117,0,0,0
2022-07-27 18:45,255,135,120,0,0,0
2022-07-27 19:00,210,95,115,0,0,0
2022-07-27 19:15,204,90,114,0,0,0
2022-07-27 19:30,165,88,77,0,0,0
2022-07-27 19:45,145,82,63,0,0,0
2022-07-27 20:00,174,83,91,0,0,0
2022-07-27 20:15,170,69,101,0,0,0
2022-07-27 20:30,153,89,64,0,0,0
2022-07-27 20:45,140,63,77,0,0,0
2022-07-27 21:00,128,48,80,0,0,0
2022-07-27 21:15,97,47,50,0,0,0
2022-07-27 21:30,107,48,59,0,0,0
2022-07-27 21:45,95,30,65,0,0,0
2022-07-27 22:00,89,38,51,0,0,0
2022-07-27 22:15,97,44,53,0,0,0
2022-07-27 22:30,74,30,44,0,0,0
2022-07-27 22:45,72,34,38,0,0,0
2022-07-27 23:00,96,40,56,0,0,0
2022-07-27 23:15,104,40,64,0,0,0
2022-07-27 23:30,74,30,44,0,0,0
2022-07-27 23:45,70,33,37,0,0,0
2022-07-28 00:00,89,40,49,0,0,0
2022-07-28 00:15,64,13,51,0,0,0
2022-07-28 00:30,28,6,22,0,0,0
2022-07-28 00:45,25,9,16,0,0,0
2022-07-28 01:00,39,15,24,0,0,0
2022-07-28 01:15,37,8,29,0,0,0
2022-07-28 01:30,24,11,13,0,0,0
2022-07-28 01:45,35,13,22,0,0,0
2022-07-28 02:00,31,9,22,0,0,0
2022-07-28 02:15,26,8,18,0,0,0
2022-07-28 02:30,15,1,14,0,0,0
2022-07-28 02:45,25,2,23,0,0,0
2022-07-28 03:00,19,3,16,0,0,0
2022-07-28 03:15,17,3,14,0,0,0
2022-07-28 03:30,21,4,17,0,0,0
2022-07-28 03:45,10,4,6,0,0,0
2022-07-28 04:00,11,3,8,0,0,0
2022-07-28 04:15,12,3,9,0,0,0
2022-07-28 04:30,13,1,12,0,0,0
2022-07-28 04:45,13,6,7,0,0,0
2022-07-28 05:00,14,8,6,0,0,0
2022-07-28 05:15,8,7,1,0,0,0
2022-07-28 05:30,27,15,12,0,0,0
2022-07-28 05:45,27,20,7,0,0,0
2022-07-28 06:00,29,20,9,0,0,0
2022-07-28 06:15,39,21,18,0,0,0
2022-07-28 06:30,60,36,24,0,0,0
2022-07-28 06:45,82,51,31,0,0,0
2022-07-28 07:00,76,49,27,0,0,0
2022-07-28 07:15,85,50,35,0,0,0
2022-07-28 07:30,118,54,64,0,0,0
2022-07-28 07:45,191,111,80,0,0,0
2022-07-28 08:00,164,109,55,0,0,0
2022-07-28 08:15,146,89,57,0,0,0
2022-07-28 08:30,145,86,59,0,0,0
2022-07-28 08:45,168,100,68,0,0,0
2022-07-28 09:00,149,90,59,0,0,0
2022-07-28 09:15,134,78,56,0,0,0
2022-07-28 09:30,148,89,59,0,0,0
2022-07-28 09:45,140,103,37,0,0,0
2022-07-28 10:00,114,64,50,0,0,0
2022-07-28 10:15,108,59,49,0,0,0
2022-07-28 10:30,130,79,51,0,0,0
2022-07-28 10:45,133,72,61,0,0,0
2022-07-28 11:00,139,76,63,0,0,0
2022-07-28 11:15,116,69,47,0,0,0
2022-07-28 11:30,118,64,54,0,0,0
2022-07-28 11:45,126,65,61,0,0,0
2022-07-28 12:00,151,80,71,0,0,0
2022-07-28 12:15,161,88,73,0,0,0
2022-07-28 12:30,133,82,51,0,0,0
2022-07-28 12:45,172,90,82,0,0,0
2022-07-28 13:00,154,71,83,0,0,0
2022-07-28 13:15,134,74,60,0,0,0
2022-07-28 13:30,152,86,66,0,0,0
2022-07-28 13:45,157,87,70,0,0,0
2022-07-28 14:00,158,92,66,0,0,0
2022-07-28 14:15,189,87,102,0,0,0
2022-07-28 14:30,155,76,79,0,0,0
2022-07-28 14:45,186,93,93,0,0,0
2022-07-28 15:00,178,92,86,0,0,0
2022-07-28 15:15,175,97,78,0,0,0
2022-07-28 15:30,167,99,68,0,0,0
2022-07-28 15:45,230,110,120,0,0,0
2022-07-28 16:00,174,66,108,0,0,0
2022-07-28 16:15,213,96,117,0,0,0
2022-07-28 16:30,215,85,130,0,0,0
2022-07-28 16:45,209,98,111,0,0,0
2022-07-28 17:00,237,115,122,0,0,0
2022-07-28 17:15,214,106,108,0,0,0
2022-07-28 17:30,232,107,125,0,0,0
2022-07-28 17:45,207,100,107,0,0,0
2022-07-28 18:00,260,120,140,0,0,0
2022-07-28 18:15,232,82,150,0,0,0
2022-07-28 18:30,225,100,125,0,0,0
2022-07-28 18:45,243,120,123,0,0,0
2022-07-28 19:00,169,88,81,0,0,0
2022-07-28 19:15,154,73,81,0,0,0
2022-07-28 19:30,162,99,63,0,0,0
2022-07-28 19:45,203,117,86,0,0,0
2022-07-28 20:00,147,80,67,0,0,0
2022-07-28 20:15,135,56,79,0,0,0
2022-07-28 20:30,118,70,48,0,0,0
2022-07-28 20:45,87,45,42,0,0,0
2022-07-28 21:00,91,51,40,0,0,0
2022-07-28 21:15,92,38,54,0,0,0
2022-07-28 21:30,83,49,34,0,0,0
2022-07-28 21:45,89,36,53,0,0,0
2022-07-28 22:00,98,41,57,0,0,0
2022-07-28 22:15,79,26,53,0,0,0
2022-07-28 22:30,87,19,68,0,0,0
2022-07-28 22:45,70,27,43,0,0,0
2022-07-28 23:00,42,14,28,0,0,0
2022-07-28 23:15,48,16,32,0,0,0
2022-07-28 23:30,53,19,34,0,0,0
2022-07-28 23:45,47,14,33,0,0,0
2022-07-29 00:00,87,9,78,0,0,0
2022-07-29 00:15,60,14,46,0,0,0
2022-07-29 00:30,19,4,15,0,0,0
2022-07-29 00:45,21,5,16,0,0,0
2022-07-29 01:00,20,7,13,0,0,0
2022-07-29 01:15,16,2,14,0,0,0
2022-07-29 01:30,23,10,13,0,0,0
2022-07-29 01:45,20,7,13,0,0,0
2022-07-29 02:00,12,1,11,0,0,0
2022-07-29 02:15,6,1,5,0,0,0
2022-07-29 02:30,3,1,2,0,0,0
2022-07-29 02:45,5,4,1,0,0,0
2022-07-29 03:00,7,0,7,0,0,0
2022-07-29 03:15,4,0,4,0,0,0
2022-07-29 03:30,5,1,4,0,0,0
2022-07-29 03:45,3,3,0,0,0,0
2022-07-29 04:00,4,1,3,0,0,0
2022-07-29 04:15,8,1,7,0,0,0
2022-07-29 04:30,4,0,4,0,0,0
2022-07-29 04:45,12,7,5,0,0,0
2022-07-29 05:00,8,5,3,0,0,0
2022-07-29 05:15,10,7,3,0,0,0
2022-07-29 05:30,18,11,7,0,0,0
2022-07-29 05:45,25,14,11,0,0,0
2022-07-29 06:00,25,15,10,0,0,0
2022-07-29 06:15,28,15,13,0,0,0
2022-07-29 06:30,54,28,26,0,0,0
2022-07-29 06:45,85,61,24,0,0,0
2022-07-29 07:00,63,46,17,0,0,0
2022-07-29 07:15,75,40,35,0,0,0
2022-07-29 07:30,110,69,41,0,0,0
2022-07-29 07:45,205,152,53,0,0,0
2022-07-29 08:00,127,88,39,0,0,0
2022-07-29 08:15,118,75,43,0,0,0
2022-07-29 08:30,119,62,57,0,0,0
2022-07-29 08:45,150,78,72,0,0,0
2022-07-29 09:00,116,66,50,0,0,0
2022-07-29 09:15,110,75,35,0,0,0
2022-07-29 09:30,107,75,32,0,0,0
2022-07-29 09:45,115,82,33,0,0,0
2022-07-29 10:00,78,69,9,0,0,0
2022-07-29 10:15,106,70,36,0,0,0
2022-07-29 10:30,106,62,44,0,0,0
2022-07-29 10:45,141,51,90,0,0,0
2022-07-29 11:00,118,54,64,0,0,0
2022-07-29 11:15,129,72,57,0,0,0
2022-07-29 11:30,123,62,61,0,0,0
2022-07-29 11:45,142,73,69,0,0,0
2022-07-29 12:00,129,56,73,0,0,0
2022-07-29 12:15,143,78,65,0,0,0
2022-07-29 12:30,155,73,82,0,0,0
2022-07-29 12:45,97,78,19,0,0,0
2022-07-29 13:00,173,66,107,0,0,0
2022-07-29 13:15,129,67,62,0,0,0
2022-07-29 13:30,121,63,58,0,0,0
2022-07-29 13:45,129,78,51,0,0,0
2022-07-29 14:00,127,71,56,0,0,0
2022-07-29 14:15,175,84,91,0,0,0
2022-07-29 14:30,174,98,76,0,0,0
2022-07-29 14:45,153,79,74,0,0,0
2022-07-29 15:00,132,74,58,0,0,0
2022-07-29 15:15,150,74,76,0,0,0
2022-07-29 15:30,130,51,79,0,0,0
2022-07-29 15:45,157,77,80,0,0,0
2022-07-29 16:00,194,88,106,0,0,0
2022-07-29 16:15,168,90,78,0,0,0
2022-07-29 16:30,195,102,93,0,0,0
2022-07-29 16:45,176,110,66,0,0,0
2022-07-29 17:00,168,84,84,0,0,0
2022-07-29 17:15,154,88,66,0,0,0
2022-07-29 17:30,187,96,91,0,0,0
2022-07-29 17:45,193,111,82,0,0,0
2022-07-29 18:00,206,108,98,0,0,0
2022-07-29 18:15,186,85,101,0,0,0
2022-07-29 18:30,174,94,80,0,0,0
2022-07-29 18:45,171,108,63,0,0,0
2022-07-29 19:00,184,105,79,0,0,0
2022-07-29 19:15,154,88,66,0,0,0
2022-07-29 19:30,162,93,69,0,0,0
2022-07-29 19:45,167,96,71,0,0,0
2022-07-29 20:00,175,101,74,0,0,0
2022-07-29 20:15,151,99,52,0,0,0
2022-07-29 20:30,112,57,55,0,0,0
2022-07-29 20:45,113,61,52,0,0,0
2022-07-29 21:00,138,58,80,0,0,0
2022-07-29 21:15,85,42,43,0,0,0
2022-07-29 21:30,87,52,35,0,0,0
2022-07-29 21:45,87,34,53,0,0,0
2022-07-29 22:00,82,28,54,0,0,0
2022-07-29 22:15,88,25,63,0,0,0
2022-07-29 22:30,75,22,53,0,0,0
2022-07-29 22:45,96,34,62,0,0,0
2022-07-29 23:00,60,20,40,0,0,0
2022-07-29 23:15,79,25,54,0,0,0
2022-07-29 23:30,81,19,62,0,0,0
2022-07-29 23:45,78,26,52,0,0,0
2022-07-30 00:00,110,21,89,0,0,0
2022-07-30 00:15,92,6,86,0,0,0
2022-07-30 00:30,47,13,34,0,0,0
2022-07-30 00:45,41,16,25,0,0,0
2022-07-30 01:00,56,14,42,0,0,0
2022-07-30 01:15,34,12,22,0,0,0
2022-07-30 01:30,74,15,59,0,0,0
2022-07-30 01:45,52,20,32,0,0,0
2022-07-30 02:00,50,14,36,0,0,0
2022-07-30 02:15,50,20,30,0,0,0
2022-07-30 02:30,15,7,8,0,0,0
2022-07-30 02:45,33,15,18,0,0,0
2022-07-30 03:00,33,7,26,0,0,0
2022-07-30 03:15,15,5,10,0,0,0
2022-07-30 03:30,18,6,12,0,0,0
2022-07-30 03:45,19,3,16,0,0,0
2022-07-30 04:00,27,13,14,0,0,0
2022-07-30 04:15,11,7,4,0,0,0
2022-07-30 04:30,14,2,12,0,0,0
2022-07-30 04:45,27,10,17,0,0,0
2022-07-30 05:00,18,7,11,0,0,0
2022-07-30 05:15,14,5,9,0,0,0
2022-07-30 05:30,24,13,11,0,0,0
2022-07-30 05:45,17,10,7,0,0,0
2022-07-30 06:00,14,7,7,0,0,0
2022-07-30 06:15,16,8,8,0,0,0
2022-07-30 06:30,18,8,10,0,0,0
2022-07-30 06:45,8,6,2,0,0,0
2022-07-30 07:00,11,10,1,0,0,0
2022-07-30 07:15,22,15,7,0,0,0
2022-07-30 07:30,22,19,3,0,0,0
2022-07-30 07:45,42,25,17,0,0,0
2022-07-30 08:00,19,14,5,0,0,0
2022-07-30 08:15,42,30,12,0,0,0
2022-07-30 08:30,47,29,18,0,0,0
2022-07-30 08:45,46,32,14,0,0,0
2022-07-30 09:00,52,32,20,0,0,0
2022-07-30 09:15,74,54,20,0,0,0
2022-07-30 09:30,79,58,21,0,0,0
2022-07-30 09:45,128,84,44,0,0,0
2022-07-30 10:00,129,93,36,0,0,0
2022-07-30 10:15,142,100,42,0,0,0
2022-07-30 10:30,142,78,64,0,0,0
2022-07-30 10:45,149,95,54,0,0,0
2022-07-30 11:00,141,107,34,0,0,0
2022-07-30 11:15,135,84,51,0,0,0
2022-07-30 11:30,125,72,53,0,0,0
2022-07-30 11:45,181,123,58,0,0,0
2022-07-30 12:00,135,87,48,0,0,0
2022-07-30 12:15,181,106,75,0,0,0
2022-07-30 12:30,137,70,67,0,0,0
2022-07-30 12:45,162,88,74,0,0,0
2022-07-30 13:00,181,96,85,0,0,0
2022-07-30 13:15,151,93,58,0,0,0
2022-07-30 13:30,165,95,70,0,0,0
2022-07-30 13:45,171,97,74,0,0,0
2022-07-30 14:00,146,67,79,0,0,0
2022-07-30 14:15,150,66,84,0,0,0
2022-07-30 14:30,157,68,89,0,0,0
2022-07-30 14:45,173,86,87,0,0,0
2022-07-30 15:00,137,57,80,0,0,0
2022-07-30 15:15,126,67,59,0,0,0
2022-07-30 15:30,138,51,87,0,0,0
2022-07-30 15:45,137,78,59,0,0,0
2022-07-30 16:00,147,74,73,0,0,0
2022-07-30 16:15,150,70,80,0,0,0
2022-07-30 16:30,145,74,71,0,0,0
2022-07-30 16:45,155,87,68,0,0,0
2022-07-30 17:00,161,69,92,0,0,0
2022-07-30 17:15,155,85,70,0,0,0
2022-07-30 17:30,164,95,69,0,0,0
2022-07-30 17:45,169,92,77,0,0,0
2022-07-30 18:00,179,91,88,0,0,0
2022-07-30 18:15,157,73,84,0,0,0
2022-07-30 18:30,132,63,69,0,0,0
2022-07-30 18:45,157,89,68,0,0,0
2022-07-30 19:00,153,84,69,0,0,0
2022-07-30 19:15,160,95,65,0,0,0
2022-07-30 19:30,163,83,80,0,0,0
2022-07-30 19:45,172,80,92,0,0,0
2022-07-30 20:00,165,79,86,0,0,0
2022-07-30 20:15,130,81,49,0,0,0
2022-07-30 20:30,132,68,64,0,0,0
2022-07-30 20:45,101,46,55,0,0,0
2022-07-30 21:00,102,61,41,0,0,0
2022-07-30 21:15,94,44,50,0,0,0
2022-07-30 21:30,114,39,75,0,0,0
2022-07-30 21:45,85,36,49,0,0,0
2022-07-30 22:00,84,37,47,0,0,0
2022-07-30 22:15,78,21,57,0,0,0
2022-07-30 22:30,60,20,40,0,0,0
2022-07-30 22:45,73,36,37,0,0,0
2022-07-30 23:00,60,17,43,0,0,0
2022-07-30 23:15,78,34,44,0,0,0
2022-07-30 23:30,56,23,33,0,0,0
2022-07-30 23:45,66,25,41,0,0,0
