Datetime,100034983 (Warendorfer Straße),101034983 (Warendorfer Straße stadteinwärts),102034983 (Warendorfer Straße stadtauswärts),100034983-status,101034983-status,102034983-status
2019-02-01 00:00,10,5,5,0,0,0
2019-02-01 00:15,7,4,3,0,0,0
2019-02-01 00:30,5,4,1,0,0,0
2019-02-01 00:45,12,7,5,0,0,0
2019-02-01 01:00,9,3,6,0,0,0
2019-02-01 01:15,4,1,3,0,0,0
2019-02-01 01:30,3,0,3,0,0,0
2019-02-01 01:45,5,3,2,0,0,0
2019-02-01 02:00,6,3,3,0,0,0
2019-02-01 02:15,3,0,3,0,0,0
2019-02-01 02:30,3,2,1,0,0,0
2019-02-01 02:45,1,0,1,0,0,0
2019-02-01 03:00,2,2,0,0,0,0
2019-02-01 03:15,1,1,0,0,0,0
2019-02-01 03:30,2,2,0,0,0,0
2019-02-01 03:45,1,1,0,0,0,0
2019-02-01 04:00,2,0,2,0,0,0
2019-02-01 04:15,2,2,0,0,0,0
2019-02-01 04:30,1,0,1,0,0,0
2019-02-01 04:45,0,0,0,0,0,0
2019-02-01 05:00,0,0,0,0,0,0
2019-02-01 05:15,2,2,0,0,0,0
2019-02-01 05:30,12,8,4,0,0,0
2019-02-01 05:45,18,11,7,0,0,0
2019-02-01 06:00,11,5,6,0,0,0
2019-02-01 06:15,27,16,11,0,0,0
2019-02-01 06:30,38,26,12,0,0,0
2019-02-01 06:45,51,30,21,0,0,0
2019-02-01 07:00,60,38,22,0,0,0
2019-02-01 07:15,106,81,25,0,0,0
2019-02-01 07:30,250,204,46,0,0,0
2019-02-01 07:45,186,124,62,0,0,0
2019-02-01 08:00,120,82,38,0,0,0
2019-02-01 08:15,105,70,35,0,0,0
2019-02-01 08:30,100,71,29,0,0,0
2019-02-01 08:45,130,89,41,0,0,0
2019-02-01 09:00,78,54,24,0,0,0
2019-02-01 09:15,65,50,15,0,0,0
2019-02-01 09:30,89,64,25,0,0,0
2019-02-01 09:45,94,72,22,0,0,0
2019-02-01 10:00,73,62,11,0,0,0
2019-02-01 10:15,64,30,34,0,0,0
2019-02-01 10:30,49,32,17,0,0,0
2019-02-01 10:45,42,32,10,0,0,0
2019-02-01 11:00,65,39,26,0,0,0
2019-02-01 11:15,78,44,34,0,0,0
2019-02-01 11:30,68,50,18,0,0,0
2019-02-01 11:45,65,49,16,0,0,0
2019-02-01 12:00,72,50,22,0,0,0
2019-02-01 12:15,84,44,40,0,0,0
2019-02-01 12:30,90,42,48,0,0,0
2019-02-01 12:45,116,66,50,0,0,0
2019-02-01 13:00,99,45,54,0,0,0
2019-02-01 13:15,111,42,69,0,0,0
2019-02-01 13:30,66,12,54,0,0,0
2019-02-01 13:45,67,14,53,0,0,0
2019-02-01 14:00,115,37,78,0,0,0
2019-02-01 14:15,114,70,44,0,0,0
2019-02-01 14:30,104,48,56,0,0,0
2019-02-01 14:45,108,52,56,0,0,0
2019-02-01 15:00,131,67,64,0,0,0
2019-02-01 15:15,110,58,52,0,0,0
2019-02-01 15:30,121,71,50,0,0,0
2019-02-01 15:45,110,67,43,0,0,0
2019-02-01 16:00,105,51,54,0,0,0
2019-02-01 16:15,110,65,45,0,0,0
2019-02-01 16:30,125,71,54,0,0,0
2019-02-01 16:45,127,71,56,0,0,0
2019-02-01 17:00,120,55,65,0,0,0
2019-02-01 17:15,121,63,58,0,0,0
2019-02-01 17:30,109,53,56,0,0,0
2019-02-01 17:45,131,68,63,0,0,0
2019-02-01 18:00,101,48,53,0,0,0
2019-02-01 18:15,94,57,37,0,0,0
2019-02-01 18:30,72,31,41,0,0,0
2019-02-01 18:45,76,33,43,0,0,0
2019-02-01 19:00,98,47,51,0,0,0
2019-02-01 19:15,117,69,48,0,0,0
2019-02-01 19:30,106,67,39,0,0,0
2019-02-01 19:45,100,50,50,0,0,0
2019-02-01 20:00,68,42,26,0,0,0
2019-02-01 20:15,60,29,31,0,0,0
2019-02-01 20:30,54,26,28,0,0,0
2019-02-01 20:45,28,12,16,0,0,0
2019-02-01 21:00,44,23,21,0,0,0
2019-02-01 21:15,44,24,20,0,0,0
2019-02-01 21:30,47,25,22,0,0,0
2019-02-01 21:45,41,18,23,0,0,0
2019-02-01 22:00,56,35,21,0,0,0
2019-02-01 22:15,54,30,24,0,0,0
2019-02-01 22:30,32,15,17,0,0,0
2019-02-01 22:45,37,14,23,0,0,0
2019-02-01 23:00,23,9,14,0,0,0
2019-02-01 23:15,21,13,8,0,0,0
2019-02-01 23:30,36,14,22,0,0,0
2019-02-01 23:45,21,10,11,0,0,0
2019-02-02 00:00,30,16,14,0,0,0
2019-02-02 00:15,41,25,16,0,0,0
2019-02-02 00:30,21,6,15,0,0,0
2019-02-02 00:45,23,14,9,0,0,0
2019-02-02 01:00,17,7,10,0,0,0
2019-02-02 01:15,16,6,10,0,0,0
2019-02-02 01:30,16,8,8,0,0,0
2019-02-02 01:45,14,3,11,0,0,0
2019-02-02 02:00,14,6,8,0,0,0
2019-02-02 02:15,17,6,11,0,0,0
2019-02-02 02:30,14,6,8,0,0,0
2019-02-02 02:45,9,2,7,0,0,0
2019-02-02 03:00,7,4,3,0,0,0
2019-02-02 03:15,9,1,8,0,0,0
2019-02-02 03:30,4,1,3,0,0,0
2019-02-02 03:45,2,0,2,0,0,0
2019-02-02 04:00,2,0,2,0,0,0
2019-02-02 04:15,7,3,4,0,0,0
2019-02-02 04:30,10,2,8,0,0,0
2019-02-02 04:45,7,4,3,0,0,0
2019-02-02 05:00,5,2,3,0,0,0
2019-02-02 05:15,4,2,2,0,0,0
2019-02-02 05:30,6,4,2,0,0,0
2019-02-02 05:45,5,2,3,0,0,0
2019-02-02 06:00,7,6,1,0,0,0
2019-02-02 06:15,3,2,1,0,0,0
2019-02-02 06:30,5,4,1,0,0,0
2019-02-02 06:45,15,7,8,0,0,0
2019-02-02 07:00,6,6,0,0,0,0
2019-02-02 07:15,9,7,2,0,0,0
2019-02-02 07:30,20,12,8,0,0,0
2019-02-02 07:45,33,29,4,0,0,0
2019-02-02 08:00,35,28,7,0,0,0
2019-02-02 08:15,20,16,4,0,0,0
2019-02-02 08:30,29,20,9,0,0,0
2019-02-02 08:45,55,36,19,0,0,0
2019-02-02 09:00,36,33,3,0,0,0
2019-02-02 09:15,54,46,8,0,0,0
2019-02-02 09:30,57,37,20,0,0,0
2019-02-02 09:45,107,78,29,0,0,0
2019-02-02 10:00,62,50,12,0,0,0
2019-02-02 10:15,75,56,19,0,0,0
2019-02-02 10:30,93,79,14,0,0,0
2019-02-02 10:45,100,77,23,0,0,0
2019-02-02 11:00,86,67,19,0,0,0
2019-02-02 11:15,112,81,31,0,0,0
2019-02-02 11:30,112,84,28,0,0,0
2019-02-02 11:45,130,98,32,0,0,0
2019-02-02 12:00,94,64,30,0,0,0
2019-02-02 12:15,126,72,54,0,0,0
2019-02-02 12:30,85,48,37,0,0,0
2019-02-02 12:45,106,62,44,0,0,0
2019-02-02 13:00,91,57,34,0,0,0
2019-02-02 13:15,118,66,52,0,0,0
2019-02-02 13:30,102,61,41,0,0,0
2019-02-02 13:45,83,38,45,0,0,0
2019-02-02 14:00,100,49,51,0,0,0
2019-02-02 14:15,90,49,41,0,0,0
2019-02-02 14:30,82,31,51,0,0,0
2019-02-02 14:45,65,17,48,0,0,0
2019-02-02 15:00,88,42,46,0,0,0
2019-02-02 15:15,78,40,38,0,0,0
2019-02-02 15:30,56,26,30,0,0,0
2019-02-02 15:45,58,24,34,0,0,0
2019-02-02 16:00,40,23,17,0,0,0
2019-02-02 16:15,53,29,24,0,0,0
2019-02-02 16:30,39,16,23,0,0,0
2019-02-02 16:45,53,18,35,0,0,0
2019-02-02 17:00,35,14,21,0,0,0
2019-02-02 17:15,35,8,27,0,0,0
2019-02-02 17:30,56,26,30,0,0,0
2019-02-02 17:45,60,33,27,0,0,0
2019-02-02 18:00,42,26,16,0,0,0
2019-02-02 18:15,51,24,27,0,0,0
2019-02-02 18:30,43,25,18,0,0,0
2019-02-02 18:45,52,31,21,0,0,0
2019-02-02 19:00,44,28,16,0,0,0
2019-02-02 19:15,54,29,25,0,0,0
2019-02-02 19:30,52,30,22,0,0,0
2019-02-02 19:45,58,42,16,0,0,0
2019-02-02 20:00,35,18,17,0,0,0
2019-02-02 20:15,46,23,23,0,0,0
2019-02-02 20:30,37,18,19,0,0,0
2019-02-02 20:45,27,18,9,0,0,0
2019-02-02 21:00,35,26,9,0,0,0
2019-02-02 21:15,22,10,12,0,0,0
2019-02-02 21:30,18,9,9,0,0,0
2019-02-02 21:45,17,6,11,0,0,0
2019-02-02 22:00,31,15,16,0,0,0
2019-02-02 22:15,25,16,9,0,0,0
2019-02-02 22:30,19,13,6,0,0,0
2019-02-02 22:45,21,13,8,0,0,0
2019-02-02 23:00,21,7,14,0,0,0
2019-02-02 23:15,26,14,12,0,0,0
2019-02-02 23:30,25,8,17,0,0,0
2019-02-02 23:45,16,6,10,0,0,0
2019-02-03 00:00,15,6,9,0,0,0
2019-02-03 00:15,23,10,13,0,0,0
2019-02-03 00:30,12,9,3,0,0,0
2019-02-03 00:45,13,6,7,0,0,0
2019-02-03 01:00,23,15,8,0,0,0
2019-02-03 01:15,16,9,7,0,0,0
2019-02-03 01:30,12,4,8,0,0,0
2019-02-03 01:45,9,3,6,0,0,0
2019-02-03 02:00,12,5,7,0,0,0
2019-02-03 02:15,10,4,6,0,0,0
2019-02-03 02:30,3,1,2,0,0,0
2019-02-03 02:45,3,1,2,0,0,0
2019-02-03 03:00,6,2,4,0,0,0
2019-02-03 03:15,4,1,3,0,0,0
2019-02-03 03:30,7,4,3,0,0,0
2019-02-03 03:45,4,0,4,0,0,0
2019-02-03 04:00,8,4,4,0,0,0
2019-02-03 04:15,0,0,0,0,0,0
2019-02-03 04:30,4,1,3,0,0,0
2019-02-03 04:45,2,1,1,0,0,0
2019-02-03 05:00,5,0,5,0,0,0
2019-02-03 05:15,3,1,2,0,0,0
2019-02-03 05:30,8,2,6,0,0,0
2019-02-03 05:45,3,2,1,0,0,0
2019-02-03 06:00,2,1,1,0,0,0
2019-02-03 06:15,4,3,1,0,0,0
2019-02-03 06:30,3,2,1,0,0,0
2019-02-03 06:45,7,2,5,0,0,0
2019-02-03 07:00,2,0,2,0,0,0
2019-02-03 07:15,2,2,0,0,0,0
2019-02-03 07:30,8,6,2,0,0,0
2019-02-03 07:45,31,24,7,0,0,0
2019-02-03 08:00,5,4,1,0,0,0
2019-02-03 08:15,9,8,1,0,0,0
2019-02-03 08:30,7,5,2,0,0,0
2019-02-03 08:45,14,10,4,0,0,0
2019-02-03 09:00,20,15,5,0,0,0
2019-02-03 09:15,14,9,5,0,0,0
2019-02-03 09:30,30,20,10,0,0,0
2019-02-03 09:45,31,25,6,0,0,0
2019-02-03 10:00,29,23,6,0,0,0
2019-02-03 10:15,46,38,8,0,0,0
2019-02-03 10:30,27,18,9,0,0,0
2019-02-03 10:45,44,38,6,0,0,0
2019-02-03 11:00,39,29,10,0,0,0
2019-02-03 11:15,28,17,11,0,0,0
2019-02-03 11:30,32,17,15,0,0,0
2019-02-03 11:45,36,19,17,0,0,0
2019-02-03 12:00,45,21,24,0,0,0
2019-02-03 12:15,34,15,19,0,0,0
2019-02-03 12:30,44,33,11,0,0,0
2019-02-03 12:45,57,32,25,0,0,0
2019-02-03 13:00,52,30,22,0,0,0
2019-02-03 13:15,44,23,21,0,0,0
2019-02-03 13:30,47,25,22,0,0,0
2019-02-03 13:45,44,31,13,0,0,0
2019-02-03 14:00,55,40,15,0,0,0
2019-02-03 14:15,50,26,24,0,0,0
2019-02-03 14:30,62,38,24,0,0,0
2019-02-03 14:45,59,36,23,0,0,0
2019-02-03 15:00,63,33,30,0,0,0
2019-02-03 15:15,55,37,18,0,0,0
2019-02-03 15:30,26,15,11,0,0,0
2019-02-03 15:45,67,42,25,0,0,0
2019-02-03 16:00,41,25,16,0,0,0
2019-02-03 16:15,46,29,17,0,0,0
2019-02-03 16:30,44,27,17,0,0,0
2019-02-03 16:45,56,38,18,0,0,0
2019-02-03 17:00,50,28,22,0,0,0
2019-02-03 17:15,40,23,17,0,0,0
2019-02-03 17:30,60,37,23,0,0,0
2019-02-03 17:45,51,36,15,0,0,0
2019-02-03 18:00,38,20,18,0,0,0
2019-02-03 18:15,34,19,15,0,0,0
2019-02-03 18:30,23,15,8,0,0,0
2019-02-03 18:45,41,21,20,0,0,0
2019-02-03 19:00,33,19,14,0,0,0
2019-02-03 19:15,34,15,19,0,0,0
2019-02-03 19:30,45,29,16,0,0,0
2019-02-03 19:45,33,17,16,0,0,0
2019-02-03 20:00,34,27,7,0,0,0
2019-02-03 20:15,39,16,23,0,0,0
2019-02-03 20:30,30,11,19,0,0,0
2019-02-03 20:45,15,11,4,0,0,0
2019-02-03 21:00,26,13,13,0,0,0
2019-02-03 21:15,23,13,10,0,0,0
2019-02-03 21:30,22,9,13,0,0,0
2019-02-03 21:45,11,4,7,0,0,0
2019-02-03 22:00,29,12,17,0,0,0
2019-02-03 22:15,17,13,4,0,0,0
2019-02-03 22:30,16,9,7,0,0,0
2019-02-03 22:45,16,8,8,0,0,0
2019-02-03 23:00,16,8,8,0,0,0
2019-02-03 23:15,14,3,11,0,0,0
2019-02-03 23:30,9,6,3,0,0,0
2019-02-03 23:45,1,1,0,0,0,0
2019-02-04 00:00,8,6,2,0,0,0
2019-02-04 00:15,1,0,1,0,0,0
2019-02-04 00:30,1,1,0,0,0,0
2019-02-04 00:45,1,0,1,0,0,0
2019-02-04 01:00,1,0,1,0,0,0
2019-02-04 01:15,0,0,0,0,0,0
2019-02-04 01:30,1,0,1,0,0,0
2019-02-04 01:45,3,0,3,0,0,0
2019-02-04 02:00,2,1,1,0,0,0
2019-02-04 02:15,1,1,0,0,0,0
2019-02-04 02:30,3,1,2,0,0,0
2019-02-04 02:45,2,0,2,0,0,0
2019-02-04 03:00,2,1,1,0,0,0
2019-02-04 03:15,1,1,0,0,0,0
2019-02-04 03:30,1,1,0,0,0,0
2019-02-04 03:45,1,1,0,0,0,0
2019-02-04 04:00,8,6,2,0,0,0
2019-02-04 04:15,12,8,4,0,0,0
2019-02-04 04:30,4,2,2,0,0,0
2019-02-04 04:45,2,1,1,0,0,0
2019-02-04 05:00,4,0,4,0,0,0
2019-02-04 05:15,4,2,2,0,0,0
2019-02-04 05:30,7,5,2,0,0,0
2019-02-04 05:45,10,4,6,0,0,0
2019-02-04 06:00,8,7,1,0,0,0
2019-02-04 06:15,26,18,8,0,0,0
2019-02-04 06:30,43,27,16,0,0,0
2019-02-04 06:45,71,49,22,0,0,0
2019-02-04 07:00,80,60,20,0,0,0
2019-02-04 07:15,130,104,26,0,0,0
2019-02-04 07:30,300,260,40,0,0,0
2019-02-04 07:45,205,146,59,0,0,0
2019-02-04 08:00,126,100,26,0,0,0
2019-02-04 08:15,138,107,31,0,0,0
2019-02-04 08:30,115,83,32,0,0,0
2019-02-04 08:45,146,116,30,0,0,0
2019-02-04 09:00,91,66,25,0,0,0
2019-02-04 09:15,97,73,24,0,0,0
2019-02-04 09:30,91,67,24,0,0,0
2019-02-04 09:45,95,69,26,0,0,0
2019-02-04 10:00,85,61,24,0,0,0
2019-02-04 10:15,74,60,14,0,0,0
2019-02-04 10:30,72,59,13,0,0,0
2019-02-04 10:45,78,55,23,0,0,0
2019-02-04 11:00,78,47,31,0,0,0
2019-02-04 11:15,77,49,28,0,0,0
2019-02-04 11:30,75,56,19,0,0,0
2019-02-04 11:45,82,49,33,0,0,0
2019-02-04 12:00,87,55,32,0,0,0
2019-02-04 12:15,85,43,42,0,0,0
2019-02-04 12:30,104,46,58,0,0,0
2019-02-04 12:45,100,60,40,0,0,0
2019-02-04 13:00,97,47,50,0,0,0
2019-02-04 13:15,125,65,60,0,0,0
2019-02-04 13:30,83,41,42,0,0,0
2019-02-04 13:45,117,66,51,0,0,0
2019-02-04 14:00,127,48,79,0,0,0
2019-02-04 14:15,133,77,56,0,0,0
2019-02-04 14:30,97,57,40,0,0,0
2019-02-04 14:45,125,68,57,0,0,0
2019-02-04 15:00,126,69,57,0,0,0
2019-02-04 15:15,116,62,54,0,0,0
2019-02-04 15:30,144,80,64,0,0,0
2019-02-04 15:45,160,81,79,0,0,0
2019-02-04 16:00,125,60,65,0,0,0
2019-02-04 16:15,134,69,65,0,0,0
2019-02-04 16:30,154,87,67,0,0,0
2019-02-04 16:45,144,71,73,0,0,0
2019-02-04 17:00,142,78,64,0,0,0
2019-02-04 17:15,155,84,71,0,0,0
2019-02-04 17:30,161,74,87,0,0,0
2019-02-04 17:45,150,77,73,0,0,0
2019-02-04 18:00,151,71,80,0,0,0
2019-02-04 18:15,146,67,79,0,0,0
2019-02-04 18:30,79,27,52,0,0,0
2019-02-04 18:45,98,53,45,0,0,0
2019-02-04 19:00,85,44,41,0,0,0
2019-02-04 19:15,72,34,38,0,0,0
2019-02-04 19:30,61,31,30,0,0,0
2019-02-04 19:45,95,49,46,0,0,0
2019-02-04 20:00,61,33,28,0,0,0
2019-02-04 20:15,45,19,26,0,0,0
2019-02-04 20:30,46,26,20,0,0,0
2019-02-04 20:45,35,18,17,0,0,0
2019-02-04 21:00,27,13,14,0,0,0
2019-02-04 21:15,28,12,16,0,0,0
2019-02-04 21:30,41,17,24,0,0,0
2019-02-04 21:45,41,19,22,0,0,0
2019-02-04 22:00,30,15,15,0,0,0
2019-02-04 22:15,39,14,25,0,0,0
2019-02-04 22:30,25,15,10,0,0,0
2019-02-04 22:45,20,9,11,0,0,0
2019-02-04 23:00,17,11,6,0,0,0
2019-02-04 23:15,13,7,6,0,0,0
2019-02-04 23:30,12,7,5,0,0,0
2019-02-04 23:45,11,10,1,0,0,0
2019-02-05 00:00,12,8,4,0,0,0
2019-02-05 00:15,2,0,2,0,0,0
2019-02-05 00:30,3,0,3,0,0,0
2019-02-05 00:45,8,4,4,0,0,0
2019-02-05 01:00,1,0,1,0,0,0
2019-02-05 01:15,2,0,2,0,0,0
2019-02-05 01:30,6,2,4,0,0,0
2019-02-05 01:45,5,2,3,0,0,0
2019-02-05 02:00,1,0,1,0,0,0
2019-02-05 02:15,1,0,1,0,0,0
2019-02-05 02:30,1,0,1,0,0,0
2019-02-05 02:45,1,0,1,0,0,0
2019-02-05 03:00,1,0,1,0,0,0
2019-02-05 03:15,0,0,0,0,0,0
2019-02-05 03:30,1,0,1,0,0,0
2019-02-05 03:45,0,0,0,0,0,0
2019-02-05 04:00,1,1,0,0,0,0
2019-02-05 04:15,3,0,3,0,0,0
2019-02-05 04:30,0,0,0,0,0,0
2019-02-05 04:45,0,0,0,0,0,0
2019-02-05 05:00,0,0,0,0,0,0
2019-02-05 05:15,5,5,0,0,0,0
2019-02-05 05:30,13,9,4,0,0,0
2019-02-05 05:45,16,5,11,0,0,0
2019-02-05 06:00,13,10,3,0,0,0
2019-02-05 06:15,23,14,9,0,0,0
2019-02-05 06:30,45,36,9,0,0,0
2019-02-05 06:45,75,50,25,0,0,0
2019-02-05 07:00,85,65,20,0,0,0
2019-02-05 07:15,164,136,28,0,0,0
2019-02-05 07:30,299,255,44,0,0,0
2019-02-05 07:45,196,147,49,0,0,0
2019-02-05 08:00,167,130,37,0,0,0
2019-02-05 08:15,142,106,36,0,0,0
2019-02-05 08:30,183,142,41,0,0,0
2019-02-05 08:45,178,135,43,0,0,0
2019-02-05 09:00,95,75,20,0,0,0
2019-02-05 09:15,103,80,23,0,0,0
2019-02-05 09:30,91,68,23,0,0,0
2019-02-05 09:45,123,94,29,0,0,0
2019-02-05 10:00,57,45,12,0,0,0
2019-02-05 10:15,60,42,18,0,0,0
2019-02-05 10:30,73,55,18,0,0,0
2019-02-05 10:45,96,68,28,0,0,0
2019-02-05 11:00,79,59,20,0,0,0
2019-02-05 11:15,76,38,38,0,0,0
2019-02-05 11:30,71,45,26,0,0,0
2019-02-05 11:45,93,61,32,0,0,0
2019-02-05 12:00,93,55,38,0,0,0
2019-02-05 12:15,126,71,55,0,0,0
2019-02-05 12:30,85,44,41,0,0,0
2019-02-05 12:45,116,64,52,0,0,0
2019-02-05 13:00,138,64,74,0,0,0
2019-02-05 13:15,135,43,92,0,0,0
2019-02-05 13:30,101,53,48,0,0,0
2019-02-05 13:45,106,51,55,0,0,0
2019-02-05 14:00,138,54,84,0,0,0
2019-02-05 14:15,110,52,58,0,0,0
2019-02-05 14:30,90,46,44,0,0,0
2019-02-05 14:45,146,73,73,0,0,0
2019-02-05 15:00,115,59,56,0,0,0
2019-02-05 15:15,119,72,47,0,0,0
2019-02-05 15:30,144,82,62,0,0,0
2019-02-05 15:45,129,64,65,0,0,0
2019-02-05 16:00,143,71,72,0,0,0
2019-02-05 16:15,124,59,65,0,0,0
2019-02-05 16:30,153,91,62,0,0,0
2019-02-05 16:45,163,85,78,0,0,0
2019-02-05 17:00,156,64,92,0,0,0
2019-02-05 17:15,152,62,90,0,0,0
2019-02-05 17:30,153,70,83,0,0,0
2019-02-05 17:45,130,62,68,0,0,0
2019-02-05 18:00,138,51,87,0,0,0
2019-02-05 18:15,141,73,68,0,0,0
2019-02-05 18:30,99,48,51,0,0,0
2019-02-05 18:45,123,61,62,0,0,0
2019-02-05 19:00,106,50,56,0,0,0
2019-02-05 19:15,103,62,41,0,0,0
2019-02-05 19:30,86,56,30,0,0,0
2019-02-05 19:45,103,61,42,0,0,0
2019-02-05 20:00,64,27,37,0,0,0
2019-02-05 20:15,65,25,40,0,0,0
2019-02-05 20:30,39,18,21,0,0,0
2019-02-05 20:45,28,13,15,0,0,0
2019-02-05 21:00,47,22,25,0,0,0
2019-02-05 21:15,44,23,21,0,0,0
2019-02-05 21:30,58,26,32,0,0,0
2019-02-05 21:45,48,20,28,0,0,0
2019-02-05 22:00,45,21,24,0,0,0
2019-02-05 22:15,52,22,30,0,0,0
2019-02-05 22:30,45,12,33,0,0,0
2019-02-05 22:45,27,10,17,0,0,0
2019-02-05 23:00,28,12,16,0,0,0
2019-02-05 23:15,19,10,9,0,0,0
2019-02-05 23:30,30,14,16,0,0,0
2019-02-05 23:45,13,5,8,0,0,0
2019-02-06 00:00,11,6,5,0,0,0
2019-02-06 00:15,9,6,3,0,0,0
2019-02-06 00:30,10,6,4,0,0,0
2019-02-06 00:45,8,4,4,0,0,0
2019-02-06 01:00,6,2,4,0,0,0
2019-02-06 01:15,5,1,4,0,0,0
2019-02-06 01:30,5,1,4,0,0,0
2019-02-06 01:45,5,1,4,0,0,0
2019-02-06 02:00,0,0,0,0,0,0
2019-02-06 02:15,1,0,1,0,0,0
2019-02-06 02:30,1,0,1,0,0,0
2019-02-06 02:45,2,0,2,0,0,0
2019-02-06 03:00,1,0,1,0,0,0
2019-02-06 03:15,2,2,0,0,0,0
2019-02-06 03:30,0,0,0,0,0,0
2019-02-06 03:45,0,0,0,0,0,0
2019-02-06 04:00,3,1,2,0,0,0
2019-02-06 04:15,0,0,0,0,0,0
2019-02-06 04:30,2,2,0,0,0,0
2019-02-06 04:45,0,0,0,0,0,0
2019-02-06 05:00,0,0,0,0,0,0
2019-02-06 05:15,3,0,3,0,0,0
2019-02-06 05:30,14,12,2,0,0,0
2019-02-06 05:45,12,7,5,0,0,0
2019-02-06 06:00,9,6,3,0,0,0
2019-02-06 06:15,27,18,9,0,0,0
2019-02-06 06:30,48,27,21,0,0,0
2019-02-06 06:45,62,39,23,0,0,0
2019-02-06 07:00,77,59,18,0,0,0
2019-02-06 07:15,141,109,32,0,0,0
2019-02-06 07:30,317,262,55,0,0,0
2019-02-06 07:45,232,158,74,0,0,0
2019-02-06 08:00,166,122,44,0,0,0
2019-02-06 08:15,142,103,39,0,0,0
2019-02-06 08:30,158,113,45,0,0,0
2019-02-06 08:45,166,139,27,0,0,0
2019-02-06 09:00,98,78,20,0,0,0
2019-02-06 09:15,128,104,24,0,0,0
2019-02-06 09:30,134,110,24,0,0,0
2019-02-06 09:45,144,117,27,0,0,0
2019-02-06 10:00,89,64,25,0,0,0
2019-02-06 10:15,92,69,23,0,0,0
2019-02-06 10:30,98,62,36,0,0,0
2019-02-06 10:45,114,85,29,0,0,0
2019-02-06 11:00,98,66,32,0,0,0
2019-02-06 11:15,110,74,36,0,0,0
2019-02-06 11:30,110,69,41,0,0,0
2019-02-06 11:45,110,76,34,0,0,0
2019-02-06 12:00,119,71,48,0,0,0
2019-02-06 12:15,117,68,49,0,0,0
2019-02-06 12:30,130,58,72,0,0,0
2019-02-06 12:45,144,78,66,0,0,0
2019-02-06 13:00,110,55,55,0,0,0
2019-02-06 13:15,119,59,60,0,0,0
2019-02-06 13:30,107,48,59,0,0,0
2019-02-06 13:45,134,62,72,0,0,0
2019-02-06 14:00,118,42,76,0,0,0
2019-02-06 14:15,105,52,53,0,0,0
2019-02-06 14:30,109,49,60,0,0,0
2019-02-06 14:45,94,47,47,0,0,0
2019-02-06 15:00,134,65,69,0,0,0
2019-02-06 15:15,138,73,65,0,0,0
2019-02-06 15:30,139,71,68,0,0,0
2019-02-06 15:45,143,62,81,0,0,0
2019-02-06 16:00,159,86,73,0,0,0
2019-02-06 16:15,161,78,83,0,0,0
2019-02-06 16:30,139,66,73,0,0,0
2019-02-06 16:45,138,68,70,0,0,0
2019-02-06 17:00,148,71,77,0,0,0
2019-02-06 17:15,134,60,74,0,0,0
2019-02-06 17:30,154,75,79,0,0,0
2019-02-06 17:45,140,76,64,0,0,0
2019-02-06 18:00,146,69,77,0,0,0
2019-02-06 18:15,138,63,75,0,0,0
2019-02-06 18:30,111,55,56,0,0,0
2019-02-06 18:45,133,69,64,0,0,0
2019-02-06 19:00,123,57,66,0,0,0
2019-02-06 19:15,94,44,50,0,0,0
2019-02-06 19:30,85,44,41,0,0,0
2019-02-06 19:45,96,48,48,0,0,0
2019-02-06 20:00,98,52,46,0,0,0
2019-02-06 20:15,56,29,27,0,0,0
2019-02-06 20:30,37,25,12,0,0,0
2019-02-06 20:45,49,19,30,0,0,0
2019-02-06 21:00,46,22,24,0,0,0
2019-02-06 21:15,37,17,20,0,0,0
2019-02-06 21:30,44,22,22,0,0,0
2019-02-06 21:45,51,23,28,0,0,0
2019-02-06 22:00,41,12,29,0,0,0
2019-02-06 22:15,57,30,27,0,0,0
2019-02-06 22:30,44,23,21,0,0,0
2019-02-06 22:45,32,14,18,0,0,0
2019-02-06 23:00,27,14,13,0,0,0
2019-02-06 23:15,31,18,13,0,0,0
2019-02-06 23:30,21,9,12,0,0,0
2019-02-06 23:45,13,0,13,0,0,0
2019-02-07 00:00,9,3,6,0,0,0
2019-02-07 00:15,18,14,4,0,0,0
2019-02-07 00:30,13,10,3,0,0,0
2019-02-07 00:45,22,21,1,0,0,0
2019-02-07 01:00,16,5,11,0,0,0
2019-02-07 01:15,15,11,4,0,0,0
2019-02-07 01:30,9,4,5,0,0,0
2019-02-07 01:45,8,2,6,0,0,0
2019-02-07 02:00,12,2,10,0,0,0
2019-02-07 02:15,4,0,4,0,0,0
2019-02-07 02:30,1,0,1,0,0,0
2019-02-07 02:45,3,0,3,0,0,0
2019-02-07 03:00,2,0,2,0,0,0
2019-02-07 03:15,6,1,5,0,0,0
2019-02-07 03:30,3,1,2,0,0,0
2019-02-07 03:45,1,0,1,0,0,0
2019-02-07 04:00,4,1,3,0,0,0
2019-02-07 04:15,1,1,0,0,0,0
2019-02-07 04:30,0,0,0,0,0,0
2019-02-07 04:45,3,3,0,0,0,0
2019-02-07 05:00,1,0,1,0,0,0
2019-02-07 05:15,2,0,2,0,0,0
2019-02-07 05:30,7,7,0,0,0,0
2019-02-07 05:45,9,6,3,0,0,0
2019-02-07 06:00,13,8,5,0,0,0
2019-02-07 06:15,23,15,8,0,0,0
2019-02-07 06:30,46,27,19,0,0,0
2019-02-07 06:45,67,46,21,0,0,0
2019-02-07 07:00,70,52,18,0,0,0
2019-02-07 07:15,117,100,17,0,0,0
2019-02-07 07:30,234,197,37,0,0,0
2019-02-07 07:45,190,132,58,0,0,0
2019-02-07 08:00,150,116,34,0,0,0
2019-02-07 08:15,142,103,39,0,0,0
2019-02-07 08:30,152,112,40,0,0,0
2019-02-07 08:45,145,112,33,0,0,0
2019-02-07 09:00,102,73,29,0,0,0
2019-02-07 09:15,83,64,19,0,0,0
2019-02-07 09:30,94,68,26,0,0,0
2019-02-07 09:45,95,66,29,0,0,0
2019-02-07 10:00,89,60,29,0,0,0
2019-02-07 10:15,76,48,28,0,0,0
2019-02-07 10:30,60,44,16,0,0,0
2019-02-07 10:45,88,64,24,0,0,0
2019-02-07 11:00,65,36,29,0,0,0
2019-02-07 11:15,60,35,25,0,0,0
2019-02-07 11:30,69,46,23,0,0,0
2019-02-07 11:45,79,46,33,0,0,0
2019-02-07 12:00,80,54,26,0,0,0
2019-02-07 12:15,94,53,41,0,0,0
2019-02-07 12:30,88,33,55,0,0,0
2019-02-07 12:45,97,52,45,0,0,0
2019-02-07 13:00,111,63,48,0,0,0
2019-02-07 13:15,112,67,45,0,0,0
2019-02-07 13:30,105,57,48,0,0,0
2019-02-07 13:45,107,62,45,0,0,0
2019-02-07 14:00,117,39,78,0,0,0
2019-02-07 14:15,118,59,59,0,0,0
2019-02-07 14:30,106,57,49,0,0,0
2019-02-07 14:45,130,73,57,0,0,0
2019-02-07 15:00,132,68,64,0,0,0
2019-02-07 15:15,136,67,69,0,0,0
2019-02-07 15:30,130,71,59,0,0,0
2019-02-07 15:45,174,95,79,0,0,0
2019-02-07 16:00,153,95,58,0,0,0
2019-02-07 16:15,144,70,74,0,0,0
2019-02-07 16:30,148,83,65,0,0,0
2019-02-07 16:45,158,82,76,0,0,0
2019-02-07 17:00,161,87,74,0,0,0
2019-02-07 17:15,144,56,88,0,0,0
2019-02-07 17:30,155,75,80,0,0,0
2019-02-07 17:45,167,89,78,0,0,0
2019-02-07 18:00,141,58,83,0,0,0
2019-02-07 18:15,165,79,86,0,0,0
2019-02-07 18:30,108,48,60,0,0,0
2019-02-07 18:45,107,53,54,0,0,0
2019-02-07 19:00,111,52,59,0,0,0
2019-02-07 19:15,105,55,50,0,0,0
2019-02-07 19:30,87,42,45,0,0,0
2019-02-07 19:45,99,60,39,0,0,0
2019-02-07 20:00,92,42,50,0,0,0
2019-02-07 20:15,47,18,29,0,0,0
2019-02-07 20:30,59,31,28,0,0,0
2019-02-07 20:45,34,21,13,0,0,0
2019-02-07 21:00,55,20,35,0,0,0
2019-02-07 21:15,50,27,23,0,0,0
2019-02-07 21:30,44,21,23,0,0,0
2019-02-07 21:45,29,13,16,0,0,0
2019-02-07 22:00,43,20,23,0,0,0
2019-02-07 22:15,46,11,35,0,0,0
2019-02-07 22:30,48,23,25,0,0,0
2019-02-07 22:45,46,28,18,0,0,0
2019-02-07 23:00,37,9,28,0,0,0
2019-02-07 23:15,30,10,20,0,0,0
2019-02-07 23:30,26,11,15,0,0,0
2019-02-07 23:45,16,7,9,0,0,0
2019-02-08 00:00,31,18,13,0,0,0
2019-02-08 00:15,15,3,12,0,0,0
2019-02-08 00:30,6,2,4,0,0,0
2019-02-08 00:45,7,2,5,0,0,0
2019-02-08 01:00,8,4,4,0,0,0
2019-02-08 01:15,6,4,2,0,0,0
2019-02-08 01:30,6,2,4,0,0,0
2019-02-08 01:45,4,0,4,0,0,0
2019-02-08 02:00,7,2,5,0,0,0
2019-02-08 02:15,1,0,1,0,0,0
2019-02-08 02:30,1,1,0,0,0,0
2019-02-08 02:45,4,0,4,0,0,0
2019-02-08 03:00,8,4,4,0,0,0
2019-02-08 03:15,12,3,9,0,0,0
2019-02-08 03:30,0,0,0,0,0,0
2019-02-08 03:45,2,1,1,0,0,0
2019-02-08 04:00,2,0,2,0,0,0
2019-02-08 04:15,4,1,3,0,0,0
2019-02-08 04:30,0,0,0,0,0,0
2019-02-08 04:45,4,3,1,0,0,0
2019-02-08 05:00,5,1,4,0,0,0
2019-02-08 05:15,3,1,2,0,0,0
2019-02-08 05:30,13,10,3,0,0,0
2019-02-08 05:45,18,11,7,0,0,0
2019-02-08 06:00,17,12,5,0,0,0
2019-02-08 06:15,20,11,9,0,0,0
2019-02-08 06:30,38,28,10,0,0,0
2019-02-08 06:45,57,37,20,0,0,0
2019-02-08 07:00,71,55,16,0,0,0
2019-02-08 07:15,121,95,26,0,0,0
2019-02-08 07:30,268,229,39,0,0,0
2019-02-08 07:45,208,144,64,0,0,0
2019-02-08 08:00,111,93,18,0,0,0
2019-02-08 08:15,128,102,26,0,0,0
2019-02-08 08:30,107,83,24,0,0,0
2019-02-08 08:45,145,122,23,0,0,0
2019-02-08 09:00,99,81,18,0,0,0
2019-02-08 09:15,79,56,23,0,0,0
2019-02-08 09:30,93,70,23,0,0,0
2019-02-08 09:45,110,83,27,0,0,0
2019-02-08 10:00,80,53,27,0,0,0
2019-02-08 10:15,84,55,29,0,0,0
2019-02-08 10:30,108,54,54,0,0,0
2019-02-08 10:45,93,53,40,0,0,0
2019-02-08 11:00,86,51,35,0,0,0
2019-02-08 11:15,89,63,26,0,0,0
2019-02-08 11:30,99,59,40,0,0,0
2019-02-08 11:45,107,62,45,0,0,0
2019-02-08 12:00,103,51,52,0,0,0
2019-02-08 12:15,101,53,48,0,0,0
2019-02-08 12:30,109,50,59,0,0,0
2019-02-08 12:45,153,79,74,0,0,0
2019-02-08 13:00,124,59,65,0,0,0
2019-02-08 13:15,104,49,55,0,0,0
2019-02-08 13:30,95,45,50,0,0,0
2019-02-08 13:45,111,65,46,0,0,0
2019-02-08 14:00,108,60,48,0,0,0
2019-02-08 14:15,113,73,40,0,0,0
2019-02-08 14:30,116,64,52,0,0,0
2019-02-08 14:45,136,82,54,0,0,0
2019-02-08 15:00,136,71,65,0,0,0
2019-02-08 15:15,132,71,61,0,0,0
2019-02-08 15:30,117,64,53,0,0,0
2019-02-08 15:45,134,74,60,0,0,0
2019-02-08 16:00,149,72,77,0,0,0
2019-02-08 16:15,97,51,46,0,0,0
2019-02-08 16:30,101,50,51,0,0,0
2019-02-08 16:45,134,65,69,0,0,0
2019-02-08 17:00,87,43,44,0,0,0
2019-02-08 17:15,127,67,60,0,0,0
2019-02-08 17:30,114,48,66,0,0,0
2019-02-08 17:45,123,70,53,0,0,0
2019-02-08 18:00,92,53,39,0,0,0
2019-02-08 18:15,93,46,47,0,0,0
2019-02-08 18:30,87,28,59,0,0,0
2019-02-08 18:45,127,63,64,0,0,0
2019-02-08 19:00,104,50,54,0,0,0
2019-02-08 19:15,96,55,41,0,0,0
2019-02-08 19:30,91,43,48,0,0,0
2019-02-08 19:45,82,37,45,0,0,0
2019-02-08 20:00,90,53,37,0,0,0
2019-02-08 20:15,62,38,24,0,0,0
2019-02-08 20:30,79,44,35,0,0,0
2019-02-08 20:45,55,31,24,0,0,0
2019-02-08 21:00,54,18,36,0,0,0
2019-02-08 21:15,34,15,19,0,0,0
2019-02-08 21:30,65,39,26,0,0,0
2019-02-08 21:45,33,13,20,0,0,0
2019-02-08 22:00,31,16,15,0,0,0
2019-02-08 22:15,35,18,17,0,0,0
2019-02-08 22:30,50,27,23,0,0,0
2019-02-08 22:45,36,26,10,0,0,0
2019-02-08 23:00,46,28,18,0,0,0
2019-02-08 23:15,36,24,12,0,0,0
2019-02-08 23:30,24,9,15,0,0,0
2019-02-08 23:45,54,24,30,0,0,0
2019-02-09 00:00,26,12,14,0,0,0
2019-02-09 00:15,36,21,15,0,0,0
2019-02-09 00:30,18,7,11,0,0,0
2019-02-09 00:45,17,12,5,0,0,0
2019-02-09 01:00,22,5,17,0,0,0
2019-02-09 01:15,17,3,14,0,0,0
2019-02-09 01:30,18,8,10,0,0,0
2019-02-09 01:45,14,4,10,0,0,0
2019-02-09 02:00,14,4,10,0,0,0
2019-02-09 02:15,15,8,7,0,0,0
2019-02-09 02:30,13,3,10,0,0,0
2019-02-09 02:45,7,5,2,0,0,0
2019-02-09 03:00,9,2,7,0,0,0
2019-02-09 03:15,11,1,10,0,0,0
2019-02-09 03:30,8,1,7,0,0,0
2019-02-09 03:45,3,0,3,0,0,0
2019-02-09 04:00,2,0,2,0,0,0
2019-02-09 04:15,6,1,5,0,0,0
2019-02-09 04:30,1,0,1,0,0,0
2019-02-09 04:45,2,1,1,0,0,0
2019-02-09 05:00,4,1,3,0,0,0
2019-02-09 05:15,6,4,2,0,0,0
2019-02-09 05:30,6,6,0,0,0,0
2019-02-09 05:45,10,5,5,0,0,0
2019-02-09 06:00,7,3,4,0,0,0
2019-02-09 06:15,4,3,1,0,0,0
2019-02-09 06:30,9,8,1,0,0,0
2019-02-09 06:45,10,9,1,0,0,0
2019-02-09 07:00,9,8,1,0,0,0
2019-02-09 07:15,3,2,1,0,0,0
2019-02-09 07:30,17,8,9,0,0,0
2019-02-09 07:45,33,27,6,0,0,0
2019-02-09 08:00,19,16,3,0,0,0
2019-02-09 08:15,27,23,4,0,0,0
2019-02-09 08:30,36,35,1,0,0,0
2019-02-09 08:45,54,42,12,0,0,0
2019-02-09 09:00,40,29,11,0,0,0
2019-02-09 09:15,63,42,21,0,0,0
2019-02-09 09:30,70,63,7,0,0,0
2019-02-09 09:45,95,80,15,0,0,0
2019-02-09 10:00,82,65,17,0,0,0
2019-02-09 10:15,86,65,21,0,0,0
2019-02-09 10:30,77,58,19,0,0,0
2019-02-09 10:45,95,66,29,0,0,0
2019-02-09 11:00,84,62,22,0,0,0
2019-02-09 11:15,113,79,34,0,0,0
2019-02-09 11:30,130,91,39,0,0,0
2019-02-09 11:45,145,93,52,0,0,0
2019-02-09 12:00,104,72,32,0,0,0
2019-02-09 12:15,97,59,38,0,0,0
2019-02-09 12:30,86,51,35,0,0,0
2019-02-09 12:45,124,71,53,0,0,0
2019-02-09 13:00,103,53,50,0,0,0
2019-02-09 13:15,108,56,52,0,0,0
2019-02-09 13:30,120,65,55,0,0,0
2019-02-09 13:45,117,69,48,0,0,0
2019-02-09 14:00,106,50,56,0,0,0
2019-02-09 14:15,93,34,59,0,0,0
2019-02-09 14:30,85,36,49,0,0,0
2019-02-09 14:45,94,53,41,0,0,0
2019-02-09 15:00,76,40,36,0,0,0
2019-02-09 15:15,92,38,54,0,0,0
2019-02-09 15:30,86,55,31,0,0,0
2019-02-09 15:45,80,43,37,0,0,0
2019-02-09 16:00,82,32,50,0,0,0
2019-02-09 16:15,69,39,30,0,0,0
2019-02-09 16:30,73,37,36,0,0,0
2019-02-09 16:45,69,32,37,0,0,0
2019-02-09 17:00,63,28,35,0,0,0
2019-02-09 17:15,58,34,24,0,0,0
2019-02-09 17:30,93,53,40,0,0,0
2019-02-09 17:45,82,56,26,0,0,0
2019-02-09 18:00,80,33,47,0,0,0
2019-02-09 18:15,53,28,25,0,0,0
2019-02-09 18:30,65,30,35,0,0,0
2019-02-09 18:45,99,69,30,0,0,0
2019-02-09 19:00,77,41,36,0,0,0
2019-02-09 19:15,67,43,24,0,0,0
2019-02-09 19:30,59,31,28,0,0,0
2019-02-09 19:45,57,34,23,0,0,0
2019-02-09 20:00,49,23,26,0,0,0
2019-02-09 20:15,43,25,18,0,0,0
2019-02-09 20:30,51,24,27,0,0,0
2019-02-09 20:45,36,24,12,0,0,0
2019-02-09 21:00,40,22,18,0,0,0
2019-02-09 21:15,16,10,6,0,0,0
2019-02-09 21:30,26,7,19,0,0,0
2019-02-09 21:45,41,17,24,0,0,0
2019-02-09 22:00,33,22,11,0,0,0
2019-02-09 22:15,36,14,22,0,0,0
2019-02-09 22:30,25,13,12,0,0,0
2019-02-09 22:45,52,31,21,0,0,0
2019-02-09 23:00,24,7,17,0,0,0
2019-02-09 23:15,22,10,12,0,0,0
2019-02-09 23:30,29,11,18,0,0,0
2019-02-09 23:45,42,15,27,0,0,0
2019-02-10 00:00,28,16,12,0,0,0
2019-02-10 00:15,25,11,14,0,0,0
2019-02-10 00:30,27,14,13,0,0,0
2019-02-10 00:45,24,9,15,0,0,0
2019-02-10 01:00,27,18,9,0,0,0
2019-02-10 01:15,19,8,11,0,0,0
2019-02-10 01:30,15,2,13,0,0,0
2019-02-10 01:45,8,0,8,0,0,0
2019-02-10 02:00,12,7,5,0,0,0
2019-02-10 02:15,10,1,9,0,0,0
2019-02-10 02:30,10,4,6,0,0,0
2019-02-10 02:45,10,4,6,0,0,0
2019-02-10 03:00,4,1,3,0,0,0
2019-02-10 03:15,6,2,4,0,0,0
2019-02-10 03:30,5,1,4,0,0,0
2019-02-10 03:45,3,0,3,0,0,0
2019-02-10 04:00,5,2,3,0,0,0
2019-02-10 04:15,1,0,1,0,0,0
2019-02-10 04:30,4,0,4,0,0,0
2019-02-10 04:45,4,1,3,0,0,0
2019-02-10 05:00,1,0,1,0,0,0
2019-02-10 05:15,4,3,1,0,0,0
2019-02-10 05:30,7,6,1,0,0,0
2019-02-10 05:45,5,2,3,0,0,0
2019-02-10 06:00,5,0,5,0,0,0
2019-02-10 06:15,5,4,1,0,0,0
2019-02-10 06:30,4,2,2,0,0,0
2019-02-10 06:45,3,0,3,0,0,0
2019-02-10 07:00,3,2,1,0,0,0
2019-02-10 07:15,2,0,2,0,0,0
2019-02-10 07:30,0,0,0,0,0,0
2019-02-10 07:45,8,5,3,0,0,0
2019-02-10 08:00,5,5,0,0,0,0
2019-02-10 08:15,8,7,1,0,0,0
2019-02-10 08:30,11,10,1,0,0,0
2019-02-10 08:45,15,12,3,0,0,0
2019-02-10 09:00,8,5,3,0,0,0
2019-02-10 09:15,11,8,3,0,0,0
2019-02-10 09:30,11,10,1,0,0,0
2019-02-10 09:45,27,21,6,0,0,0
2019-02-10 10:00,10,9,1,0,0,0
2019-02-10 10:15,7,4,3,0,0,0
2019-02-10 10:30,25,23,2,0,0,0
2019-02-10 10:45,22,16,6,0,0,0
2019-02-10 11:00,20,11,9,0,0,0
2019-02-10 11:15,19,14,5,0,0,0
2019-02-10 11:30,26,21,5,0,0,0
2019-02-10 11:45,31,20,11,0,0,0
2019-02-10 12:00,22,10,12,0,0,0
2019-02-10 12:15,20,10,10,0,0,0
2019-02-10 12:30,18,13,5,0,0,0
2019-02-10 12:45,30,18,12,0,0,0
2019-02-10 13:00,21,7,14,0,0,0
2019-02-10 13:15,26,17,9,0,0,0
2019-02-10 13:30,22,6,16,0,0,0
2019-02-10 13:45,40,21,19,0,0,0
2019-02-10 14:00,26,10,16,0,0,0
2019-02-10 14:15,40,30,10,0,0,0
2019-02-10 14:30,42,26,16,0,0,0
2019-02-10 14:45,25,17,8,0,0,0
2019-02-10 15:00,34,17,17,0,0,0
2019-02-10 15:15,31,22,9,0,0,0
2019-02-10 15:30,27,14,13,0,0,0
2019-02-10 15:45,33,16,17,0,0,0
2019-02-10 16:00,21,7,14,0,0,0
2019-02-10 16:15,40,31,9,0,0,0
2019-02-10 16:30,34,13,21,0,0,0
2019-02-10 16:45,31,18,13,0,0,0
2019-02-10 17:00,34,19,15,0,0,0
2019-02-10 17:15,37,20,17,0,0,0
2019-02-10 17:30,21,12,9,0,0,0
2019-02-10 17:45,34,14,20,0,0,0
2019-02-10 18:00,31,14,17,0,0,0
2019-02-10 18:15,29,12,17,0,0,0
2019-02-10 18:30,25,10,15,0,0,0
2019-02-10 18:45,19,10,9,0,0,0
2019-02-10 19:00,29,13,16,0,0,0
2019-02-10 19:15,21,9,12,0,0,0
2019-02-10 19:30,18,9,9,0,0,0
2019-02-10 19:45,15,7,8,0,0,0
2019-02-10 20:00,30,15,15,0,0,0
2019-02-10 20:15,21,7,14,0,0,0
2019-02-10 20:30,13,7,6,0,0,0
2019-02-10 20:45,13,5,8,0,0,0
2019-02-10 21:00,16,4,12,0,0,0
2019-02-10 21:15,7,6,1,0,0,0
2019-02-10 21:30,1,1,0,0,0,0
2019-02-10 21:45,14,6,8,0,0,0
2019-02-10 22:00,14,9,5,0,0,0
2019-02-10 22:15,8,3,5,0,0,0
2019-02-10 22:30,13,9,4,0,0,0
2019-02-10 22:45,8,5,3,0,0,0
2019-02-10 23:00,17,12,5,0,0,0
2019-02-10 23:15,3,3,0,0,0,0
2019-02-10 23:30,6,1,5,0,0,0
2019-02-10 23:45,7,4,3,0,0,0
2019-02-11 00:00,4,4,0,0,0,0
2019-02-11 00:15,0,0,0,0,0,0
2019-02-11 00:30,3,2,1,0,0,0
2019-02-11 00:45,0,0,0,0,0,0
2019-02-11 01:00,1,0,1,0,0,0
2019-02-11 01:15,1,0,1,0,0,0
2019-02-11 01:30,2,1,1,0,0,0
2019-02-11 01:45,4,2,2,0,0,0
2019-02-11 02:00,0,0,0,0,0,0
2019-02-11 02:15,1,0,1,0,0,0
2019-02-11 02:30,2,2,0,0,0,0
2019-02-11 02:45,0,0,0,0,0,0
2019-02-11 03:00,0,0,0,0,0,0
2019-02-11 03:15,0,0,0,0,0,0
2019-02-11 03:30,0,0,0,0,0,0
2019-02-11 03:45,0,0,0,0,0,0
2019-02-11 04:00,3,3,0,0,0,0
2019-02-11 04:15,0,0,0,0,0,0
2019-02-11 04:30,0,0,0,0,0,0
2019-02-11 04:45,2,1,1,0,0,0
2019-02-11 05:00,0,0,0,0,0,0
2019-02-11 05:15,2,1,1,0,0,0
2019-02-11 05:30,9,7,2,0,0,0
2019-02-11 05:45,12,4,8,0,0,0
2019-02-11 06:00,15,8,7,0,0,0
2019-02-11 06:15,24,15,9,0,0,0
2019-02-11 06:30,48,31,17,0,0,0
2019-02-11 06:45,56,34,22,0,0,0
2019-02-11 07:00,73,48,25,0,0,0
2019-02-11 07:15,106,82,24,0,0,0
2019-02-11 07:30,223,181,42,0,0,0
2019-02-11 07:45,210,157,53,0,0,0
2019-02-11 08:00,149,118,31,0,0,0
2019-02-11 08:15,141,107,34,0,0,0
2019-02-11 08:30,140,106,34,0,0,0
2019-02-11 08:45,137,107,30,0,0,0
2019-02-11 09:00,72,60,12,0,0,0
2019-02-11 09:15,85,61,24,0,0,0
2019-02-11 09:30,69,57,12,0,0,0
2019-02-11 09:45,93,63,30,0,0,0
2019-02-11 10:00,56,43,13,0,0,0
2019-02-11 10:15,63,43,20,0,0,0
2019-02-11 10:30,77,53,24,0,0,0
2019-02-11 10:45,107,73,34,0,0,0
2019-02-11 11:00,68,42,26,0,0,0
2019-02-11 11:15,68,40,28,0,0,0
2019-02-11 11:30,67,37,30,0,0,0
2019-02-11 11:45,73,44,29,0,0,0
2019-02-11 12:00,93,53,40,0,0,0
2019-02-11 12:15,98,60,38,0,0,0
2019-02-11 12:30,103,39,64,0,0,0
2019-02-11 12:45,109,62,47,0,0,0
2019-02-11 13:00,129,66,63,0,0,0
2019-02-11 13:15,102,52,50,0,0,0
2019-02-11 13:30,98,56,42,0,0,0
2019-02-11 13:45,74,31,43,0,0,0
2019-02-11 14:00,101,42,59,0,0,0
2019-02-11 14:15,113,73,40,0,0,0
2019-02-11 14:30,108,64,44,0,0,0
2019-02-11 14:45,115,63,52,0,0,0
2019-02-11 15:00,112,65,47,0,0,0
2019-02-11 15:15,105,68,37,0,0,0
2019-02-11 15:30,145,69,76,0,0,0
2019-02-11 15:45,155,79,76,0,0,0
2019-02-11 16:00,146,84,62,0,0,0
2019-02-11 16:15,132,75,57,0,0,0
2019-02-11 16:30,128,67,61,0,0,0
2019-02-11 16:45,140,75,65,0,0,0
2019-02-11 17:00,123,60,63,0,0,0
2019-02-11 17:15,155,70,85,0,0,0
2019-02-11 17:30,145,61,84,0,0,0
2019-02-11 17:45,119,65,54,0,0,0
2019-02-11 18:00,132,58,74,0,0,0
2019-02-11 18:15,137,60,77,0,0,0
2019-02-11 18:30,119,71,48,0,0,0
2019-02-11 18:45,90,46,44,0,0,0
2019-02-11 19:00,93,44,49,0,0,0
2019-02-11 19:15,76,38,38,0,0,0
2019-02-11 19:30,48,28,20,0,0,0
2019-02-11 19:45,75,35,40,0,0,0
2019-02-11 20:00,68,30,38,0,0,0
2019-02-11 20:15,47,19,28,0,0,0
2019-02-11 20:30,29,11,18,0,0,0
2019-02-11 20:45,32,15,17,0,0,0
2019-02-11 21:00,28,15,13,0,0,0
2019-02-11 21:15,37,19,18,0,0,0
2019-02-11 21:30,32,8,24,0,0,0
2019-02-11 21:45,43,26,17,0,0,0
2019-02-11 22:00,27,9,18,0,0,0
2019-02-11 22:15,15,4,11,0,0,0
2019-02-11 22:30,28,18,10,0,0,0
2019-02-11 22:45,25,16,9,0,0,0
2019-02-11 23:00,13,2,11,0,0,0
2019-02-11 23:15,14,3,11,0,0,0
2019-02-11 23:30,16,3,13,0,0,0
2019-02-11 23:45,14,3,11,0,0,0
2019-02-12 00:00,7,2,5,0,0,0
2019-02-12 00:15,4,2,2,0,0,0
2019-02-12 00:30,7,2,5,0,0,0
2019-02-12 00:45,2,1,1,0,0,0
2019-02-12 01:00,1,0,1,0,0,0
2019-02-12 01:15,1,0,1,0,0,0
2019-02-12 01:30,4,1,3,0,0,0
2019-02-12 01:45,1,0,1,0,0,0
2019-02-12 02:00,1,0,1,0,0,0
2019-02-12 02:15,1,0,1,0,0,0
2019-02-12 02:30,2,1,1,0,0,0
2019-02-12 02:45,0,0,0,0,0,0
2019-02-12 03:00,0,0,0,0,0,0
2019-02-12 03:15,0,0,0,0,0,0
2019-02-12 03:30,1,1,0,0,0,0
2019-02-12 03:45,0,0,0,0,0,0
2019-02-12 04:00,0,0,0,0,0,0
2019-02-12 04:15,1,0,1,0,0,0
2019-02-12 04:30,3,2,1,0,0,0
2019-02-12 04:45,1,0,1,0,0,0
2019-02-12 05:00,0,0,0,0,0,0
2019-02-12 05:15,2,2,0,0,0,0
2019-02-12 05:30,13,10,3,0,0,0
2019-02-12 05:45,17,10,7,0,0,0
2019-02-12 06:00,19,11,8,0,0,0
2019-02-12 06:15,31,20,11,0,0,0
2019-02-12 06:30,46,30,16,0,0,0
2019-02-12 06:45,86,58,28,0,0,0
2019-02-12 07:00,88,66,22,0,0,0
2019-02-12 07:15,152,118,34,0,0,0
2019-02-12 07:30,289,251,38,0,0,0
2019-02-12 07:45,204,148,56,0,0,0
2019-02-12 08:00,148,111,37,0,0,0
2019-02-12 08:15,131,118,13,0,0,0
2019-02-12 08:30,148,115,33,0,0,0
2019-02-12 08:45,149,122,27,0,0,0
2019-02-12 09:00,89,69,20,0,0,0
2019-02-12 09:15,111,85,26,0,0,0
2019-02-12 09:30,83,67,16,0,0,0
2019-02-12 09:45,118,100,18,0,0,0
2019-02-12 10:00,76,54,22,0,0,0
2019-02-12 10:15,80,60,20,0,0,0
2019-02-12 10:30,65,46,19,0,0,0
2019-02-12 10:45,98,67,31,0,0,0
2019-02-12 11:00,75,53,22,0,0,0
2019-02-12 11:15,81,50,31,0,0,0
2019-02-12 11:30,79,53,26,0,0,0
2019-02-12 11:45,89,49,40,0,0,0
2019-02-12 12:00,92,55,37,0,0,0
2019-02-12 12:15,99,57,42,0,0,0
2019-02-12 12:30,102,50,52,0,0,0
2019-02-12 12:45,116,62,54,0,0,0
2019-02-12 13:00,126,63,63,0,0,0
2019-02-12 13:15,115,48,67,0,0,0
2019-02-12 13:30,116,63,53,0,0,0
2019-02-12 13:45,120,71,49,0,0,0
2019-02-12 14:00,109,40,69,0,0,0
2019-02-12 14:15,110,59,51,0,0,0
2019-02-12 14:30,94,57,37,0,0,0
2019-02-12 14:45,131,73,58,0,0,0
2019-02-12 15:00,121,61,60,0,0,0
2019-02-12 15:15,116,48,68,0,0,0
2019-02-12 15:30,145,81,64,0,0,0
2019-02-12 15:45,159,80,79,0,0,0
2019-02-12 16:00,173,106,67,0,0,0
2019-02-12 16:15,128,70,58,0,0,0
2019-02-12 16:30,134,75,59,0,0,0
2019-02-12 16:45,144,68,76,0,0,0
2019-02-12 17:00,158,80,78,0,0,0
2019-02-12 17:15,152,67,85,0,0,0
2019-02-12 17:30,180,80,100,0,0,0
2019-02-12 17:45,141,64,77,0,0,0
2019-02-12 18:00,122,61,61,0,0,0
2019-02-12 18:15,133,45,88,0,0,0
2019-02-12 18:30,106,52,54,0,0,0
2019-02-12 18:45,134,69,65,0,0,0
2019-02-12 19:00,70,37,33,0,0,0
2019-02-12 19:15,89,45,44,0,0,0
2019-02-12 19:30,91,44,47,0,0,0
2019-02-12 19:45,96,43,53,0,0,0
2019-02-12 20:00,88,42,46,0,0,0
2019-02-12 20:15,60,27,33,0,0,0
2019-02-12 20:30,52,18,34,0,0,0
2019-02-12 20:45,42,20,22,0,0,0
2019-02-12 21:00,34,15,19,0,0,0
2019-02-12 21:15,58,29,29,0,0,0
2019-02-12 21:30,44,21,23,0,0,0
2019-02-12 21:45,39,16,23,0,0,0
2019-02-12 22:00,48,30,18,0,0,0
2019-02-12 22:15,39,16,23,0,0,0
2019-02-12 22:30,31,16,15,0,0,0
2019-02-12 22:45,30,15,15,0,0,0
2019-02-12 23:00,28,14,14,0,0,0
2019-02-12 23:15,27,18,9,0,0,0
2019-02-12 23:30,19,9,10,0,0,0
2019-02-12 23:45,7,4,3,0,0,0
2019-02-13 00:00,15,11,4,0,0,0
2019-02-13 00:15,12,7,5,0,0,0
2019-02-13 00:30,2,2,0,0,0,0
2019-02-13 00:45,6,4,2,0,0,0
2019-02-13 01:00,9,4,5,0,0,0
2019-02-13 01:15,6,4,2,0,0,0
2019-02-13 01:30,3,2,1,0,0,0
2019-02-13 01:45,1,0,1,0,0,0
2019-02-13 02:00,2,0,2,0,0,0
2019-02-13 02:15,2,0,2,0,0,0
2019-02-13 02:30,3,2,1,0,0,0
2019-02-13 02:45,1,1,0,0,0,0
2019-02-13 03:00,1,1,0,0,0,0
2019-02-13 03:15,4,2,2,0,0,0
2019-02-13 03:30,0,0,0,0,0,0
2019-02-13 03:45,1,0,1,0,0,0
2019-02-13 04:00,0,0,0,0,0,0
2019-02-13 04:15,1,0,1,0,0,0
2019-02-13 04:30,0,0,0,0,0,0
2019-02-13 04:45,1,0,1,0,0,0
2019-02-13 05:00,2,2,0,0,0,0
2019-02-13 05:15,4,0,4,0,0,0
2019-02-13 05:30,11,10,1,0,0,0
2019-02-13 05:45,13,6,7,0,0,0
2019-02-13 06:00,13,7,6,0,0,0
2019-02-13 06:15,25,15,10,0,0,0
2019-02-13 06:30,43,29,14,0,0,0
2019-02-13 06:45,67,39,28,0,0,0
2019-02-13 07:00,93,72,21,0,0,0
2019-02-13 07:15,153,123,30,0,0,0
2019-02-13 07:30,291,235,56,0,0,0
2019-02-13 07:45,216,153,63,0,0,0
2019-02-13 08:00,139,111,28,0,0,0
2019-02-13 08:15,163,121,42,0,0,0
2019-02-13 08:30,141,116,25,0,0,0
2019-02-13 08:45,165,119,46,0,0,0
2019-02-13 09:00,99,86,13,0,0,0
2019-02-13 09:15,99,76,23,0,0,0
2019-02-13 09:30,104,77,27,0,0,0
2019-02-13 09:45,110,80,30,0,0,0
2019-02-13 10:00,87,65,22,0,0,0
2019-02-13 10:15,86,51,35,0,0,0
2019-02-13 10:30,82,62,20,0,0,0
2019-02-13 10:45,100,79,21,0,0,0
2019-02-13 11:00,117,72,45,0,0,0
2019-02-13 11:15,106,72,34,0,0,0
2019-02-13 11:30,87,46,41,0,0,0
2019-02-13 11:45,118,72,46,0,0,0
2019-02-13 12:00,107,62,45,0,0,0
2019-02-13 12:15,145,77,68,0,0,0
2019-02-13 12:30,129,66,63,0,0,0
2019-02-13 12:45,141,88,53,0,0,0
2019-02-13 13:00,150,68,82,0,0,0
2019-02-13 13:15,135,56,79,0,0,0
2019-02-13 13:30,130,70,60,0,0,0
2019-02-13 13:45,137,67,70,0,0,0
2019-02-13 14:00,104,36,68,0,0,0
2019-02-13 14:15,100,60,40,0,0,0
2019-02-13 14:30,123,63,60,0,0,0
2019-02-13 14:45,117,54,63,0,0,0
2019-02-13 15:00,117,55,62,0,0,0
2019-02-13 15:15,99,44,55,0,0,0
2019-02-13 15:30,130,65,65,0,0,0
2019-02-13 15:45,137,64,73,0,0,0
2019-02-13 16:00,143,82,61,0,0,0
2019-02-13 16:15,155,74,81,0,0,0
2019-02-13 16:30,143,76,67,0,0,0
2019-02-13 16:45,143,70,73,0,0,0
2019-02-13 17:00,163,86,77,0,0,0
2019-02-13 17:15,150,78,72,0,0,0
2019-02-13 17:30,152,67,85,0,0,0
2019-02-13 17:45,172,81,91,0,0,0
2019-02-13 18:00,141,67,74,0,0,0
2019-02-13 18:15,165,85,80,0,0,0
2019-02-13 18:30,112,49,63,0,0,0
2019-02-13 18:45,118,60,58,0,0,0
2019-02-13 19:00,88,37,51,0,0,0
2019-02-13 19:15,113,55,58,0,0,0
2019-02-13 19:30,77,46,31,0,0,0
2019-02-13 19:45,96,51,45,0,0,0
2019-02-13 20:00,84,48,36,0,0,0
2019-02-13 20:15,63,32,31,0,0,0
2019-02-13 20:30,56,29,27,0,0,0
2019-02-13 20:45,52,28,24,0,0,0
2019-02-13 21:00,34,17,17,0,0,0
2019-02-13 21:15,47,18,29,0,0,0
2019-02-13 21:30,39,21,18,0,0,0
2019-02-13 21:45,50,27,23,0,0,0
2019-02-13 22:00,35,13,22,0,0,0
2019-02-13 22:15,46,23,23,0,0,0
2019-02-13 22:30,42,19,23,0,0,0
2019-02-13 22:45,44,20,24,0,0,0
2019-02-13 23:00,45,21,24,0,0,0
2019-02-13 23:15,31,17,14,0,0,0
2019-02-13 23:30,45,29,16,0,0,0
2019-02-13 23:45,13,6,7,0,0,0
2019-02-14 00:00,20,11,9,0,0,0
2019-02-14 00:15,14,8,6,0,0,0
2019-02-14 00:30,11,5,6,0,0,0
2019-02-14 00:45,9,2,7,0,0,0
2019-02-14 01:00,4,1,3,0,0,0
2019-02-14 01:15,7,3,4,0,0,0
2019-02-14 01:30,3,0,3,0,0,0
2019-02-14 01:45,4,0,4,0,0,0
2019-02-14 02:00,3,0,3,0,0,0
2019-02-14 02:15,0,0,0,0,0,0
2019-02-14 02:30,6,0,6,0,0,0
2019-02-14 02:45,7,3,4,0,0,0
2019-02-14 03:00,1,0,1,0,0,0
2019-02-14 03:15,3,0,3,0,0,0
2019-02-14 03:30,1,0,1,0,0,0
2019-02-14 03:45,0,0,0,0,0,0
2019-02-14 04:00,4,3,1,0,0,0
2019-02-14 04:15,0,0,0,0,0,0
2019-02-14 04:30,1,1,0,0,0,0
2019-02-14 04:45,4,2,2,0,0,0
2019-02-14 05:00,0,0,0,0,0,0
2019-02-14 05:15,2,0,2,0,0,0
2019-02-14 05:30,15,12,3,0,0,0
2019-02-14 05:45,14,6,8,0,0,0
2019-02-14 06:00,13,8,5,0,0,0
2019-02-14 06:15,19,10,9,0,0,0
2019-02-14 06:30,50,34,16,0,0,0
2019-02-14 06:45,56,35,21,0,0,0
2019-02-14 07:00,100,71,29,0,0,0
2019-02-14 07:15,136,116,20,0,0,0
2019-02-14 07:30,301,257,44,0,0,0
2019-02-14 07:45,231,170,61,0,0,0
2019-02-14 08:00,149,120,29,0,0,0
2019-02-14 08:15,153,117,36,0,0,0
2019-02-14 08:30,141,113,28,0,0,0
2019-02-14 08:45,156,119,37,0,0,0
2019-02-14 09:00,107,86,21,0,0,0
2019-02-14 09:15,99,87,12,0,0,0
2019-02-14 09:30,89,71,18,0,0,0
2019-02-14 09:45,124,96,28,0,0,0
2019-02-14 10:00,103,83,20,0,0,0
2019-02-14 10:15,68,45,23,0,0,0
2019-02-14 10:30,70,54,16,0,0,0
2019-02-14 10:45,67,48,19,0,0,0
2019-02-14 11:00,85,54,31,0,0,0
2019-02-14 11:15,94,53,41,0,0,0
2019-02-14 11:30,92,62,30,0,0,0
2019-02-14 11:45,98,59,39,0,0,0
2019-02-14 12:00,98,58,40,0,0,0
2019-02-14 12:15,85,41,44,0,0,0
2019-02-14 12:30,100,56,44,0,0,0
2019-02-14 12:45,114,62,52,0,0,0
2019-02-14 13:00,129,58,71,0,0,0
2019-02-14 13:15,112,54,58,0,0,0
2019-02-14 13:30,98,48,50,0,0,0
2019-02-14 13:45,110,64,46,0,0,0
2019-02-14 14:00,154,57,97,0,0,0
2019-02-14 14:15,140,76,64,0,0,0
2019-02-14 14:30,127,65,62,0,0,0
2019-02-14 14:45,148,96,52,0,0,0
2019-02-14 15:00,127,67,60,0,0,0
2019-02-14 15:15,142,87,55,0,0,0
2019-02-14 15:30,162,84,78,0,0,0
2019-02-14 15:45,166,79,87,0,0,0
2019-02-14 16:00,182,106,76,0,0,0
2019-02-14 16:15,177,82,95,0,0,0
2019-02-14 16:30,156,90,66,0,0,0
2019-02-14 16:45,170,93,77,0,0,0
2019-02-14 17:00,181,94,87,0,0,0
2019-02-14 17:15,162,82,80,0,0,0
2019-02-14 17:30,194,88,106,0,0,0
2019-02-14 17:45,179,81,98,0,0,0
2019-02-14 18:00,163,68,95,0,0,0
2019-02-14 18:15,140,68,72,0,0,0
2019-02-14 18:30,116,53,63,0,0,0
2019-02-14 18:45,127,76,51,0,0,0
2019-02-14 19:00,114,57,57,0,0,0
2019-02-14 19:15,112,56,56,0,0,0
2019-02-14 19:30,107,59,48,0,0,0
2019-02-14 19:45,105,57,48,0,0,0
2019-02-14 20:00,74,38,36,0,0,0
2019-02-14 20:15,74,32,42,0,0,0
2019-02-14 20:30,47,11,36,0,0,0
2019-02-14 20:45,44,23,21,0,0,0
2019-02-14 21:00,40,14,26,0,0,0
2019-02-14 21:15,52,25,27,0,0,0
2019-02-14 21:30,31,11,20,0,0,0
2019-02-14 21:45,36,20,16,0,0,0
2019-02-14 22:00,47,22,25,0,0,0
2019-02-14 22:15,52,21,31,0,0,0
2019-02-14 22:30,40,11,29,0,0,0
2019-02-14 22:45,26,13,13,0,0,0
2019-02-14 23:00,38,12,26,0,0,0
2019-02-14 23:15,26,11,15,0,0,0
2019-02-14 23:30,11,5,6,0,0,0
2019-02-14 23:45,11,5,6,0,0,0
2019-02-15 00:00,8,3,5,0,0,0
2019-02-15 00:15,14,5,9,0,0,0
2019-02-15 00:30,6,2,4,0,0,0
2019-02-15 00:45,9,6,3,0,0,0
2019-02-15 01:00,8,2,6,0,0,0
2019-02-15 01:15,3,2,1,0,0,0
2019-02-15 01:30,6,2,4,0,0,0
2019-02-15 01:45,2,0,2,0,0,0
2019-02-15 02:00,2,0,2,0,0,0
2019-02-15 02:15,4,0,4,0,0,0
2019-02-15 02:30,7,5,2,0,0,0
2019-02-15 02:45,3,1,2,0,0,0
2019-02-15 03:00,1,0,1,0,0,0
2019-02-15 03:15,0,0,0,0,0,0
2019-02-15 03:30,1,1,0,0,0,0
2019-02-15 03:45,1,1,0,0,0,0
2019-02-15 04:00,2,1,1,0,0,0
2019-02-15 04:15,1,1,0,0,0,0
2019-02-15 04:30,0,0,0,0,0,0
2019-02-15 04:45,2,2,0,0,0,0
2019-02-15 05:00,1,0,1,0,0,0
2019-02-15 05:15,3,0,3,0,0,0
2019-02-15 05:30,15,11,4,0,0,0
2019-02-15 05:45,21,13,8,0,0,0
2019-02-15 06:00,10,7,3,0,0,0
2019-02-15 06:15,17,13,4,0,0,0
2019-02-15 06:30,46,29,17,0,0,0
2019-02-15 06:45,64,50,14,0,0,0
2019-02-15 07:00,62,47,15,0,0,0
2019-02-15 07:15,165,131,34,0,0,0
2019-02-15 07:30,295,259,36,0,0,0
2019-02-15 07:45,181,130,51,0,0,0
2019-02-15 08:00,127,91,36,0,0,0
2019-02-15 08:15,154,116,38,0,0,0
2019-02-15 08:30,120,90,30,0,0,0
2019-02-15 08:45,156,129,27,0,0,0
2019-02-15 09:00,111,87,24,0,0,0
2019-02-15 09:15,122,94,28,0,0,0
2019-02-15 09:30,120,102,18,0,0,0
2019-02-15 09:45,121,97,24,0,0,0
2019-02-15 10:00,74,54,20,0,0,0
2019-02-15 10:15,94,74,20,0,0,0
2019-02-15 10:30,81,54,27,0,0,0
2019-02-15 10:45,94,69,25,0,0,0
2019-02-15 11:00,116,77,39,0,0,0
2019-02-15 11:15,108,62,46,0,0,0
2019-02-15 11:30,94,65,29,0,0,0
2019-02-15 11:45,98,64,34,0,0,0
2019-02-15 12:00,122,81,41,0,0,0
2019-02-15 12:15,126,77,49,0,0,0
2019-02-15 12:30,147,73,74,0,0,0
2019-02-15 12:45,151,84,67,0,0,0
2019-02-15 13:00,144,70,74,0,0,0
2019-02-15 13:15,155,61,94,0,0,0
2019-02-15 13:30,148,76,72,0,0,0
2019-02-15 13:45,151,80,71,0,0,0
2019-02-15 14:00,166,76,90,0,0,0
2019-02-15 14:15,155,71,84,0,0,0
2019-02-15 14:30,151,80,71,0,0,0
2019-02-15 14:45,141,78,63,0,0,0
2019-02-15 15:00,157,96,61,0,0,0
2019-02-15 15:15,168,95,73,0,0,0
2019-02-15 15:30,172,94,78,0,0,0
2019-02-15 15:45,161,91,70,0,0,0
2019-02-15 16:00,172,103,69,0,0,0
2019-02-15 16:15,139,67,72,0,0,0
2019-02-15 16:30,163,92,71,0,0,0
2019-02-15 16:45,182,106,76,0,0,0
2019-02-15 17:00,141,66,75,0,0,0
2019-02-15 17:15,152,72,80,0,0,0
2019-02-15 17:30,149,63,86,0,0,0
2019-02-15 17:45,161,90,71,0,0,0
2019-02-15 18:00,112,58,54,0,0,0
2019-02-15 18:15,94,46,48,0,0,0
2019-02-15 18:30,97,45,52,0,0,0
2019-02-15 18:45,139,83,56,0,0,0
2019-02-15 19:00,137,74,63,0,0,0
2019-02-15 19:15,115,63,52,0,0,0
2019-02-15 19:30,79,44,35,0,0,0
2019-02-15 19:45,90,52,38,0,0,0
2019-02-15 20:00,79,42,37,0,0,0
2019-02-15 20:15,64,38,26,0,0,0
2019-02-15 20:30,59,24,35,0,0,0
2019-02-15 20:45,57,37,20,0,0,0
2019-02-15 21:00,44,17,27,0,0,0
2019-02-15 21:15,44,22,22,0,0,0
2019-02-15 21:30,44,23,21,0,0,0
2019-02-15 21:45,52,24,28,0,0,0
2019-02-15 22:00,41,24,17,0,0,0
2019-02-15 22:15,59,28,31,0,0,0
2019-02-15 22:30,33,15,18,0,0,0
2019-02-15 22:45,37,18,19,0,0,0
2019-02-15 23:00,34,13,21,0,0,0
2019-02-15 23:15,24,13,11,0,0,0
2019-02-15 23:30,33,22,11,0,0,0
2019-02-15 23:45,28,13,15,0,0,0
2019-02-16 00:00,34,10,24,0,0,0
2019-02-16 00:15,23,13,10,0,0,0
2019-02-16 00:30,27,16,11,0,0,0
2019-02-16 00:45,19,12,7,0,0,0
2019-02-16 01:00,29,16,13,0,0,0
2019-02-16 01:15,20,5,15,0,0,0
2019-02-16 01:30,17,8,9,0,0,0
2019-02-16 01:45,19,4,15,0,0,0
2019-02-16 02:00,15,9,6,0,0,0
2019-02-16 02:15,12,0,12,0,0,0
2019-02-16 02:30,10,5,5,0,0,0
2019-02-16 02:45,18,4,14,0,0,0
2019-02-16 03:00,5,1,4,0,0,0
2019-02-16 03:15,8,3,5,0,0,0
2019-02-16 03:30,6,1,5,0,0,0
2019-02-16 03:45,6,2,4,0,0,0
2019-02-16 04:00,4,2,2,0,0,0
2019-02-16 04:15,2,0,2,0,0,0
2019-02-16 04:30,1,1,0,0,0,0
2019-02-16 04:45,3,2,1,0,0,0
2019-02-16 05:00,0,0,0,0,0,0
2019-02-16 05:15,8,6,2,0,0,0
2019-02-16 05:30,8,6,2,0,0,0
2019-02-16 05:45,7,3,4,0,0,0
2019-02-16 06:00,9,7,2,0,0,0
2019-02-16 06:15,5,2,3,0,0,0
2019-02-16 06:30,8,7,1,0,0,0
2019-02-16 06:45,10,7,3,0,0,0
2019-02-16 07:00,10,8,2,0,0,0
2019-02-16 07:15,4,3,1,0,0,0
2019-02-16 07:30,18,11,7,0,0,0
2019-02-16 07:45,32,25,7,0,0,0
2019-02-16 08:00,29,21,8,0,0,0
2019-02-16 08:15,34,27,7,0,0,0
2019-02-16 08:30,56,50,6,0,0,0
2019-02-16 08:45,68,55,13,0,0,0
2019-02-16 09:00,44,31,13,0,0,0
2019-02-16 09:15,74,57,17,0,0,0
2019-02-16 09:30,96,76,20,0,0,0
2019-02-16 09:45,147,123,24,0,0,0
2019-02-16 10:00,125,97,28,0,0,0
2019-02-16 10:15,104,82,22,0,0,0
2019-02-16 10:30,111,79,32,0,0,0
2019-02-16 10:45,153,121,32,0,0,0
2019-02-16 11:00,153,114,39,0,0,0
2019-02-16 11:15,173,120,53,0,0,0
2019-02-16 11:30,159,109,50,0,0,0
2019-02-16 11:45,171,130,41,0,0,0
2019-02-16 12:00,184,119,65,0,0,0
2019-02-16 12:15,171,119,52,0,0,0
2019-02-16 12:30,201,134,67,0,0,0
2019-02-16 12:45,185,120,65,0,0,0
2019-02-16 13:00,174,104,70,0,0,0
2019-02-16 13:15,171,100,71,0,0,0
2019-02-16 13:30,149,93,56,0,0,0
2019-02-16 13:45,145,82,63,0,0,0
2019-02-16 14:00,124,69,55,0,0,0
2019-02-16 14:15,201,103,98,0,0,0
2019-02-16 14:30,166,87,79,0,0,0
2019-02-16 14:45,141,70,71,0,0,0
2019-02-16 15:00,127,63,64,0,0,0
2019-02-16 15:15,122,61,61,0,0,0
2019-02-16 15:30,134,67,67,0,0,0
2019-02-16 15:45,135,70,65,0,0,0
2019-02-16 16:00,127,61,66,0,0,0
2019-02-16 16:15,122,54,68,0,0,0
2019-02-16 16:30,104,46,58,0,0,0
2019-02-16 16:45,96,35,61,0,0,0
2019-02-16 17:00,108,37,71,0,0,0
2019-02-16 17:15,95,41,54,0,0,0
2019-02-16 17:30,119,57,62,0,0,0
2019-02-16 17:45,103,51,52,0,0,0
2019-02-16 18:00,119,42,77,0,0,0
2019-02-16 18:15,104,48,56,0,0,0
2019-02-16 18:30,57,29,28,0,0,0
2019-02-16 18:45,71,36,35,0,0,0
2019-02-16 19:00,80,47,33,0,0,0
2019-02-16 19:15,99,59,40,0,0,0
2019-02-16 19:30,79,46,33,0,0,0
2019-02-16 19:45,78,44,34,0,0,0
2019-02-16 20:00,70,45,25,0,0,0
2019-02-16 20:15,50,27,23,0,0,0
2019-02-16 20:30,28,16,12,0,0,0
2019-02-16 20:45,50,30,20,0,0,0
2019-02-16 21:00,40,23,17,0,0,0
2019-02-16 21:15,32,20,12,0,0,0
2019-02-16 21:30,47,17,30,0,0,0
2019-02-16 21:45,35,17,18,0,0,0
2019-02-16 22:00,23,10,13,0,0,0
2019-02-16 22:15,27,12,15,0,0,0
2019-02-16 22:30,35,24,11,0,0,0
2019-02-16 22:45,21,8,13,0,0,0
2019-02-16 23:00,33,15,18,0,0,0
2019-02-16 23:15,27,10,17,0,0,0
2019-02-16 23:30,30,16,14,0,0,0
2019-02-16 23:45,30,13,17,0,0,0
2019-02-17 00:00,22,11,11,0,0,0
2019-02-17 00:15,25,9,16,0,0,0
2019-02-17 00:30,35,21,14,0,0,0
2019-02-17 00:45,20,9,11,0,0,0
2019-02-17 01:00,18,12,6,0,0,0
2019-02-17 01:15,16,3,13,0,0,0
2019-02-17 01:30,17,5,12,0,0,0
2019-02-17 01:45,14,7,7,0,0,0
2019-02-17 02:00,13,5,8,0,0,0
2019-02-17 02:15,13,2,11,0,0,0
2019-02-17 02:30,10,5,5,0,0,0
2019-02-17 02:45,15,8,7,0,0,0
2019-02-17 03:00,6,2,4,0,0,0
2019-02-17 03:15,10,2,8,0,0,0
2019-02-17 03:30,4,2,2,0,0,0
2019-02-17 03:45,7,2,5,0,0,0
2019-02-17 04:00,1,0,1,0,0,0
2019-02-17 04:15,8,1,7,0,0,0
2019-02-17 04:30,3,0,3,0,0,0
2019-02-17 04:45,2,0,2,0,0,0
2019-02-17 05:00,4,3,1,0,0,0
2019-02-17 05:15,2,1,1,0,0,0
2019-02-17 05:30,4,3,1,0,0,0
2019-02-17 05:45,6,4,2,0,0,0
2019-02-17 06:00,4,2,2,0,0,0
2019-02-17 06:15,9,7,2,0,0,0
2019-02-17 06:30,0,0,0,0,0,0
2019-02-17 06:45,2,1,1,0,0,0
2019-02-17 07:00,3,2,1,0,0,0
2019-02-17 07:15,4,2,2,0,0,0
2019-02-17 07:30,11,8,3,0,0,0
2019-02-17 07:45,9,7,2,0,0,0
2019-02-17 08:00,4,4,0,0,0,0
2019-02-17 08:15,11,8,3,0,0,0
2019-02-17 08:30,13,12,1,0,0,0
2019-02-17 08:45,22,14,8,0,0,0
2019-02-17 09:00,15,6,9,0,0,0
2019-02-17 09:15,23,17,6,0,0,0
2019-02-17 09:30,34,27,7,0,0,0
2019-02-17 09:45,62,53,9,0,0,0
2019-02-17 10:00,41,27,14,0,0,0
2019-02-17 10:15,42,27,15,0,0,0
2019-02-17 10:30,29,21,8,0,0,0
2019-02-17 10:45,65,46,19,0,0,0
2019-02-17 11:00,47,35,12,0,0,0
2019-02-17 11:15,51,37,14,0,0,0
2019-02-17 11:30,41,30,11,0,0,0
2019-02-17 11:45,49,27,22,0,0,0
2019-02-17 12:00,56,38,18,0,0,0
2019-02-17 12:15,56,35,21,0,0,0
2019-02-17 12:30,80,53,27,0,0,0
2019-02-17 12:45,99,61,38,0,0,0
2019-02-17 13:00,96,61,35,0,0,0
2019-02-17 13:15,67,46,21,0,0,0
2019-02-17 13:30,76,54,22,0,0,0
2019-02-17 13:45,102,62,40,0,0,0
2019-02-17 14:00,78,50,28,0,0,0
2019-02-17 14:15,83,48,35,0,0,0
2019-02-17 14:30,88,53,35,0,0,0
2019-02-17 14:45,100,60,40,0,0,0
2019-02-17 15:00,79,52,27,0,0,0
2019-02-17 15:15,94,67,27,0,0,0
2019-02-17 15:30,96,65,31,0,0,0
2019-02-17 15:45,111,69,42,0,0,0
2019-02-17 16:00,115,61,54,0,0,0
2019-02-17 16:15,83,39,44,0,0,0
2019-02-17 16:30,98,61,37,0,0,0
2019-02-17 16:45,84,50,34,0,0,0
2019-02-17 17:00,69,40,29,0,0,0
2019-02-17 17:15,107,64,43,0,0,0
2019-02-17 17:30,109,57,52,0,0,0
2019-02-17 17:45,97,63,34,0,0,0
2019-02-17 18:00,49,20,29,0,0,0
2019-02-17 18:15,78,47,31,0,0,0
2019-02-17 18:30,36,17,19,0,0,0
2019-02-17 18:45,48,22,26,0,0,0
2019-02-17 19:00,54,21,33,0,0,0
2019-02-17 19:15,40,18,22,0,0,0
2019-02-17 19:30,30,17,13,0,0,0
2019-02-17 19:45,45,35,10,0,0,0
2019-02-17 20:00,38,15,23,0,0,0
2019-02-17 20:15,30,12,18,0,0,0
2019-02-17 20:30,29,16,13,0,0,0
2019-02-17 20:45,41,17,24,0,0,0
2019-02-17 21:00,30,14,16,0,0,0
2019-02-17 21:15,25,12,13,0,0,0
2019-02-17 21:30,17,2,15,0,0,0
2019-02-17 21:45,31,14,17,0,0,0
2019-02-17 22:00,26,16,10,0,0,0
2019-02-17 22:15,17,6,11,0,0,0
2019-02-17 22:30,15,10,5,0,0,0
2019-02-17 22:45,16,6,10,0,0,0
2019-02-17 23:00,10,3,7,0,0,0
2019-02-17 23:15,8,1,7,0,0,0
2019-02-17 23:30,3,1,2,0,0,0
2019-02-17 23:45,4,2,2,0,0,0
2019-02-18 00:00,2,2,0,0,0,0
2019-02-18 00:15,2,1,1,0,0,0
2019-02-18 00:30,2,1,1,0,0,0
2019-02-18 00:45,2,1,1,0,0,0
2019-02-18 01:00,3,2,1,0,0,0
2019-02-18 01:15,1,1,0,0,0,0
2019-02-18 01:30,1,1,0,0,0,0
2019-02-18 01:45,6,1,5,0,0,0
2019-02-18 02:00,1,0,1,0,0,0
2019-02-18 02:15,2,1,1,0,0,0
2019-02-18 02:30,0,0,0,0,0,0
2019-02-18 02:45,1,1,0,0,0,0
2019-02-18 03:00,1,0,1,0,0,0
2019-02-18 03:15,0,0,0,0,0,0
2019-02-18 03:30,0,0,0,0,0,0
2019-02-18 03:45,2,1,1,0,0,0
2019-02-18 04:00,0,0,0,0,0,0
2019-02-18 04:15,1,0,1,0,0,0
2019-02-18 04:30,0,0,0,0,0,0
2019-02-18 04:45,1,0,1,0,0,0
2019-02-18 05:00,1,0,1,0,0,0
2019-02-18 05:15,9,5,4,0,0,0
2019-02-18 05:30,8,7,1,0,0,0
2019-02-18 05:45,13,6,7,0,0,0
2019-02-18 06:00,11,7,4,0,0,0
2019-02-18 06:15,28,15,13,0,0,0
2019-02-18 06:30,43,25,18,0,0,0
2019-02-18 06:45,58,43,15,0,0,0
2019-02-18 07:00,83,61,22,0,0,0
2019-02-18 07:15,161,130,31,0,0,0
2019-02-18 07:30,309,261,48,0,0,0
2019-02-18 07:45,198,134,64,0,0,0
2019-02-18 08:00,148,115,33,0,0,0
2019-02-18 08:15,124,101,23,0,0,0
2019-02-18 08:30,140,110,30,0,0,0
2019-02-18 08:45,162,134,28,0,0,0
2019-02-18 09:00,115,97,18,0,0,0
2019-02-18 09:15,118,86,32,0,0,0
2019-02-18 09:30,105,89,16,0,0,0
2019-02-18 09:45,112,90,22,0,0,0
2019-02-18 10:00,83,58,25,0,0,0
2019-02-18 10:15,71,54,17,0,0,0
2019-02-18 10:30,71,51,20,0,0,0
2019-02-18 10:45,100,73,27,0,0,0
2019-02-18 11:00,96,68,28,0,0,0
2019-02-18 11:15,96,61,35,0,0,0
2019-02-18 11:30,99,67,32,0,0,0
2019-02-18 11:45,98,62,36,0,0,0
2019-02-18 12:00,98,59,39,0,0,0
2019-02-18 12:15,105,69,36,0,0,0
2019-02-18 12:30,126,63,63,0,0,0
2019-02-18 12:45,99,54,45,0,0,0
2019-02-18 13:00,128,61,67,0,0,0
2019-02-18 13:15,117,61,56,0,0,0
2019-02-18 13:30,125,75,50,0,0,0
2019-02-18 13:45,124,68,56,0,0,0
2019-02-18 14:00,156,65,91,0,0,0
2019-02-18 14:15,129,67,62,0,0,0
2019-02-18 14:30,112,59,53,0,0,0
2019-02-18 14:45,134,80,54,0,0,0
2019-02-18 15:00,161,104,57,0,0,0
2019-02-18 15:15,126,73,53,0,0,0
2019-02-18 15:30,196,101,95,0,0,0
2019-02-18 15:45,172,86,86,0,0,0
2019-02-18 16:00,183,106,77,0,0,0
2019-02-18 16:15,180,107,73,0,0,0
2019-02-18 16:30,184,89,95,0,0,0
2019-02-18 16:45,186,95,91,0,0,0
2019-02-18 17:00,177,83,94,0,0,0
2019-02-18 17:15,156,78,78,0,0,0
2019-02-18 17:30,189,92,97,0,0,0
2019-02-18 17:45,186,87,99,0,0,0
2019-02-18 18:00,190,80,110,0,0,0
2019-02-18 18:15,152,62,90,0,0,0
2019-02-18 18:30,127,63,64,0,0,0
2019-02-18 18:45,122,64,58,0,0,0
2019-02-18 19:00,93,43,50,0,0,0
2019-02-18 19:15,109,58,51,0,0,0
2019-02-18 19:30,74,35,39,0,0,0
2019-02-18 19:45,83,36,47,0,0,0
2019-02-18 20:00,66,17,49,0,0,0
2019-02-18 20:15,65,31,34,0,0,0
2019-02-18 20:30,58,14,44,0,0,0
2019-02-18 20:45,32,20,12,0,0,0
2019-02-18 21:00,43,23,20,0,0,0
2019-02-18 21:15,36,23,13,0,0,0
2019-02-18 21:30,35,17,18,0,0,0
2019-02-18 21:45,32,16,16,0,0,0
2019-02-18 22:00,32,17,15,0,0,0
2019-02-18 22:15,43,18,25,0,0,0
2019-02-18 22:30,41,16,25,0,0,0
2019-02-18 22:45,30,21,9,0,0,0
2019-02-18 23:00,24,11,13,0,0,0
2019-02-18 23:15,37,32,5,0,0,0
2019-02-18 23:30,13,5,8,0,0,0
2019-02-18 23:45,5,3,2,0,0,0
2019-02-19 00:00,8,4,4,0,0,0
2019-02-19 00:15,10,6,4,0,0,0
2019-02-19 00:30,3,2,1,0,0,0
2019-02-19 00:45,2,0,2,0,0,0
2019-02-19 01:00,5,1,4,0,0,0
2019-02-19 01:15,3,0,3,0,0,0
2019-02-19 01:30,1,0,1,0,0,0
2019-02-19 01:45,1,1,0,0,0,0
2019-02-19 02:00,5,4,1,0,0,0
2019-02-19 02:15,0,0,0,0,0,0
2019-02-19 02:30,3,2,1,0,0,0
2019-02-19 02:45,0,0,0,0,0,0
2019-02-19 03:00,0,0,0,0,0,0
2019-02-19 03:15,0,0,0,0,0,0
2019-02-19 03:30,1,1,0,0,0,0
2019-02-19 03:45,3,3,0,0,0,0
2019-02-19 04:00,0,0,0,0,0,0
2019-02-19 04:15,0,0,0,0,0,0
2019-02-19 04:30,0,0,0,0,0,0
2019-02-19 04:45,1,0,1,0,0,0
2019-02-19 05:00,3,1,2,0,0,0
2019-02-19 05:15,4,2,2,0,0,0
2019-02-19 05:30,14,11,3,0,0,0
2019-02-19 05:45,15,5,10,0,0,0
2019-02-19 06:00,11,9,2,0,0,0
2019-02-19 06:15,23,15,8,0,0,0
2019-02-19 06:30,41,24,17,0,0,0
2019-02-19 06:45,64,45,19,0,0,0
2019-02-19 07:00,78,59,19,0,0,0
2019-02-19 07:15,163,118,45,0,0,0
2019-02-19 07:30,306,260,46,0,0,0
2019-02-19 07:45,217,149,68,0,0,0
2019-02-19 08:00,143,105,38,0,0,0
2019-02-19 08:15,147,108,39,0,0,0
2019-02-19 08:30,152,117,35,0,0,0
2019-02-19 08:45,173,140,33,0,0,0
2019-02-19 09:00,93,68,25,0,0,0
2019-02-19 09:15,98,74,24,0,0,0
2019-02-19 09:30,88,70,18,0,0,0
2019-02-19 09:45,125,102,23,0,0,0
2019-02-19 10:00,89,71,18,0,0,0
2019-02-19 10:15,66,45,21,0,0,0
2019-02-19 10:30,98,64,34,0,0,0
2019-02-19 10:45,100,67,33,0,0,0
2019-02-19 11:00,85,55,30,0,0,0
2019-02-19 11:15,67,45,22,0,0,0
2019-02-19 11:30,72,51,21,0,0,0
2019-02-19 11:45,117,74,43,0,0,0
2019-02-19 12:00,108,57,51,0,0,0
2019-02-19 12:15,106,61,45,0,0,0
2019-02-19 12:30,112,54,58,0,0,0
2019-02-19 12:45,116,65,51,0,0,0
2019-02-19 13:00,144,58,86,0,0,0
2019-02-19 13:15,140,62,78,0,0,0
2019-02-19 13:30,112,65,47,0,0,0
2019-02-19 13:45,136,65,71,0,0,0
2019-02-19 14:00,119,42,77,0,0,0
2019-02-19 14:15,98,53,45,0,0,0
2019-02-19 14:30,87,45,42,0,0,0
2019-02-19 14:45,132,62,70,0,0,0
2019-02-19 15:00,118,61,57,0,0,0
2019-02-19 15:15,122,69,53,0,0,0
2019-02-19 15:30,146,75,71,0,0,0
2019-02-19 15:45,140,79,61,0,0,0
2019-02-19 16:00,158,90,68,0,0,0
2019-02-19 16:15,150,80,70,0,0,0
2019-02-19 16:30,172,75,97,0,0,0
2019-02-19 16:45,168,98,70,0,0,0
2019-02-19 17:00,155,86,69,0,0,0
2019-02-19 17:15,160,70,90,0,0,0
2019-02-19 17:30,173,90,83,0,0,0
2019-02-19 17:45,142,71,71,0,0,0
2019-02-19 18:00,146,72,74,0,0,0
2019-02-19 18:15,142,74,68,0,0,0
2019-02-19 18:30,100,41,59,0,0,0
2019-02-19 18:45,122,50,72,0,0,0
2019-02-19 19:00,93,48,45,0,0,0
2019-02-19 19:15,85,47,38,0,0,0
2019-02-19 19:30,103,60,43,0,0,0
2019-02-19 19:45,104,56,48,0,0,0
2019-02-19 20:00,68,40,28,0,0,0
2019-02-19 20:15,77,35,42,0,0,0
2019-02-19 20:30,50,29,21,0,0,0
2019-02-19 20:45,50,26,24,0,0,0
2019-02-19 21:00,49,22,27,0,0,0
2019-02-19 21:15,34,19,15,0,0,0
2019-02-19 21:30,53,24,29,0,0,0
2019-02-19 21:45,42,8,34,0,0,0
2019-02-19 22:00,38,23,15,0,0,0
2019-02-19 22:15,49,22,27,0,0,0
2019-02-19 22:30,37,21,16,0,0,0
2019-02-19 22:45,27,10,17,0,0,0
2019-02-19 23:00,63,27,36,0,0,0
2019-02-19 23:15,20,5,15,0,0,0
2019-02-19 23:30,20,6,14,0,0,0
2019-02-19 23:45,13,5,8,0,0,0
2019-02-20 00:00,8,5,3,0,0,0
2019-02-20 00:15,10,5,5,0,0,0
2019-02-20 00:30,5,3,2,0,0,0
2019-02-20 00:45,7,1,6,0,0,0
2019-02-20 01:00,5,0,5,0,0,0
2019-02-20 01:15,2,1,1,0,0,0
2019-02-20 01:30,0,0,0,0,0,0
2019-02-20 01:45,7,5,2,0,0,0
2019-02-20 02:00,0,0,0,0,0,0
2019-02-20 02:15,2,0,2,0,0,0
2019-02-20 02:30,0,0,0,0,0,0
2019-02-20 02:45,1,1,0,0,0,0
2019-02-20 03:00,1,1,0,0,0,0
2019-02-20 03:15,1,0,1,0,0,0
2019-02-20 03:30,2,2,0,0,0,0
2019-02-20 03:45,0,0,0,0,0,0
2019-02-20 04:00,1,0,1,0,0,0
2019-02-20 04:15,1,1,0,0,0,0
2019-02-20 04:30,0,0,0,0,0,0
2019-02-20 04:45,1,0,1,0,0,0
2019-02-20 05:00,2,1,1,0,0,0
2019-02-20 05:15,5,3,2,0,0,0
2019-02-20 05:30,15,12,3,0,0,0
2019-02-20 05:45,18,9,9,0,0,0
2019-02-20 06:00,15,11,4,0,0,0
2019-02-20 06:15,23,14,9,0,0,0
2019-02-20 06:30,50,29,21,0,0,0
2019-02-20 06:45,61,41,20,0,0,0
2019-02-20 07:00,69,47,22,0,0,0
2019-02-20 07:15,155,126,29,0,0,0
2019-02-20 07:30,309,256,53,0,0,0
2019-02-20 07:45,207,153,54,0,0,0
2019-02-20 08:00,149,115,34,0,0,0
2019-02-20 08:15,157,118,39,0,0,0
2019-02-20 08:30,164,122,42,0,0,0
2019-02-20 08:45,186,148,38,0,0,0
2019-02-20 09:00,88,88,0,0,0,0
2019-02-20 09:15,98,85,13,0,0,0
2019-02-20 09:30,131,101,30,0,0,0
2019-02-20 09:45,127,102,25,0,0,0
2019-02-20 10:00,88,70,18,0,0,0
2019-02-20 10:15,100,64,36,0,0,0
2019-02-20 10:30,106,77,29,0,0,0
2019-02-20 10:45,116,81,35,0,0,0
2019-02-20 11:00,97,64,33,0,0,0
2019-02-20 11:15,87,64,23,0,0,0
2019-02-20 11:30,127,74,53,0,0,0
2019-02-20 11:45,131,90,41,0,0,0
2019-02-20 12:00,104,60,44,0,0,0
2019-02-20 12:15,126,67,59,0,0,0
2019-02-20 12:30,107,48,59,0,0,0
2019-02-20 12:45,138,73,65,0,0,0
2019-02-20 13:00,117,69,48,0,0,0
2019-02-20 13:15,166,80,86,0,0,0
2019-02-20 13:30,126,71,55,0,0,0
2019-02-20 13:45,137,63,74,0,0,0
2019-02-20 14:00,155,62,93,0,0,0
2019-02-20 14:15,109,54,55,0,0,0
2019-02-20 14:30,108,50,58,0,0,0
2019-02-20 14:45,135,66,69,0,0,0
2019-02-20 15:00,123,59,64,0,0,0
2019-02-20 15:15,115,63,52,0,0,0
2019-02-20 15:30,156,76,80,0,0,0
2019-02-20 15:45,122,70,52,0,0,0
2019-02-20 16:00,177,106,71,0,0,0
2019-02-20 16:15,144,80,64,0,0,0
2019-02-20 16:30,152,77,75,0,0,0
2019-02-20 16:45,148,81,67,0,0,0
2019-02-20 17:00,155,81,74,0,0,0
2019-02-20 17:15,159,79,80,0,0,0
2019-02-20 17:30,147,61,86,0,0,0
2019-02-20 17:45,172,94,78,0,0,0
2019-02-20 18:00,163,84,79,0,0,0
2019-02-20 18:15,122,61,61,0,0,0
2019-02-20 18:30,111,56,55,0,0,0
2019-02-20 18:45,121,58,63,0,0,0
2019-02-20 19:00,103,51,52,0,0,0
2019-02-20 19:15,115,58,57,0,0,0
2019-02-20 19:30,89,46,43,0,0,0
2019-02-20 19:45,95,56,39,0,0,0
2019-02-20 20:00,91,48,43,0,0,0
2019-02-20 20:15,61,29,32,0,0,0
2019-02-20 20:30,57,25,32,0,0,0
2019-02-20 20:45,45,22,23,0,0,0
2019-02-20 21:00,44,15,29,0,0,0
2019-02-20 21:15,45,24,21,0,0,0
2019-02-20 21:30,36,17,19,0,0,0
2019-02-20 21:45,55,24,31,0,0,0
2019-02-20 22:00,58,26,32,0,0,0
2019-02-20 22:15,43,24,19,0,0,0
2019-02-20 22:30,52,29,23,0,0,0
2019-02-20 22:45,30,18,12,0,0,0
2019-02-20 23:00,28,8,20,0,0,0
2019-02-20 23:15,26,14,12,0,0,0
2019-02-20 23:30,18,6,12,0,0,0
2019-02-20 23:45,12,2,10,0,0,0
2019-02-21 00:00,24,15,9,0,0,0
2019-02-21 00:15,8,6,2,0,0,0
2019-02-21 00:30,10,4,6,0,0,0
2019-02-21 00:45,29,26,3,0,0,0
2019-02-21 01:00,20,17,3,0,0,0
2019-02-21 01:15,16,11,5,0,0,0
2019-02-21 01:30,6,1,5,0,0,0
2019-02-21 01:45,6,2,4,0,0,0
2019-02-21 02:00,5,4,1,0,0,0
2019-02-21 02:15,1,0,1,0,0,0
2019-02-21 02:30,4,2,2,0,0,0
2019-02-21 02:45,4,1,3,0,0,0
2019-02-21 03:00,3,0,3,0,0,0
2019-02-21 03:15,2,0,2,0,0,0
2019-02-21 03:30,2,1,1,0,0,0
2019-02-21 03:45,1,0,1,0,0,0
2019-02-21 04:00,1,0,1,0,0,0
2019-02-21 04:15,1,0,1,0,0,0
2019-02-21 04:30,1,0,1,0,0,0
2019-02-21 04:45,2,0,2,0,0,0
2019-02-21 05:00,4,3,1,0,0,0
2019-02-21 05:15,5,2,3,0,0,0
2019-02-21 05:30,10,7,3,0,0,0
2019-02-21 05:45,14,4,10,0,0,0
2019-02-21 06:00,16,12,4,0,0,0
2019-02-21 06:15,16,7,9,0,0,0
2019-02-21 06:30,44,27,17,0,0,0
2019-02-21 06:45,84,56,28,0,0,0
2019-02-21 07:00,72,57,15,0,0,0
2019-02-21 07:15,173,138,35,0,0,0
2019-02-21 07:30,293,243,50,0,0,0
2019-02-21 07:45,183,131,52,0,0,0
2019-02-21 08:00,151,115,36,0,0,0
2019-02-21 08:15,141,106,35,0,0,0
2019-02-21 08:30,159,129,30,0,0,0
2019-02-21 08:45,152,125,27,0,0,0
2019-02-21 09:00,106,82,24,0,0,0
2019-02-21 09:15,109,87,22,0,0,0
2019-02-21 09:30,119,95,24,0,0,0
2019-02-21 09:45,121,102,19,0,0,0
2019-02-21 10:00,107,65,42,0,0,0
2019-02-21 10:15,87,55,32,0,0,0
2019-02-21 10:30,73,48,25,0,0,0
2019-02-21 10:45,74,54,20,0,0,0
2019-02-21 11:00,93,60,33,0,0,0
2019-02-21 11:15,91,58,33,0,0,0
2019-02-21 11:30,82,49,33,0,0,0
2019-02-21 11:45,92,53,39,0,0,0
2019-02-21 12:00,85,55,30,0,0,0
2019-02-21 12:15,101,54,47,0,0,0
2019-02-21 12:30,87,39,48,0,0,0
2019-02-21 12:45,101,54,47,0,0,0
2019-02-21 13:00,119,52,67,0,0,0
2019-02-21 13:15,112,49,63,0,0,0
2019-02-21 13:30,98,61,37,0,0,0
2019-02-21 13:45,103,51,52,0,0,0
2019-02-21 14:00,121,46,75,0,0,0
2019-02-21 14:15,101,52,49,0,0,0
2019-02-21 14:30,106,59,47,0,0,0
2019-02-21 14:45,123,75,48,0,0,0
2019-02-21 15:00,112,66,46,0,0,0
2019-02-21 15:15,126,72,54,0,0,0
2019-02-21 15:30,126,60,66,0,0,0
2019-02-21 15:45,151,80,71,0,0,0
2019-02-21 16:00,152,100,52,0,0,0
2019-02-21 16:15,126,65,61,0,0,0
2019-02-21 16:30,144,70,74,0,0,0
2019-02-21 16:45,140,79,61,0,0,0
2019-02-21 17:00,151,71,80,0,0,0
2019-02-21 17:15,150,71,79,0,0,0
2019-02-21 17:30,140,76,64,0,0,0
2019-02-21 17:45,161,98,63,0,0,0
2019-02-21 18:00,149,73,76,0,0,0
2019-02-21 18:15,129,71,58,0,0,0
2019-02-21 18:30,122,65,57,0,0,0
2019-02-21 18:45,107,62,45,0,0,0
2019-02-21 19:00,107,55,52,0,0,0
2019-02-21 19:15,91,46,45,0,0,0
2019-02-21 19:30,85,39,46,0,0,0
2019-02-21 19:45,87,44,43,0,0,0
2019-02-21 20:00,78,26,52,0,0,0
2019-02-21 20:15,54,24,30,0,0,0
2019-02-21 20:30,51,18,33,0,0,0
2019-02-21 20:45,51,21,30,0,0,0
2019-02-21 21:00,36,18,18,0,0,0
2019-02-21 21:15,27,16,11,0,0,0
2019-02-21 21:30,48,17,31,0,0,0
2019-02-21 21:45,36,20,16,0,0,0
2019-02-21 22:00,47,18,29,0,0,0
2019-02-21 22:15,45,23,22,0,0,0
2019-02-21 22:30,46,25,21,0,0,0
2019-02-21 22:45,25,15,10,0,0,0
2019-02-21 23:00,27,16,11,0,0,0
2019-02-21 23:15,40,26,14,0,0,0
2019-02-21 23:30,18,8,10,0,0,0
2019-02-21 23:45,16,9,7,0,0,0
2019-02-22 00:00,7,3,4,0,0,0
2019-02-22 00:15,5,3,2,0,0,0
2019-02-22 00:30,7,4,3,0,0,0
2019-02-22 00:45,14,9,5,0,0,0
2019-02-22 01:00,6,1,5,0,0,0
2019-02-22 01:15,3,3,0,0,0,0
2019-02-22 01:30,6,3,3,0,0,0
2019-02-22 01:45,4,2,2,0,0,0
2019-02-22 02:00,4,0,4,0,0,0
2019-02-22 02:15,0,0,0,0,0,0
2019-02-22 02:30,4,0,4,0,0,0
2019-02-22 02:45,2,2,0,0,0,0
2019-02-22 03:00,2,0,2,0,0,0
2019-02-22 03:15,0,0,0,0,0,0
2019-02-22 03:30,1,1,0,0,0,0
2019-02-22 03:45,1,0,1,0,0,0
2019-02-22 04:00,1,0,1,0,0,0
2019-02-22 04:15,3,1,2,0,0,0
2019-02-22 04:30,0,0,0,0,0,0
2019-02-22 04:45,1,0,1,0,0,0
2019-02-22 05:00,6,3,3,0,0,0
2019-02-22 05:15,5,3,2,0,0,0
2019-02-22 05:30,16,11,5,0,0,0
2019-02-22 05:45,18,7,11,0,0,0
2019-02-22 06:00,12,9,3,0,0,0
2019-02-22 06:15,20,9,11,0,0,0
2019-02-22 06:30,50,33,17,0,0,0
2019-02-22 06:45,58,43,15,0,0,0
2019-02-22 07:00,72,52,20,0,0,0
2019-02-22 07:15,147,108,39,0,0,0
2019-02-22 07:30,278,234,44,0,0,0
2019-02-22 07:45,209,144,65,0,0,0
2019-02-22 08:00,142,113,29,0,0,0
2019-02-22 08:15,122,91,31,0,0,0
2019-02-22 08:30,125,101,24,0,0,0
2019-02-22 08:45,126,97,29,0,0,0
2019-02-22 09:00,103,81,22,0,0,0
2019-02-22 09:15,94,72,22,0,0,0
2019-02-22 09:30,109,85,24,0,0,0
2019-02-22 09:45,118,99,19,0,0,0
2019-02-22 10:00,83,65,18,0,0,0
2019-02-22 10:15,75,57,18,0,0,0
2019-02-22 10:30,94,71,23,0,0,0
2019-02-22 10:45,95,59,36,0,0,0
2019-02-22 11:00,77,48,29,0,0,0
2019-02-22 11:15,114,80,34,0,0,0
2019-02-22 11:30,110,77,33,0,0,0
2019-02-22 11:45,118,72,46,0,0,0
2019-02-22 12:00,105,69,36,0,0,0
2019-02-22 12:15,115,62,53,0,0,0
2019-02-22 12:30,132,73,59,0,0,0
2019-02-22 12:45,114,70,44,0,0,0
2019-02-22 13:00,162,75,87,0,0,0
2019-02-22 13:15,127,63,64,0,0,0
2019-02-22 13:30,106,54,52,0,0,0
2019-02-22 13:45,129,68,61,0,0,0
2019-02-22 14:00,145,67,78,0,0,0
2019-02-22 14:15,142,75,67,0,0,0
2019-02-22 14:30,123,68,55,0,0,0
2019-02-22 14:45,136,81,55,0,0,0
2019-02-22 15:00,140,76,64,0,0,0
2019-02-22 15:15,131,77,54,0,0,0
2019-02-22 15:30,136,82,54,0,0,0
2019-02-22 15:45,162,95,67,0,0,0
2019-02-22 16:00,177,112,65,0,0,0
2019-02-22 16:15,173,108,65,0,0,0
2019-02-22 16:30,161,92,69,0,0,0
2019-02-22 16:45,158,109,49,0,0,0
2019-02-22 17:00,190,120,70,0,0,0
2019-02-22 17:15,201,129,72,0,0,0
2019-02-22 17:30,140,92,48,0,0,0
2019-02-22 17:45,165,96,69,0,0,0
2019-02-22 18:00,120,75,45,0,0,0
2019-02-22 18:15,144,80,64,0,0,0
2019-02-22 18:30,107,46,61,0,0,0
2019-02-22 18:45,152,74,78,0,0,0
2019-02-22 19:00,128,55,73,0,0,0
2019-02-22 19:15,142,70,72,0,0,0
2019-02-22 19:30,90,32,58,0,0,0
2019-02-22 19:45,114,51,63,0,0,0
2019-02-22 20:00,80,32,48,0,0,0
2019-02-22 20:15,83,42,41,0,0,0
2019-02-22 20:30,60,31,29,0,0,0
2019-02-22 20:45,63,38,25,0,0,0
2019-02-22 21:00,56,28,28,0,0,0
2019-02-22 21:15,48,18,30,0,0,0
2019-02-22 21:30,45,13,32,0,0,0
2019-02-22 21:45,52,20,32,0,0,0
2019-02-22 22:00,44,15,29,0,0,0
2019-02-22 22:15,66,37,29,0,0,0
2019-02-22 22:30,42,18,24,0,0,0
2019-02-22 22:45,39,20,19,0,0,0
2019-02-22 23:00,54,27,27,0,0,0
2019-02-22 23:15,29,13,16,0,0,0
2019-02-22 23:30,39,20,19,0,0,0
2019-02-22 23:45,30,11,19,0,0,0
2019-02-23 00:00,35,23,12,0,0,0
2019-02-23 00:15,50,36,14,0,0,0
2019-02-23 00:30,42,29,13,0,0,0
2019-02-23 00:45,44,30,14,0,0,0
2019-02-23 01:00,43,30,13,0,0,0
2019-02-23 01:15,27,15,12,0,0,0
2019-02-23 01:30,11,0,11,0,0,0
2019-02-23 01:45,15,4,11,0,0,0
2019-02-23 02:00,19,10,9,0,0,0
2019-02-23 02:15,9,3,6,0,0,0
2019-02-23 02:30,11,5,6,0,0,0
2019-02-23 02:45,13,3,10,0,0,0
2019-02-23 03:00,3,0,3,0,0,0
2019-02-23 03:15,9,1,8,0,0,0
2019-02-23 03:30,14,8,6,0,0,0
2019-02-23 03:45,9,4,5,0,0,0
2019-02-23 04:00,2,1,1,0,0,0
2019-02-23 04:15,1,0,1,0,0,0
2019-02-23 04:30,2,0,2,0,0,0
2019-02-23 04:45,1,0,1,0,0,0
2019-02-23 05:00,6,1,5,0,0,0
2019-02-23 05:15,4,2,2,0,0,0
2019-02-23 05:30,8,4,4,0,0,0
2019-02-23 05:45,13,6,7,0,0,0
2019-02-23 06:00,4,2,2,0,0,0
2019-02-23 06:15,4,1,3,0,0,0
2019-02-23 06:30,6,3,3,0,0,0
2019-02-23 06:45,6,4,2,0,0,0
2019-02-23 07:00,6,6,0,0,0,0
2019-02-23 07:15,11,8,3,0,0,0
2019-02-23 07:30,28,14,14,0,0,0
2019-02-23 07:45,40,30,10,0,0,0
2019-02-23 08:00,24,17,7,0,0,0
2019-02-23 08:15,29,23,6,0,0,0
2019-02-23 08:30,40,32,8,0,0,0
2019-02-23 08:45,53,44,9,0,0,0
2019-02-23 09:00,54,43,11,0,0,0
2019-02-23 09:15,71,55,16,0,0,0
2019-02-23 09:30,110,96,14,0,0,0
2019-02-23 09:45,119,95,24,0,0,0
2019-02-23 10:00,121,101,20,0,0,0
2019-02-23 10:15,108,73,35,0,0,0
2019-02-23 10:30,164,147,17,0,0,0
2019-02-23 10:45,164,133,31,0,0,0
2019-02-23 11:00,166,130,36,0,0,0
2019-02-23 11:15,135,99,36,0,0,0
2019-02-23 11:30,167,127,40,0,0,0
2019-02-23 11:45,164,104,60,0,0,0
2019-02-23 12:00,144,99,45,0,0,0
2019-02-23 12:15,159,110,49,0,0,0
2019-02-23 12:30,163,99,64,0,0,0
2019-02-23 12:45,167,103,64,0,0,0
2019-02-23 13:00,150,83,67,0,0,0
2019-02-23 13:15,163,92,71,0,0,0
2019-02-23 13:30,141,82,59,0,0,0
2019-02-23 13:45,155,89,66,0,0,0
2019-02-23 14:00,137,79,58,0,0,0
2019-02-23 14:15,116,62,54,0,0,0
2019-02-23 14:30,118,43,75,0,0,0
2019-02-23 14:45,127,64,63,0,0,0
2019-02-23 15:00,119,69,50,0,0,0
2019-02-23 15:15,152,82,70,0,0,0
2019-02-23 15:30,113,47,66,0,0,0
2019-02-23 15:45,102,65,37,0,0,0
2019-02-23 16:00,101,44,57,0,0,0
2019-02-23 16:15,106,49,57,0,0,0
2019-02-23 16:30,96,51,45,0,0,0
2019-02-23 16:45,106,43,63,0,0,0
2019-02-23 17:00,97,49,48,0,0,0
2019-02-23 17:15,94,33,61,0,0,0
2019-02-23 17:30,82,42,40,0,0,0
2019-02-23 17:45,129,60,69,0,0,0
2019-02-23 18:00,82,29,53,0,0,0
2019-02-23 18:15,78,30,48,0,0,0
2019-02-23 18:30,78,43,35,0,0,0
2019-02-23 18:45,99,70,29,0,0,0
2019-02-23 19:00,92,57,35,0,0,0
2019-02-23 19:15,80,46,34,0,0,0
2019-02-23 19:30,52,29,23,0,0,0
2019-02-23 19:45,75,35,40,0,0,0
2019-02-23 20:00,47,24,23,0,0,0
2019-02-23 20:15,47,28,19,0,0,0
2019-02-23 20:30,48,29,19,0,0,0
2019-02-23 20:45,46,31,15,0,0,0
2019-02-23 21:00,41,26,15,0,0,0
2019-02-23 21:15,32,14,18,0,0,0
2019-02-23 21:30,35,17,18,0,0,0
2019-02-23 21:45,40,15,25,0,0,0
2019-02-23 22:00,27,20,7,0,0,0
2019-02-23 22:15,40,19,21,0,0,0
2019-02-23 22:30,19,11,8,0,0,0
2019-02-23 22:45,37,17,20,0,0,0
2019-02-23 23:00,25,12,13,0,0,0
2019-02-23 23:15,27,18,9,0,0,0
2019-02-23 23:30,39,21,18,0,0,0
2019-02-23 23:45,37,19,18,0,0,0
2019-02-24 00:00,27,11,16,0,0,0
2019-02-24 00:15,28,16,12,0,0,0
2019-02-24 00:30,21,10,11,0,0,0
2019-02-24 00:45,35,12,23,0,0,0
2019-02-24 01:00,13,5,8,0,0,0
2019-02-24 01:15,16,9,7,0,0,0
2019-02-24 01:30,22,5,17,0,0,0
2019-02-24 01:45,9,1,8,0,0,0
2019-02-24 02:00,16,4,12,0,0,0
2019-02-24 02:15,23,8,15,0,0,0
2019-02-24 02:30,16,9,7,0,0,0
2019-02-24 02:45,16,6,10,0,0,0
2019-02-24 03:00,7,4,3,0,0,0
2019-02-24 03:15,0,0,0,0,0,0
2019-02-24 03:30,4,3,1,0,0,0
2019-02-24 03:45,6,1,5,0,0,0
2019-02-24 04:00,5,3,2,0,0,0
2019-02-24 04:15,6,2,4,0,0,0
2019-02-24 04:30,4,0,4,0,0,0
2019-02-24 04:45,5,1,4,0,0,0
2019-02-24 05:00,1,0,1,0,0,0
2019-02-24 05:15,2,1,1,0,0,0
2019-02-24 05:30,5,4,1,0,0,0
2019-02-24 05:45,5,0,5,0,0,0
2019-02-24 06:00,2,0,2,0,0,0
2019-02-24 06:15,9,4,5,0,0,0
2019-02-24 06:30,3,1,2,0,0,0
2019-02-24 06:45,1,1,0,0,0,0
2019-02-24 07:00,2,2,0,0,0,0
2019-02-24 07:15,4,2,2,0,0,0
2019-02-24 07:30,8,4,4,0,0,0
2019-02-24 07:45,5,3,2,0,0,0
2019-02-24 08:00,9,5,4,0,0,0
2019-02-24 08:15,14,12,2,0,0,0
2019-02-24 08:30,13,12,1,0,0,0
2019-02-24 08:45,17,12,5,0,0,0
2019-02-24 09:00,28,23,5,0,0,0
2019-02-24 09:15,22,18,4,0,0,0
2019-02-24 09:30,26,23,3,0,0,0
2019-02-24 09:45,58,51,7,0,0,0
2019-02-24 10:00,36,23,13,0,0,0
2019-02-24 10:15,53,36,17,0,0,0
2019-02-24 10:30,35,20,15,0,0,0
2019-02-24 10:45,47,27,20,0,0,0
2019-02-24 11:00,46,30,16,0,0,0
2019-02-24 11:15,53,37,16,0,0,0
2019-02-24 11:30,60,42,18,0,0,0
2019-02-24 11:45,45,20,25,0,0,0
2019-02-24 12:00,67,48,19,0,0,0
2019-02-24 12:15,54,34,20,0,0,0
2019-02-24 12:30,64,45,19,0,0,0
2019-02-24 12:45,80,56,24,0,0,0
2019-02-24 13:00,58,34,24,0,0,0
2019-02-24 13:15,79,45,34,0,0,0
2019-02-24 13:30,74,52,22,0,0,0
2019-02-24 13:45,85,58,27,0,0,0
2019-02-24 14:00,101,61,40,0,0,0
2019-02-24 14:15,77,51,26,0,0,0
2019-02-24 14:30,109,75,34,0,0,0
2019-02-24 14:45,97,57,40,0,0,0
2019-02-24 15:00,119,67,52,0,0,0
2019-02-24 15:15,117,72,45,0,0,0
2019-02-24 15:30,91,45,46,0,0,0
2019-02-24 15:45,118,68,50,0,0,0
2019-02-24 16:00,88,57,31,0,0,0
2019-02-24 16:15,94,63,31,0,0,0
2019-02-24 16:30,66,46,20,0,0,0
2019-02-24 16:45,99,73,26,0,0,0
2019-02-24 17:00,77,41,36,0,0,0
2019-02-24 17:15,88,53,35,0,0,0
2019-02-24 17:30,91,62,29,0,0,0
2019-02-24 17:45,116,77,39,0,0,0
2019-02-24 18:00,53,32,21,0,0,0
2019-02-24 18:15,50,24,26,0,0,0
2019-02-24 18:30,53,27,26,0,0,0
2019-02-24 18:45,51,27,24,0,0,0
2019-02-24 19:00,43,21,22,0,0,0
2019-02-24 19:15,32,21,11,0,0,0
2019-02-24 19:30,34,16,18,0,0,0
2019-02-24 19:45,46,20,26,0,0,0
2019-02-24 20:00,34,12,22,0,0,0
2019-02-24 20:15,36,12,24,0,0,0
2019-02-24 20:30,24,14,10,0,0,0
2019-02-24 20:45,22,9,13,0,0,0
2019-02-24 21:00,16,5,11,0,0,0
2019-02-24 21:15,26,13,13,0,0,0
2019-02-24 21:30,10,3,7,0,0,0
2019-02-24 21:45,19,8,11,0,0,0
2019-02-24 22:00,20,9,11,0,0,0
2019-02-24 22:15,19,13,6,0,0,0
2019-02-24 22:30,16,7,9,0,0,0
2019-02-24 22:45,18,12,6,0,0,0
2019-02-24 23:00,13,8,5,0,0,0
2019-02-24 23:15,15,11,4,0,0,0
2019-02-24 23:30,9,5,4,0,0,0
2019-02-24 23:45,6,3,3,0,0,0
2019-02-25 00:00,4,1,3,0,0,0
2019-02-25 00:15,1,1,0,0,0,0
2019-02-25 00:30,1,1,0,0,0,0
2019-02-25 00:45,0,0,0,0,0,0
2019-02-25 01:00,0,0,0,0,0,0
2019-02-25 01:15,2,1,1,0,0,0
2019-02-25 01:30,2,0,2,0,0,0
2019-02-25 01:45,4,1,3,0,0,0
2019-02-25 02:00,0,0,0,0,0,0
2019-02-25 02:15,0,0,0,0,0,0
2019-02-25 02:30,0,0,0,0,0,0
2019-02-25 02:45,0,0,0,0,0,0
2019-02-25 03:00,0,0,0,0,0,0
2019-02-25 03:15,0,0,0,0,0,0
2019-02-25 03:30,0,0,0,0,0,0
2019-02-25 03:45,0,0,0,0,0,0
2019-02-25 04:00,1,1,0,0,0,0
2019-02-25 04:15,0,0,0,0,0,0
2019-02-25 04:30,3,0,3,0,0,0
2019-02-25 04:45,0,0,0,0,0,0
2019-02-25 05:00,6,3,3,0,0,0
2019-02-25 05:15,8,8,0,0,0,0
2019-02-25 05:30,11,7,4,0,0,0
2019-02-25 05:45,17,8,9,0,0,0
2019-02-25 06:00,14,10,4,0,0,0
2019-02-25 06:15,29,19,10,0,0,0
2019-02-25 06:30,61,47,14,0,0,0
2019-02-25 06:45,67,51,16,0,0,0
2019-02-25 07:00,84,62,22,0,0,0
2019-02-25 07:15,189,156,33,0,0,0
2019-02-25 07:30,326,283,43,0,0,0
2019-02-25 07:45,212,148,64,0,0,0
2019-02-25 08:00,128,95,33,0,0,0
2019-02-25 08:15,137,102,35,0,0,0
2019-02-25 08:30,159,118,41,0,0,0
2019-02-25 08:45,156,119,37,0,0,0
2019-02-25 09:00,100,84,16,0,0,0
2019-02-25 09:15,112,90,22,0,0,0
2019-02-25 09:30,113,91,22,0,0,0
2019-02-25 09:45,99,74,25,0,0,0
2019-02-25 10:00,82,71,11,0,0,0
2019-02-25 10:15,79,59,20,0,0,0
2019-02-25 10:30,81,53,28,0,0,0
2019-02-25 10:45,91,55,36,0,0,0
2019-02-25 11:00,58,36,22,0,0,0
2019-02-25 11:15,106,69,37,0,0,0
2019-02-25 11:30,68,40,28,0,0,0
2019-02-25 11:45,112,76,36,0,0,0
2019-02-25 12:00,100,51,49,0,0,0
2019-02-25 12:15,109,61,48,0,0,0
2019-02-25 12:30,151,71,80,0,0,0
2019-02-25 12:45,131,75,56,0,0,0
2019-02-25 13:00,122,56,66,0,0,0
2019-02-25 13:15,116,56,60,0,0,0
2019-02-25 13:30,112,61,51,0,0,0
2019-02-25 13:45,126,70,56,0,0,0
2019-02-25 14:00,87,45,42,0,0,0
2019-02-25 14:15,106,52,54,0,0,0
2019-02-25 14:30,129,67,62,0,0,0
2019-02-25 14:45,143,80,63,0,0,0
2019-02-25 15:00,120,66,54,0,0,0
2019-02-25 15:15,142,82,60,0,0,0
2019-02-25 15:30,196,90,106,0,0,0
2019-02-25 15:45,181,106,75,0,0,0
2019-02-25 16:00,182,105,77,0,0,0
2019-02-25 16:15,151,89,62,0,0,0
2019-02-25 16:30,133,58,75,0,0,0
2019-02-25 16:45,159,98,61,0,0,0
2019-02-25 17:00,182,91,91,0,0,0
2019-02-25 17:15,164,97,67,0,0,0
2019-02-25 17:30,167,86,81,0,0,0
2019-02-25 17:45,137,66,71,0,0,0
2019-02-25 18:00,160,70,90,0,0,0
2019-02-25 18:15,141,67,74,0,0,0
2019-02-25 18:30,125,62,63,0,0,0
2019-02-25 18:45,122,72,50,0,0,0
2019-02-25 19:00,94,41,53,0,0,0
2019-02-25 19:15,97,46,51,0,0,0
2019-02-25 19:30,81,42,39,0,0,0
2019-02-25 19:45,85,43,42,0,0,0
2019-02-25 20:00,70,28,42,0,0,0
2019-02-25 20:15,49,16,33,0,0,0
2019-02-25 20:30,54,26,28,0,0,0
2019-02-25 20:45,60,30,30,0,0,0
2019-02-25 21:00,33,17,16,0,0,0
2019-02-25 21:15,35,18,17,0,0,0
2019-02-25 21:30,48,25,23,0,0,0
2019-02-25 21:45,37,17,20,0,0,0
2019-02-25 22:00,29,14,15,0,0,0
2019-02-25 22:15,36,19,17,0,0,0
2019-02-25 22:30,26,15,11,0,0,0
2019-02-25 22:45,28,12,16,0,0,0
2019-02-25 23:00,28,11,17,0,0,0
2019-02-25 23:15,18,11,7,0,0,0
2019-02-25 23:30,13,6,7,0,0,0
2019-02-25 23:45,6,0,6,0,0,0
2019-02-26 00:00,6,3,3,0,0,0
2019-02-26 00:15,2,1,1,0,0,0
2019-02-26 00:30,7,6,1,0,0,0
2019-02-26 00:45,3,0,3,0,0,0
2019-02-26 01:00,1,0,1,0,0,0
2019-02-26 01:15,4,0,4,0,0,0
2019-02-26 01:30,0,0,0,0,0,0
2019-02-26 01:45,4,1,3,0,0,0
2019-02-26 02:00,1,0,1,0,0,0
2019-02-26 02:15,0,0,0,0,0,0
2019-02-26 02:30,3,0,3,0,0,0
2019-02-26 02:45,2,0,2,0,0,0
2019-02-26 03:00,0,0,0,0,0,0
2019-02-26 03:15,0,0,0,0,0,0
2019-02-26 03:30,1,1,0,0,0,0
2019-02-26 03:45,0,0,0,0,0,0
2019-02-26 04:00,2,2,0,0,0,0
2019-02-26 04:15,0,0,0,0,0,0
2019-02-26 04:30,2,0,2,0,0,0
2019-02-26 04:45,0,0,0,0,0,0
2019-02-26 05:00,0,0,0,0,0,0
2019-02-26 05:15,11,9,2,0,0,0
2019-02-26 05:30,8,4,4,0,0,0
2019-02-26 05:45,20,12,8,0,0,0
2019-02-26 06:00,13,10,3,0,0,0
2019-02-26 06:15,26,16,10,0,0,0
2019-02-26 06:30,52,38,14,0,0,0
2019-02-26 06:45,75,58,17,0,0,0
2019-02-26 07:00,91,73,18,0,0,0
2019-02-26 07:15,186,147,39,0,0,0
2019-02-26 07:30,342,291,51,0,0,0
2019-02-26 07:45,217,147,70,0,0,0
2019-02-26 08:00,150,127,23,0,0,0
2019-02-26 08:15,150,118,32,0,0,0
2019-02-26 08:30,193,150,43,0,0,0
2019-02-26 08:45,151,130,21,0,0,0
2019-02-26 09:00,117,86,31,0,0,0
2019-02-26 09:15,115,76,39,0,0,0
2019-02-26 09:30,105,78,27,0,0,0
2019-02-26 09:45,121,94,27,0,0,0
2019-02-26 10:00,84,64,20,0,0,0
2019-02-26 10:15,89,67,22,0,0,0
2019-02-26 10:30,100,69,31,0,0,0
2019-02-26 10:45,111,78,33,0,0,0
2019-02-26 11:00,71,45,26,0,0,0
2019-02-26 11:15,84,52,32,0,0,0
2019-02-26 11:30,87,54,33,0,0,0
2019-02-26 11:45,104,67,37,0,0,0
2019-02-26 12:00,87,46,41,0,0,0
2019-02-26 12:15,116,72,44,0,0,0
2019-02-26 12:30,114,59,55,0,0,0
2019-02-26 12:45,117,64,53,0,0,0
2019-02-26 13:00,141,75,66,0,0,0
2019-02-26 13:15,129,67,62,0,0,0
2019-02-26 13:30,130,80,50,0,0,0
2019-02-26 13:45,130,70,60,0,0,0
2019-02-26 14:00,128,51,77,0,0,0
2019-02-26 14:15,117,66,51,0,0,0
2019-02-26 14:30,127,69,58,0,0,0
2019-02-26 14:45,156,94,62,0,0,0
2019-02-26 15:00,148,86,62,0,0,0
2019-02-26 15:15,161,87,74,0,0,0
2019-02-26 15:30,183,108,75,0,0,0
2019-02-26 15:45,206,121,85,0,0,0
2019-02-26 16:00,170,105,65,0,0,0
2019-02-26 16:15,192,99,93,0,0,0
2019-02-26 16:30,179,101,78,0,0,0
2019-02-26 16:45,193,114,79,0,0,0
2019-02-26 17:00,202,101,101,0,0,0
2019-02-26 17:15,175,97,78,0,0,0
2019-02-26 17:30,174,73,101,0,0,0
2019-02-26 17:45,191,90,101,0,0,0
2019-02-26 18:00,163,84,79,0,0,0
2019-02-26 18:15,159,74,85,0,0,0
2019-02-26 18:30,120,66,54,0,0,0
2019-02-26 18:45,134,66,68,0,0,0
2019-02-26 19:00,93,58,35,0,0,0
2019-02-26 19:15,93,57,36,0,0,0
2019-02-26 19:30,72,39,33,0,0,0
2019-02-26 19:45,106,59,47,0,0,0
2019-02-26 20:00,73,31,42,0,0,0
2019-02-26 20:15,39,17,22,0,0,0
2019-02-26 20:30,39,13,26,0,0,0
2019-02-26 20:45,41,16,25,0,0,0
2019-02-26 21:00,66,40,26,0,0,0
2019-02-26 21:15,48,17,31,0,0,0
2019-02-26 21:30,49,31,18,0,0,0
2019-02-26 21:45,56,19,37,0,0,0
2019-02-26 22:00,64,30,34,0,0,0
2019-02-26 22:15,43,30,13,0,0,0
2019-02-26 22:30,32,13,19,0,0,0
2019-02-26 22:45,26,10,16,0,0,0
2019-02-26 23:00,17,10,7,0,0,0
2019-02-26 23:15,30,19,11,0,0,0
2019-02-26 23:30,13,2,11,0,0,0
2019-02-26 23:45,11,6,5,0,0,0
2019-02-27 00:00,7,2,5,0,0,0
2019-02-27 00:15,8,5,3,0,0,0
2019-02-27 00:30,3,0,3,0,0,0
2019-02-27 00:45,3,2,1,0,0,0
2019-02-27 01:00,3,2,1,0,0,0
2019-02-27 01:15,1,0,1,0,0,0
2019-02-27 01:30,3,1,2,0,0,0
2019-02-27 01:45,1,0,1,0,0,0
2019-02-27 02:00,3,1,2,0,0,0
2019-02-27 02:15,1,0,1,0,0,0
2019-02-27 02:30,0,0,0,0,0,0
2019-02-27 02:45,1,0,1,0,0,0
2019-02-27 03:00,0,0,0,0,0,0
2019-02-27 03:15,0,0,0,0,0,0
2019-02-27 03:30,0,0,0,0,0,0
2019-02-27 03:45,0,0,0,0,0,0
2019-02-27 04:00,2,0,2,0,0,0
2019-02-27 04:15,3,1,2,0,0,0
2019-02-27 04:30,0,0,0,0,0,0
2019-02-27 04:45,0,0,0,0,0,0
2019-02-27 05:00,2,1,1,0,0,0
2019-02-27 05:15,7,5,2,0,0,0
2019-02-27 05:30,14,10,4,0,0,0
2019-02-27 05:45,22,12,10,0,0,0
2019-02-27 06:00,14,11,3,0,0,0
2019-02-27 06:15,29,16,13,0,0,0
2019-02-27 06:30,39,29,10,0,0,0
2019-02-27 06:45,67,48,19,0,0,0
2019-02-27 07:00,105,84,21,0,0,0
2019-02-27 07:15,162,121,41,0,0,0
2019-02-27 07:30,302,266,36,0,0,0
2019-02-27 07:45,210,159,51,0,0,0
2019-02-27 08:00,171,132,39,0,0,0
2019-02-27 08:15,158,109,49,0,0,0
2019-02-27 08:30,135,112,23,0,0,0
2019-02-27 08:45,192,151,41,0,0,0
2019-02-27 09:00,122,102,20,0,0,0
2019-02-27 09:15,123,98,25,0,0,0
2019-02-27 09:30,126,108,18,0,0,0
2019-02-27 09:45,147,114,33,0,0,0
2019-02-27 10:00,87,61,26,0,0,0
2019-02-27 10:15,89,70,19,0,0,0
2019-02-27 10:30,110,76,34,0,0,0
2019-02-27 10:45,118,91,27,0,0,0
2019-02-27 11:00,106,71,35,0,0,0
2019-02-27 11:15,128,88,40,0,0,0
2019-02-27 11:30,123,64,59,0,0,0
2019-02-27 11:45,110,69,41,0,0,0
2019-02-27 12:00,115,68,47,0,0,0
2019-02-27 12:15,158,95,63,0,0,0
2019-02-27 12:30,142,75,67,0,0,0
2019-02-27 12:45,171,121,50,0,0,0
2019-02-27 13:00,150,79,71,0,0,0
2019-02-27 13:15,174,75,99,0,0,0
2019-02-27 13:30,142,80,62,0,0,0
2019-02-27 13:45,168,86,82,0,0,0
2019-02-27 14:00,157,70,87,0,0,0
2019-02-27 14:15,138,76,62,0,0,0
2019-02-27 14:30,109,53,56,0,0,0
2019-02-27 14:45,138,64,74,0,0,0
2019-02-27 15:00,192,101,91,0,0,0
2019-02-27 15:15,166,97,69,0,0,0
2019-02-27 15:30,163,83,80,0,0,0
2019-02-27 15:45,190,97,93,0,0,0
2019-02-27 16:00,196,118,78,0,0,0
2019-02-27 16:15,183,118,65,0,0,0
2019-02-27 16:30,153,85,68,0,0,0
2019-02-27 16:45,151,93,58,0,0,0
2019-02-27 17:00,174,77,97,0,0,0
2019-02-27 17:15,197,102,95,0,0,0
2019-02-27 17:30,179,74,105,0,0,0
2019-02-27 17:45,186,93,93,0,0,0
2019-02-27 18:00,164,77,87,0,0,0
2019-02-27 18:15,162,86,76,0,0,0
2019-02-27 18:30,97,63,34,0,0,0
2019-02-27 18:45,119,63,56,0,0,0
2019-02-27 19:00,150,86,64,0,0,0
2019-02-27 19:15,114,58,56,0,0,0
2019-02-27 19:30,98,42,56,0,0,0
2019-02-27 19:45,99,50,49,0,0,0
2019-02-27 20:00,67,37,30,0,0,0
2019-02-27 20:15,60,35,25,0,0,0
2019-02-27 20:30,54,26,28,0,0,0
2019-02-27 20:45,44,17,27,0,0,0
2019-02-27 21:00,54,25,29,0,0,0
2019-02-27 21:15,43,19,24,0,0,0
2019-02-27 21:30,42,24,18,0,0,0
2019-02-27 21:45,60,29,31,0,0,0
2019-02-27 22:00,39,16,23,0,0,0
2019-02-27 22:15,56,28,28,0,0,0
2019-02-27 22:30,53,19,34,0,0,0
2019-02-27 22:45,41,23,18,0,0,0
2019-02-27 23:00,27,12,15,0,0,0
2019-02-27 23:15,16,12,4,0,0,0
2019-02-27 23:30,23,15,8,0,0,0
2019-02-27 23:45,15,9,6,0,0,0
2019-02-28 00:00,13,6,7,0,0,0
2019-02-28 00:15,7,3,4,0,0,0
2019-02-28 00:30,3,0,3,0,0,0
2019-02-28 00:45,10,3,7,0,0,0
2019-02-28 01:00,4,0,4,0,0,0
2019-02-28 01:15,9,2,7,0,0,0
2019-02-28 01:30,5,0,5,0,0,0
2019-02-28 01:45,4,2,2,0,0,0
2019-02-28 02:00,3,1,2,0,0,0
2019-02-28 02:15,4,0,4,0,0,0
2019-02-28 02:30,2,0,2,0,0,0
2019-02-28 02:45,2,1,1,0,0,0
2019-02-28 03:00,0,0,0,0,0,0
2019-02-28 03:15,0,0,0,0,0,0
2019-02-28 03:30,1,1,0,0,0,0
2019-02-28 03:45,1,1,0,0,0,0
2019-02-28 04:00,0,0,0,0,0,0
2019-02-28 04:15,2,0,2,0,0,0
2019-02-28 04:30,3,1,2,0,0,0
2019-02-28 04:45,1,0,1,0,0,0
2019-02-28 05:00,1,0,1,0,0,0
2019-02-28 05:15,5,4,1,0,0,0
2019-02-28 05:30,13,7,6,0,0,0
2019-02-28 05:45,17,8,9,0,0,0
2019-02-28 06:00,11,11,0,0,0,0
2019-02-28 06:15,20,10,10,0,0,0
2019-02-28 06:30,48,28,20,0,0,0
2019-02-28 06:45,60,45,15,0,0,0
2019-02-28 07:00,82,63,19,0,0,0
2019-02-28 07:15,165,139,26,0,0,0
2019-02-28 07:30,298,262,36,0,0,0
2019-02-28 07:45,203,144,59,0,0,0
2019-02-28 08:00,162,125,37,0,0,0
2019-02-28 08:15,144,114,30,0,0,0
2019-02-28 08:30,154,114,40,0,0,0
2019-02-28 08:45,149,116,33,0,0,0
2019-02-28 09:00,126,99,27,0,0,0
2019-02-28 09:15,104,82,22,0,0,0
2019-02-28 09:30,103,81,22,0,0,0
2019-02-28 09:45,121,89,32,0,0,0
2019-02-28 10:00,99,86,13,0,0,0
2019-02-28 10:15,92,81,11,0,0,0
2019-02-28 10:30,70,46,24,0,0,0
2019-02-28 10:45,104,64,40,0,0,0
2019-02-28 11:00,98,61,37,0,0,0
2019-02-28 11:15,91,59,32,0,0,0
2019-02-28 11:30,96,60,36,0,0,0
2019-02-28 11:45,101,64,37,0,0,0
2019-02-28 12:00,88,46,42,0,0,0
2019-02-28 12:15,96,53,43,0,0,0
2019-02-28 12:30,107,52,55,0,0,0
2019-02-28 12:45,126,60,66,0,0,0
2019-02-28 13:00,144,74,70,0,0,0
2019-02-28 13:15,116,62,54,0,0,0
2019-02-28 13:30,109,59,50,0,0,0
2019-02-28 13:45,112,60,52,0,0,0
2019-02-28 14:00,143,56,87,0,0,0
2019-02-28 14:15,103,61,42,0,0,0
2019-02-28 14:30,130,75,55,0,0,0
2019-02-28 14:45,156,99,57,0,0,0
2019-02-28 15:00,126,81,45,0,0,0
2019-02-28 15:15,135,74,61,0,0,0
2019-02-28 15:30,150,74,76,0,0,0
2019-02-28 15:45,169,102,67,0,0,0
2019-02-28 16:00,164,99,65,0,0,0
2019-02-28 16:15,184,118,66,0,0,0
2019-02-28 16:30,163,85,78,0,0,0
2019-02-28 16:45,149,83,66,0,0,0
2019-02-28 17:00,149,81,68,0,0,0
2019-02-28 17:15,149,65,84,0,0,0
2019-02-28 17:30,132,64,68,0,0,0
2019-02-28 17:45,171,88,83,0,0,0
2019-02-28 18:00,128,53,75,0,0,0
2019-02-28 18:15,135,63,72,0,0,0
2019-02-28 18:30,119,59,60,0,0,0
2019-02-28 18:45,95,45,50,0,0,0
2019-02-28 19:00,109,55,54,0,0,0
2019-02-28 19:15,95,52,43,0,0,0
2019-02-28 19:30,101,51,50,0,0,0
2019-02-28 19:45,94,56,38,0,0,0
2019-02-28 20:00,76,32,44,0,0,0
2019-02-28 20:15,38,15,23,0,0,0
2019-02-28 20:30,51,27,24,0,0,0
2019-02-28 20:45,41,22,19,0,0,0
2019-02-28 21:00,35,18,17,0,0,0
2019-02-28 21:15,46,24,22,0,0,0
2019-02-28 21:30,49,30,19,0,0,0
2019-02-28 21:45,58,33,25,0,0,0
2019-02-28 22:00,50,20,30,0,0,0
2019-02-28 22:15,25,9,16,0,0,0
2019-02-28 22:30,46,23,23,0,0,0
2019-02-28 22:45,37,18,19,0,0,0
2019-02-28 23:00,40,16,24,0,0,0
2019-02-28 23:15,35,21,14,0,0,0
2019-02-28 23:30,26,20,6,0,0,0
2019-02-28 23:45,15,6,9,0,0,0
