Datetime,100034983 (Warendorfer Straße),101034983 (Warendorfer Straße stadteinwärts),102034983 (Warendorfer Straße stadtauswärts),100034983-status,101034983-status,102034983-status
2019-01-01 00:00,1,1,0,0,0,0
2019-01-01 00:15,8,3,5,0,0,0
2019-01-01 00:30,16,4,12,0,0,0
2019-01-01 00:45,21,10,11,0,0,0
2019-01-01 01:00,21,9,12,0,0,0
2019-01-01 01:15,17,9,8,0,0,0
2019-01-01 01:30,13,3,10,0,0,0
2019-01-01 01:45,24,16,8,0,0,0
2019-01-01 02:00,24,22,2,0,0,0
2019-01-01 02:15,24,11,13,0,0,0
2019-01-01 02:30,27,16,11,0,0,0
2019-01-01 02:45,21,18,3,0,0,0
2019-01-01 03:00,34,26,8,0,0,0
2019-01-01 03:15,44,17,27,0,0,0
2019-01-01 03:30,19,13,6,0,0,0
2019-01-01 03:45,26,15,11,0,0,0
2019-01-01 04:00,14,6,8,0,0,0
2019-01-01 04:15,13,7,6,0,0,0
2019-01-01 04:30,16,5,11,0,0,0
2019-01-01 04:45,10,2,8,0,0,0
2019-01-01 05:00,7,2,5,0,0,0
2019-01-01 05:15,5,2,3,0,0,0
2019-01-01 05:30,8,5,3,0,0,0
2019-01-01 05:45,3,1,2,0,0,0
2019-01-01 06:00,5,2,3,0,0,0
2019-01-01 06:15,5,3,2,0,0,0
2019-01-01 06:30,9,4,5,0,0,0
2019-01-01 06:45,5,5,0,0,0,0
2019-01-01 07:00,2,2,0,0,0,0
2019-01-01 07:15,5,4,1,0,0,0
2019-01-01 07:30,2,2,0,0,0,0
2019-01-01 07:45,9,4,5,0,0,0
2019-01-01 08:00,2,2,0,0,0,0
2019-01-01 08:15,2,1,1,0,0,0
2019-01-01 08:30,3,3,0,0,0,0
2019-01-01 08:45,3,1,2,0,0,0
2019-01-01 09:00,1,1,0,0,0,0
2019-01-01 09:15,9,9,0,0,0,0
2019-01-01 09:30,3,3,0,0,0,0
2019-01-01 09:45,6,3,3,0,0,0
2019-01-01 10:00,4,4,0,0,0,0
2019-01-01 10:15,4,4,0,0,0,0
2019-01-01 10:30,3,3,0,0,0,0
2019-01-01 10:45,6,5,1,0,0,0
2019-01-01 11:00,5,4,1,0,0,0
2019-01-01 11:15,15,13,2,0,0,0
2019-01-01 11:30,3,3,0,0,0,0
2019-01-01 11:45,9,4,5,0,0,0
2019-01-01 12:00,11,7,4,0,0,0
2019-01-01 12:15,11,9,2,0,0,0
2019-01-01 12:30,14,9,5,0,0,0
2019-01-01 12:45,11,7,4,0,0,0
2019-01-01 13:00,11,10,1,0,0,0
2019-01-01 13:15,16,12,4,0,0,0
2019-01-01 13:30,20,15,5,0,0,0
2019-01-01 13:45,29,20,9,0,0,0
2019-01-01 14:00,29,18,11,0,0,0
2019-01-01 14:15,24,16,8,0,0,0
2019-01-01 14:30,27,22,5,0,0,0
2019-01-01 14:45,32,26,6,0,0,0
2019-01-01 15:00,15,13,2,0,0,0
2019-01-01 15:15,18,12,6,0,0,0
2019-01-01 15:30,40,30,10,0,0,0
2019-01-01 15:45,30,23,7,0,0,0
2019-01-01 16:00,20,11,9,0,0,0
2019-01-01 16:15,22,14,8,0,0,0
2019-01-01 16:30,19,13,6,0,0,0
2019-01-01 16:45,25,19,6,0,0,0
2019-01-01 17:00,18,13,5,0,0,0
2019-01-01 17:15,14,5,9,0,0,0
2019-01-01 17:30,10,4,6,0,0,0
2019-01-01 17:45,19,14,5,0,0,0
2019-01-01 18:00,13,8,5,0,0,0
2019-01-01 18:15,8,6,2,0,0,0
2019-01-01 18:30,11,7,4,0,0,0
2019-01-01 18:45,21,15,6,0,0,0
2019-01-01 19:00,10,8,2,0,0,0
2019-01-01 19:15,15,14,1,0,0,0
2019-01-01 19:30,6,5,1,0,0,0
2019-01-01 19:45,15,7,8,0,0,0
2019-01-01 20:00,5,4,1,0,0,0
2019-01-01 20:15,5,2,3,0,0,0
2019-01-01 20:30,12,7,5,0,0,0
2019-01-01 20:45,5,5,0,0,0,0
2019-01-01 21:00,3,2,1,0,0,0
2019-01-01 21:15,5,4,1,0,0,0
2019-01-01 21:30,8,4,4,0,0,0
2019-01-01 21:45,4,3,1,0,0,0
2019-01-01 22:00,7,3,4,0,0,0
2019-01-01 22:15,5,3,2,0,0,0
2019-01-01 22:30,1,1,0,0,0,0
2019-01-01 22:45,7,4,3,0,0,0
2019-01-01 23:00,4,4,0,0,0,0
2019-01-01 23:15,1,1,0,0,0,0
2019-01-01 23:30,1,0,1,0,0,0
2019-01-01 23:45,2,1,1,0,0,0
2019-01-02 00:00,3,0,3,0,0,0
2019-01-02 00:15,1,0,1,0,0,0
2019-01-02 00:30,0,0,0,0,0,0
2019-01-02 00:45,0,0,0,0,0,0
2019-01-02 01:00,0,0,0,0,0,0
2019-01-02 01:15,2,0,2,0,0,0
2019-01-02 01:30,3,2,1,0,0,0
2019-01-02 01:45,1,0,1,0,0,0
2019-01-02 02:00,2,1,1,0,0,0
2019-01-02 02:15,1,0,1,0,0,0
2019-01-02 02:30,0,0,0,0,0,0
2019-01-02 02:45,0,0,0,0,0,0
2019-01-02 03:00,0,0,0,0,0,0
2019-01-02 03:15,1,1,0,0,0,0
2019-01-02 03:30,1,1,0,0,0,0
2019-01-02 03:45,0,0,0,0,0,0
2019-01-02 04:00,0,0,0,0,0,0
2019-01-02 04:15,0,0,0,0,0,0
2019-01-02 04:30,0,0,0,0,0,0
2019-01-02 04:45,1,1,0,0,0,0
2019-01-02 05:00,0,0,0,0,0,0
2019-01-02 05:15,4,2,2,0,0,0
2019-01-02 05:30,12,7,5,0,0,0
2019-01-02 05:45,11,6,5,0,0,0
2019-01-02 06:00,10,9,1,0,0,0
2019-01-02 06:15,15,10,5,0,0,0
2019-01-02 06:30,28,19,9,0,0,0
2019-01-02 06:45,52,36,16,0,0,0
2019-01-02 07:00,49,28,21,0,0,0
2019-01-02 07:15,58,41,17,0,0,0
2019-01-02 07:30,67,48,19,0,0,0
2019-01-02 07:45,94,73,21,0,0,0
2019-01-02 08:00,77,55,22,0,0,0
2019-01-02 08:15,83,52,31,0,0,0
2019-01-02 08:30,97,71,26,0,0,0
2019-01-02 08:45,98,72,26,0,0,0
2019-01-02 09:00,66,60,6,0,0,0
2019-01-02 09:15,59,50,9,0,0,0
2019-01-02 09:30,85,71,14,0,0,0
2019-01-02 09:45,87,65,22,0,0,0
2019-01-02 10:00,65,53,12,0,0,0
2019-01-02 10:15,74,56,18,0,0,0
2019-01-02 10:30,88,74,14,0,0,0
2019-01-02 10:45,102,77,25,0,0,0
2019-01-02 11:00,94,70,24,0,0,0
2019-01-02 11:15,107,74,33,0,0,0
2019-01-02 11:30,111,66,45,0,0,0
2019-01-02 11:45,130,95,35,0,0,0
2019-01-02 12:00,117,71,46,0,0,0
2019-01-02 12:15,98,60,38,0,0,0
2019-01-02 12:30,122,73,49,0,0,0
2019-01-02 12:45,115,66,49,0,0,0
2019-01-02 13:00,99,49,50,0,0,0
2019-01-02 13:15,102,56,46,0,0,0
2019-01-02 13:30,106,67,39,0,0,0
2019-01-02 13:45,98,54,44,0,0,0
2019-01-02 14:00,105,56,49,0,0,0
2019-01-02 14:15,108,60,48,0,0,0
2019-01-02 14:30,107,51,56,0,0,0
2019-01-02 14:45,116,68,48,0,0,0
2019-01-02 15:00,107,56,51,0,0,0
2019-01-02 15:15,124,66,58,0,0,0
2019-01-02 15:30,113,73,40,0,0,0
2019-01-02 15:45,111,65,46,0,0,0
2019-01-02 16:00,120,70,50,0,0,0
2019-01-02 16:15,136,70,66,0,0,0
2019-01-02 16:30,121,70,51,0,0,0
2019-01-02 16:45,112,48,64,0,0,0
2019-01-02 17:00,112,55,57,0,0,0
2019-01-02 17:15,120,76,44,0,0,0
2019-01-02 17:30,116,58,58,0,0,0
2019-01-02 17:45,80,42,38,0,0,0
2019-01-02 18:00,95,42,53,0,0,0
2019-01-02 18:15,64,27,37,0,0,0
2019-01-02 18:30,82,45,37,0,0,0
2019-01-02 18:45,59,34,25,0,0,0
2019-01-02 19:00,47,20,27,0,0,0
2019-01-02 19:15,57,25,32,0,0,0
2019-01-02 19:30,35,17,18,0,0,0
2019-01-02 19:45,61,36,25,0,0,0
2019-01-02 20:00,46,21,25,0,0,0
2019-01-02 20:15,32,17,15,0,0,0
2019-01-02 20:30,24,11,13,0,0,0
2019-01-02 20:45,32,22,10,0,0,0
2019-01-02 21:00,14,7,7,0,0,0
2019-01-02 21:15,34,22,12,0,0,0
2019-01-02 21:30,35,12,23,0,0,0
2019-01-02 21:45,18,8,10,0,0,0
2019-01-02 22:00,17,8,9,0,0,0
2019-01-02 22:15,29,16,13,0,0,0
2019-01-02 22:30,26,1,25,0,0,0
2019-01-02 22:45,35,21,14,0,0,0
2019-01-02 23:00,24,14,10,0,0,0
2019-01-02 23:15,17,7,10,0,0,0
2019-01-02 23:30,13,7,6,0,0,0
2019-01-02 23:45,7,2,5,0,0,0
2019-01-03 00:00,7,1,6,0,0,0
2019-01-03 00:15,6,1,5,0,0,0
2019-01-03 00:30,6,2,4,0,0,0
2019-01-03 00:45,11,10,1,0,0,0
2019-01-03 01:00,11,9,2,0,0,0
2019-01-03 01:15,6,4,2,0,0,0
2019-01-03 01:30,4,2,2,0,0,0
2019-01-03 01:45,0,0,0,0,0,0
2019-01-03 02:00,2,1,1,0,0,0
2019-01-03 02:15,3,2,1,0,0,0
2019-01-03 02:30,1,1,0,0,0,0
2019-01-03 02:45,1,0,1,0,0,0
2019-01-03 03:00,3,2,1,0,0,0
2019-01-03 03:15,2,0,2,0,0,0
2019-01-03 03:30,2,1,1,0,0,0
2019-01-03 03:45,2,2,0,0,0,0
2019-01-03 04:00,2,1,1,0,0,0
2019-01-03 04:15,3,0,3,0,0,0
2019-01-03 04:30,1,0,1,0,0,0
2019-01-03 04:45,0,0,0,0,0,0
2019-01-03 05:00,0,0,0,0,0,0
2019-01-03 05:15,2,0,2,0,0,0
2019-01-03 05:30,8,5,3,0,0,0
2019-01-03 05:45,12,5,7,0,0,0
2019-01-03 06:00,12,9,3,0,0,0
2019-01-03 06:15,26,18,8,0,0,0
2019-01-03 06:30,31,22,9,0,0,0
2019-01-03 06:45,51,33,18,0,0,0
2019-01-03 07:00,40,30,10,0,0,0
2019-01-03 07:15,62,38,24,0,0,0
2019-01-03 07:30,64,47,17,0,0,0
2019-01-03 07:45,102,68,34,0,0,0
2019-01-03 08:00,72,59,13,0,0,0
2019-01-03 08:15,79,51,28,0,0,0
2019-01-03 08:30,93,71,22,0,0,0
2019-01-03 08:45,105,83,22,0,0,0
2019-01-03 09:00,67,48,19,0,0,0
2019-01-03 09:15,67,53,14,0,0,0
2019-01-03 09:30,68,54,14,0,0,0
2019-01-03 09:45,83,72,11,0,0,0
2019-01-03 10:00,45,30,15,0,0,0
2019-01-03 10:15,55,39,16,0,0,0
2019-01-03 10:30,83,66,17,0,0,0
2019-01-03 10:45,81,58,23,0,0,0
2019-01-03 11:00,46,32,14,0,0,0
2019-01-03 11:15,88,63,25,0,0,0
2019-01-03 11:30,71,50,21,0,0,0
2019-01-03 11:45,79,44,35,0,0,0
2019-01-03 12:00,72,44,28,0,0,0
2019-01-03 12:15,79,49,30,0,0,0
2019-01-03 12:30,73,42,31,0,0,0
2019-01-03 12:45,104,61,43,0,0,0
2019-01-03 13:00,71,40,31,0,0,0
2019-01-03 13:15,61,32,29,0,0,0
2019-01-03 13:30,58,32,26,0,0,0
2019-01-03 13:45,92,55,37,0,0,0
2019-01-03 14:00,100,56,44,0,0,0
2019-01-03 14:15,96,53,43,0,0,0
2019-01-03 14:30,95,54,41,0,0,0
2019-01-03 14:45,117,81,36,0,0,0
2019-01-03 15:00,109,69,40,0,0,0
2019-01-03 15:15,105,63,42,0,0,0
2019-01-03 15:30,113,62,51,0,0,0
2019-01-03 15:45,129,77,52,0,0,0
2019-01-03 16:00,127,76,51,0,0,0
2019-01-03 16:15,110,64,46,0,0,0
2019-01-03 16:30,99,61,38,0,0,0
2019-01-03 16:45,139,75,64,0,0,0
2019-01-03 17:00,117,64,53,0,0,0
2019-01-03 17:15,121,69,52,0,0,0
2019-01-03 17:30,119,66,53,0,0,0
2019-01-03 17:45,81,44,37,0,0,0
2019-01-03 18:00,80,38,42,0,0,0
2019-01-03 18:15,100,48,52,0,0,0
2019-01-03 18:30,74,48,26,0,0,0
2019-01-03 18:45,88,49,39,0,0,0
2019-01-03 19:00,60,32,28,0,0,0
2019-01-03 19:15,74,35,39,0,0,0
2019-01-03 19:30,58,21,37,0,0,0
2019-01-03 19:45,51,23,28,0,0,0
2019-01-03 20:00,74,44,30,0,0,0
2019-01-03 20:15,33,17,16,0,0,0
2019-01-03 20:30,36,18,18,0,0,0
2019-01-03 20:45,41,21,20,0,0,0
2019-01-03 21:00,21,9,12,0,0,0
2019-01-03 21:15,24,15,9,0,0,0
2019-01-03 21:30,18,9,9,0,0,0
2019-01-03 21:45,19,6,13,0,0,0
2019-01-03 22:00,24,12,12,0,0,0
2019-01-03 22:15,29,11,18,0,0,0
2019-01-03 22:30,24,12,12,0,0,0
2019-01-03 22:45,53,33,20,0,0,0
2019-01-03 23:00,18,9,9,0,0,0
2019-01-03 23:15,11,3,8,0,0,0
2019-01-03 23:30,8,1,7,0,0,0
2019-01-03 23:45,16,7,9,0,0,0
2019-01-04 00:00,11,5,6,0,0,0
2019-01-04 00:15,5,2,3,0,0,0
2019-01-04 00:30,5,2,3,0,0,0
2019-01-04 00:45,5,0,5,0,0,0
2019-01-04 01:00,8,6,2,0,0,0
2019-01-04 01:15,2,0,2,0,0,0
2019-01-04 01:30,7,4,3,0,0,0
2019-01-04 01:45,4,2,2,0,0,0
2019-01-04 02:00,3,1,2,0,0,0
2019-01-04 02:15,1,0,1,0,0,0
2019-01-04 02:30,0,0,0,0,0,0
2019-01-04 02:45,1,0,1,0,0,0
2019-01-04 03:00,3,2,1,0,0,0
2019-01-04 03:15,2,2,0,0,0,0
2019-01-04 03:30,2,1,1,0,0,0
2019-01-04 03:45,1,1,0,0,0,0
2019-01-04 04:00,2,0,2,0,0,0
2019-01-04 04:15,0,0,0,0,0,0
2019-01-04 04:30,0,0,0,0,0,0
2019-01-04 04:45,0,0,0,0,0,0
2019-01-04 05:00,0,0,0,0,0,0
2019-01-04 05:15,4,2,2,0,0,0
2019-01-04 05:30,5,5,0,0,0,0
2019-01-04 05:45,10,5,5,0,0,0
2019-01-04 06:00,10,6,4,0,0,0
2019-01-04 06:15,22,13,9,0,0,0
2019-01-04 06:30,31,20,11,0,0,0
2019-01-04 06:45,39,27,12,0,0,0
2019-01-04 07:00,47,29,18,0,0,0
2019-01-04 07:15,55,27,28,0,0,0
2019-01-04 07:30,74,58,16,0,0,0
2019-01-04 07:45,88,62,26,0,0,0
2019-01-04 08:00,75,59,16,0,0,0
2019-01-04 08:15,92,73,19,0,0,0
2019-01-04 08:30,75,59,16,0,0,0
2019-01-04 08:45,101,73,28,0,0,0
2019-01-04 09:00,64,50,14,0,0,0
2019-01-04 09:15,63,48,15,0,0,0
2019-01-04 09:30,70,57,13,0,0,0
2019-01-04 09:45,99,78,21,0,0,0
2019-01-04 10:00,83,64,19,0,0,0
2019-01-04 10:15,61,50,11,0,0,0
2019-01-04 10:30,58,37,21,0,0,0
2019-01-04 10:45,87,60,27,0,0,0
2019-01-04 11:00,87,64,23,0,0,0
2019-01-04 11:15,108,76,32,0,0,0
2019-01-04 11:30,81,59,22,0,0,0
2019-01-04 11:45,86,51,35,0,0,0
2019-01-04 12:00,85,38,47,0,0,0
2019-01-04 12:15,79,39,40,0,0,0
2019-01-04 12:30,80,46,34,0,0,0
2019-01-04 12:45,99,65,34,0,0,0
2019-01-04 13:00,82,45,37,0,0,0
2019-01-04 13:15,88,47,41,0,0,0
2019-01-04 13:30,92,48,44,0,0,0
2019-01-04 13:45,86,52,34,0,0,0
2019-01-04 14:00,82,46,36,0,0,0
2019-01-04 14:15,90,51,39,0,0,0
2019-01-04 14:30,105,61,44,0,0,0
2019-01-04 14:45,115,66,49,0,0,0
2019-01-04 15:00,95,47,48,0,0,0
2019-01-04 15:15,93,43,50,0,0,0
2019-01-04 15:30,91,51,40,0,0,0
2019-01-04 15:45,106,56,50,0,0,0
2019-01-04 16:00,81,45,36,0,0,0
2019-01-04 16:15,100,49,51,0,0,0
2019-01-04 16:30,90,55,35,0,0,0
2019-01-04 16:45,61,38,23,0,0,0
2019-01-04 17:00,77,47,30,0,0,0
2019-01-04 17:15,76,37,39,0,0,0
2019-01-04 17:30,95,50,45,0,0,0
2019-01-04 17:45,92,65,27,0,0,0
2019-01-04 18:00,94,46,48,0,0,0
2019-01-04 18:15,86,43,43,0,0,0
2019-01-04 18:30,80,50,30,0,0,0
2019-01-04 18:45,84,53,31,0,0,0
2019-01-04 19:00,57,21,36,0,0,0
2019-01-04 19:15,53,29,24,0,0,0
2019-01-04 19:30,63,37,26,0,0,0
2019-01-04 19:45,52,23,29,0,0,0
2019-01-04 20:00,67,30,37,0,0,0
2019-01-04 20:15,43,21,22,0,0,0
2019-01-04 20:30,54,25,29,0,0,0
2019-01-04 20:45,29,16,13,0,0,0
2019-01-04 21:00,43,26,17,0,0,0
2019-01-04 21:15,38,25,13,0,0,0
2019-01-04 21:30,16,11,5,0,0,0
2019-01-04 21:45,19,11,8,0,0,0
2019-01-04 22:00,29,20,9,0,0,0
2019-01-04 22:15,46,21,25,0,0,0
2019-01-04 22:30,21,6,15,0,0,0
2019-01-04 22:45,27,16,11,0,0,0
2019-01-04 23:00,27,13,14,0,0,0
2019-01-04 23:15,26,13,13,0,0,0
2019-01-04 23:30,16,8,8,0,0,0
2019-01-04 23:45,18,7,11,0,0,0
2019-01-05 00:00,29,14,15,0,0,0
2019-01-05 00:15,8,4,4,0,0,0
2019-01-05 00:30,19,5,14,0,0,0
2019-01-05 00:45,24,9,15,0,0,0
2019-01-05 01:00,15,7,8,0,0,0
2019-01-05 01:15,15,7,8,0,0,0
2019-01-05 01:30,15,6,9,0,0,0
2019-01-05 01:45,7,1,6,0,0,0
2019-01-05 02:00,6,3,3,0,0,0
2019-01-05 02:15,6,0,6,0,0,0
2019-01-05 02:30,4,0,4,0,0,0
2019-01-05 02:45,10,5,5,0,0,0
2019-01-05 03:00,7,1,6,0,0,0
2019-01-05 03:15,4,0,4,0,0,0
2019-01-05 03:30,2,0,2,0,0,0
2019-01-05 03:45,2,0,2,0,0,0
2019-01-05 04:00,5,0,5,0,0,0
2019-01-05 04:15,6,1,5,0,0,0
2019-01-05 04:30,4,1,3,0,0,0
2019-01-05 04:45,0,0,0,0,0,0
2019-01-05 05:00,1,1,0,0,0,0
2019-01-05 05:15,3,2,1,0,0,0
2019-01-05 05:30,7,4,3,0,0,0
2019-01-05 05:45,13,8,5,0,0,0
2019-01-05 06:00,8,7,1,0,0,0
2019-01-05 06:15,5,3,2,0,0,0
2019-01-05 06:30,3,3,0,0,0,0
2019-01-05 06:45,7,5,2,0,0,0
2019-01-05 07:00,4,4,0,0,0,0
2019-01-05 07:15,6,3,3,0,0,0
2019-01-05 07:30,8,4,4,0,0,0
2019-01-05 07:45,14,9,5,0,0,0
2019-01-05 08:00,15,10,5,0,0,0
2019-01-05 08:15,12,8,4,0,0,0
2019-01-05 08:30,19,12,7,0,0,0
2019-01-05 08:45,33,23,10,0,0,0
2019-01-05 09:00,35,26,9,0,0,0
2019-01-05 09:15,34,25,9,0,0,0
2019-01-05 09:30,39,34,5,0,0,0
2019-01-05 09:45,87,72,15,0,0,0
2019-01-05 10:00,93,75,18,0,0,0
2019-01-05 10:15,53,40,13,0,0,0
2019-01-05 10:30,86,68,18,0,0,0
2019-01-05 10:45,94,71,23,0,0,0
2019-01-05 11:00,66,57,9,0,0,0
2019-01-05 11:15,93,74,19,0,0,0
2019-01-05 11:30,68,46,22,0,0,0
2019-01-05 11:45,107,79,28,0,0,0
2019-01-05 12:00,133,88,45,0,0,0
2019-01-05 12:15,95,64,31,0,0,0
2019-01-05 12:30,112,68,44,0,0,0
2019-01-05 12:45,130,84,46,0,0,0
2019-01-05 13:00,105,59,46,0,0,0
2019-01-05 13:15,105,61,44,0,0,0
2019-01-05 13:30,107,52,55,0,0,0
2019-01-05 13:45,109,52,57,0,0,0
2019-01-05 14:00,85,42,43,0,0,0
2019-01-05 14:15,80,41,39,0,0,0
2019-01-05 14:30,88,43,45,0,0,0
2019-01-05 14:45,76,49,27,0,0,0
2019-01-05 15:00,69,27,42,0,0,0
2019-01-05 15:15,59,31,28,0,0,0
2019-01-05 15:30,91,36,55,0,0,0
2019-01-05 15:45,82,44,38,0,0,0
2019-01-05 16:00,67,36,31,0,0,0
2019-01-05 16:15,71,35,36,0,0,0
2019-01-05 16:30,85,47,38,0,0,0
2019-01-05 16:45,69,36,33,0,0,0
2019-01-05 17:00,69,37,32,0,0,0
2019-01-05 17:15,65,38,27,0,0,0
2019-01-05 17:30,73,38,35,0,0,0
2019-01-05 17:45,77,44,33,0,0,0
2019-01-05 18:00,44,17,27,0,0,0
2019-01-05 18:15,68,32,36,0,0,0
2019-01-05 18:30,41,20,21,0,0,0
2019-01-05 18:45,65,42,23,0,0,0
2019-01-05 19:00,56,32,24,0,0,0
2019-01-05 19:15,54,28,26,0,0,0
2019-01-05 19:30,54,25,29,0,0,0
2019-01-05 19:45,35,21,14,0,0,0
2019-01-05 20:00,55,31,24,0,0,0
2019-01-05 20:15,44,22,22,0,0,0
2019-01-05 20:30,36,26,10,0,0,0
2019-01-05 20:45,37,20,17,0,0,0
2019-01-05 21:00,15,9,6,0,0,0
2019-01-05 21:15,21,10,11,0,0,0
2019-01-05 21:30,25,16,9,0,0,0
2019-01-05 21:45,10,2,8,0,0,0
2019-01-05 22:00,19,16,3,0,0,0
2019-01-05 22:15,30,13,17,0,0,0
2019-01-05 22:30,18,11,7,0,0,0
2019-01-05 22:45,18,9,9,0,0,0
2019-01-05 23:00,17,8,9,0,0,0
2019-01-05 23:15,16,6,10,0,0,0
2019-01-05 23:30,16,7,9,0,0,0
2019-01-05 23:45,20,14,6,0,0,0
2019-01-06 00:00,18,5,13,0,0,0
2019-01-06 00:15,33,18,15,0,0,0
2019-01-06 00:30,11,1,10,0,0,0
2019-01-06 00:45,41,16,25,0,0,0
2019-01-06 01:00,33,18,15,0,0,0
2019-01-06 01:15,12,6,6,0,0,0
2019-01-06 01:30,15,1,14,0,0,0
2019-01-06 01:45,15,8,7,0,0,0
2019-01-06 02:00,12,7,5,0,0,0
2019-01-06 02:15,14,5,9,0,0,0
2019-01-06 02:30,4,2,2,0,0,0
2019-01-06 02:45,8,4,4,0,0,0
2019-01-06 03:00,8,3,5,0,0,0
2019-01-06 03:15,3,0,3,0,0,0
2019-01-06 03:30,3,0,3,0,0,0
2019-01-06 03:45,8,6,2,0,0,0
2019-01-06 04:00,8,2,6,0,0,0
2019-01-06 04:15,4,2,2,0,0,0
2019-01-06 04:30,5,1,4,0,0,0
2019-01-06 04:45,1,0,1,0,0,0
2019-01-06 05:00,3,2,1,0,0,0
2019-01-06 05:15,2,0,2,0,0,0
2019-01-06 05:30,6,5,1,0,0,0
2019-01-06 05:45,5,1,4,0,0,0
2019-01-06 06:00,3,3,0,0,0,0
2019-01-06 06:15,7,5,2,0,0,0
2019-01-06 06:30,3,2,1,0,0,0
2019-01-06 06:45,5,3,2,0,0,0
2019-01-06 07:00,1,1,0,0,0,0
2019-01-06 07:15,4,2,2,0,0,0
2019-01-06 07:30,2,0,2,0,0,0
2019-01-06 07:45,5,4,1,0,0,0
2019-01-06 08:00,6,4,2,0,0,0
2019-01-06 08:15,1,0,1,0,0,0
2019-01-06 08:30,8,6,2,0,0,0
2019-01-06 08:45,18,10,8,0,0,0
2019-01-06 09:00,8,6,2,0,0,0
2019-01-06 09:15,11,8,3,0,0,0
2019-01-06 09:30,19,17,2,0,0,0
2019-01-06 09:45,53,44,9,0,0,0
2019-01-06 10:00,33,28,5,0,0,0
2019-01-06 10:15,25,20,5,0,0,0
2019-01-06 10:30,29,20,9,0,0,0
2019-01-06 10:45,27,22,5,0,0,0
2019-01-06 11:00,20,15,5,0,0,0
2019-01-06 11:15,32,22,10,0,0,0
2019-01-06 11:30,27,16,11,0,0,0
2019-01-06 11:45,33,26,7,0,0,0
2019-01-06 12:00,26,16,10,0,0,0
2019-01-06 12:15,37,24,13,0,0,0
2019-01-06 12:30,45,20,25,0,0,0
2019-01-06 12:45,29,19,10,0,0,0
2019-01-06 13:00,40,21,19,0,0,0
2019-01-06 13:15,33,23,10,0,0,0
2019-01-06 13:30,39,23,16,0,0,0
2019-01-06 13:45,44,24,20,0,0,0
2019-01-06 14:00,38,20,18,0,0,0
2019-01-06 14:15,36,26,10,0,0,0
2019-01-06 14:30,53,28,25,0,0,0
2019-01-06 14:45,90,71,19,0,0,0
2019-01-06 15:00,52,34,18,0,0,0
2019-01-06 15:15,61,43,18,0,0,0
2019-01-06 15:30,70,50,20,0,0,0
2019-01-06 15:45,58,38,20,0,0,0
2019-01-06 16:00,50,30,20,0,0,0
2019-01-06 16:15,38,21,17,0,0,0
2019-01-06 16:30,59,33,26,0,0,0
2019-01-06 16:45,53,35,18,0,0,0
2019-01-06 17:00,42,27,15,0,0,0
2019-01-06 17:15,43,19,24,0,0,0
2019-01-06 17:30,35,27,8,0,0,0
2019-01-06 17:45,48,34,14,0,0,0
2019-01-06 18:00,43,18,25,0,0,0
2019-01-06 18:15,45,27,18,0,0,0
2019-01-06 18:30,31,16,15,0,0,0
2019-01-06 18:45,49,31,18,0,0,0
2019-01-06 19:00,38,14,24,0,0,0
2019-01-06 19:15,32,16,16,0,0,0
2019-01-06 19:30,40,26,14,0,0,0
2019-01-06 19:45,40,21,19,0,0,0
2019-01-06 20:00,25,14,11,0,0,0
2019-01-06 20:15,21,8,13,0,0,0
2019-01-06 20:30,17,4,13,0,0,0
2019-01-06 20:45,14,7,7,0,0,0
2019-01-06 21:00,23,12,11,0,0,0
2019-01-06 21:15,22,9,13,0,0,0
2019-01-06 21:30,21,11,10,0,0,0
2019-01-06 21:45,19,11,8,0,0,0
2019-01-06 22:00,16,7,9,0,0,0
2019-01-06 22:15,13,5,8,0,0,0
2019-01-06 22:30,16,10,6,0,0,0
2019-01-06 22:45,28,8,20,0,0,0
2019-01-06 23:00,11,6,5,0,0,0
2019-01-06 23:15,8,1,7,0,0,0
2019-01-06 23:30,7,2,5,0,0,0
2019-01-06 23:45,8,3,5,0,0,0
2019-01-07 00:00,2,1,1,0,0,0
2019-01-07 00:15,8,5,3,0,0,0
2019-01-07 00:30,1,1,0,0,0,0
2019-01-07 00:45,6,3,3,0,0,0
2019-01-07 01:00,1,0,1,0,0,0
2019-01-07 01:15,4,0,4,0,0,0
2019-01-07 01:30,0,0,0,0,0,0
2019-01-07 01:45,3,1,2,0,0,0
2019-01-07 02:00,2,0,2,0,0,0
2019-01-07 02:15,2,2,0,0,0,0
2019-01-07 02:30,0,0,0,0,0,0
2019-01-07 02:45,0,0,0,0,0,0
2019-01-07 03:00,0,0,0,0,0,0
2019-01-07 03:15,0,0,0,0,0,0
2019-01-07 03:30,0,0,0,0,0,0
2019-01-07 03:45,1,1,0,0,0,0
2019-01-07 04:00,0,0,0,0,0,0
2019-01-07 04:15,0,0,0,0,0,0
2019-01-07 04:30,0,0,0,0,0,0
2019-01-07 04:45,2,2,0,0,0,0
2019-01-07 05:00,0,0,0,0,0,0
2019-01-07 05:15,4,1,3,0,0,0
2019-01-07 05:30,12,8,4,0,0,0
2019-01-07 05:45,15,5,10,0,0,0
2019-01-07 06:00,10,8,2,0,0,0
2019-01-07 06:15,25,20,5,0,0,0
2019-01-07 06:30,49,30,19,0,0,0
2019-01-07 06:45,70,49,21,0,0,0
2019-01-07 07:00,79,60,19,0,0,0
2019-01-07 07:15,181,155,26,0,0,0
2019-01-07 07:30,336,300,36,0,0,0
2019-01-07 07:45,195,155,40,0,0,0
2019-01-07 08:00,166,136,30,0,0,0
2019-01-07 08:15,125,96,29,0,0,0
2019-01-07 08:30,142,110,32,0,0,0
2019-01-07 08:45,151,116,35,0,0,0
2019-01-07 09:00,92,67,25,0,0,0
2019-01-07 09:15,109,89,20,0,0,0
2019-01-07 09:30,84,71,13,0,0,0
2019-01-07 09:45,135,112,23,0,0,0
2019-01-07 10:00,94,75,19,0,0,0
2019-01-07 10:15,64,42,22,0,0,0
2019-01-07 10:30,64,47,17,0,0,0
2019-01-07 10:45,51,37,14,0,0,0
2019-01-07 11:00,58,36,22,0,0,0
2019-01-07 11:15,60,36,24,0,0,0
2019-01-07 11:30,67,43,24,0,0,0
2019-01-07 11:45,88,56,32,0,0,0
2019-01-07 12:00,77,50,27,0,0,0
2019-01-07 12:15,74,39,35,0,0,0
2019-01-07 12:30,75,31,44,0,0,0
2019-01-07 12:45,75,43,32,0,0,0
2019-01-07 13:00,88,37,51,0,0,0
2019-01-07 13:15,84,39,45,0,0,0
2019-01-07 13:30,83,44,39,0,0,0
2019-01-07 13:45,111,64,47,0,0,0
2019-01-07 14:00,128,48,80,0,0,0
2019-01-07 14:15,78,35,43,0,0,0
2019-01-07 14:30,80,40,40,0,0,0
2019-01-07 14:45,115,68,47,0,0,0
2019-01-07 15:00,101,60,41,0,0,0
2019-01-07 15:15,97,62,35,0,0,0
2019-01-07 15:30,126,64,62,0,0,0
2019-01-07 15:45,172,92,80,0,0,0
2019-01-07 16:00,150,90,60,0,0,0
2019-01-07 16:15,130,59,71,0,0,0
2019-01-07 16:30,153,79,74,0,0,0
2019-01-07 16:45,154,82,72,0,0,0
2019-01-07 17:00,132,60,72,0,0,0
2019-01-07 17:15,128,73,55,0,0,0
2019-01-07 17:30,130,66,64,0,0,0
2019-01-07 17:45,163,70,93,0,0,0
2019-01-07 18:00,153,55,98,0,0,0
2019-01-07 18:15,114,53,61,0,0,0
2019-01-07 18:30,77,28,49,0,0,0
2019-01-07 18:45,88,42,46,0,0,0
2019-01-07 19:00,63,24,39,0,0,0
2019-01-07 19:15,55,35,20,0,0,0
2019-01-07 19:30,58,26,32,0,0,0
2019-01-07 19:45,80,37,43,0,0,0
2019-01-07 20:00,73,32,41,0,0,0
2019-01-07 20:15,46,18,28,0,0,0
2019-01-07 20:30,40,15,25,0,0,0
2019-01-07 20:45,32,21,11,0,0,0
2019-01-07 21:00,34,14,20,0,0,0
2019-01-07 21:15,30,19,11,0,0,0
2019-01-07 21:30,28,15,13,0,0,0
2019-01-07 21:45,22,9,13,0,0,0
2019-01-07 22:00,32,12,20,0,0,0
2019-01-07 22:15,26,15,11,0,0,0
2019-01-07 22:30,28,10,18,0,0,0
2019-01-07 22:45,14,4,10,0,0,0
2019-01-07 23:00,29,12,17,0,0,0
2019-01-07 23:15,16,5,11,0,0,0
2019-01-07 23:30,12,6,6,0,0,0
2019-01-07 23:45,9,5,4,0,0,0
2019-01-08 00:00,4,3,1,0,0,0
2019-01-08 00:15,3,1,2,0,0,0
2019-01-08 00:30,10,8,2,0,0,0
2019-01-08 00:45,6,6,0,0,0,0
2019-01-08 01:00,3,1,2,0,0,0
2019-01-08 01:15,0,0,0,0,0,0
2019-01-08 01:30,5,0,5,0,0,0
2019-01-08 01:45,3,2,1,0,0,0
2019-01-08 02:00,3,2,1,0,0,0
2019-01-08 02:15,1,0,1,0,0,0
2019-01-08 02:30,1,0,1,0,0,0
2019-01-08 02:45,2,2,0,0,0,0
2019-01-08 03:00,1,0,1,0,0,0
2019-01-08 03:15,1,0,1,0,0,0
2019-01-08 03:30,0,0,0,0,0,0
2019-01-08 03:45,0,0,0,0,0,0
2019-01-08 04:00,1,0,1,0,0,0
2019-01-08 04:15,0,0,0,0,0,0
2019-01-08 04:30,1,0,1,0,0,0
2019-01-08 04:45,0,0,0,0,0,0
2019-01-08 05:00,2,1,1,0,0,0
2019-01-08 05:15,3,3,0,0,0,0
2019-01-08 05:30,8,7,1,0,0,0
2019-01-08 05:45,15,6,9,0,0,0
2019-01-08 06:00,11,8,3,0,0,0
2019-01-08 06:15,25,22,3,0,0,0
2019-01-08 06:30,32,19,13,0,0,0
2019-01-08 06:45,56,41,15,0,0,0
2019-01-08 07:00,69,55,14,0,0,0
2019-01-08 07:15,138,102,36,0,0,0
2019-01-08 07:30,300,271,29,0,0,0
2019-01-08 07:45,211,163,48,0,0,0
2019-01-08 08:00,174,149,25,0,0,0
2019-01-08 08:15,143,115,28,0,0,0
2019-01-08 08:30,112,85,27,0,0,0
2019-01-08 08:45,142,112,30,0,0,0
2019-01-08 09:00,95,75,20,0,0,0
2019-01-08 09:15,99,77,22,0,0,0
2019-01-08 09:30,71,56,15,0,0,0
2019-01-08 09:45,135,116,19,0,0,0
2019-01-08 10:00,95,77,18,0,0,0
2019-01-08 10:15,65,47,18,0,0,0
2019-01-08 10:30,45,29,16,0,0,0
2019-01-08 10:45,77,59,18,0,0,0
2019-01-08 11:00,54,42,12,0,0,0
2019-01-08 11:15,72,37,35,0,0,0
2019-01-08 11:30,71,55,16,0,0,0
2019-01-08 11:45,83,54,29,0,0,0
2019-01-08 12:00,65,33,32,0,0,0
2019-01-08 12:15,87,50,37,0,0,0
2019-01-08 12:30,92,43,49,0,0,0
2019-01-08 12:45,90,47,43,0,0,0
2019-01-08 13:00,108,47,61,0,0,0
2019-01-08 13:15,97,27,70,0,0,0
2019-01-08 13:30,68,33,35,0,0,0
2019-01-08 13:45,121,74,47,0,0,0
2019-01-08 14:00,127,45,82,0,0,0
2019-01-08 14:15,70,38,32,0,0,0
2019-01-08 14:30,87,50,37,0,0,0
2019-01-08 14:45,95,54,41,0,0,0
2019-01-08 15:00,91,44,47,0,0,0
2019-01-08 15:15,79,48,31,0,0,0
2019-01-08 15:30,112,67,45,0,0,0
2019-01-08 15:45,155,72,83,0,0,0
2019-01-08 16:00,157,90,67,0,0,0
2019-01-08 16:15,119,53,66,0,0,0
2019-01-08 16:30,119,50,69,0,0,0
2019-01-08 16:45,141,80,61,0,0,0
2019-01-08 17:00,128,50,78,0,0,0
2019-01-08 17:15,117,60,57,0,0,0
2019-01-08 17:30,113,43,70,0,0,0
2019-01-08 17:45,133,63,70,0,0,0
2019-01-08 18:00,106,38,68,0,0,0
2019-01-08 18:15,117,55,62,0,0,0
2019-01-08 18:30,105,51,54,0,0,0
2019-01-08 18:45,82,40,42,0,0,0
2019-01-08 19:00,77,28,49,0,0,0
2019-01-08 19:15,80,34,46,0,0,0
2019-01-08 19:30,69,37,32,0,0,0
2019-01-08 19:45,100,39,61,0,0,0
2019-01-08 20:00,53,24,29,0,0,0
2019-01-08 20:15,55,34,21,0,0,0
2019-01-08 20:30,33,12,21,0,0,0
2019-01-08 20:45,27,9,18,0,0,0
2019-01-08 21:00,43,21,22,0,0,0
2019-01-08 21:15,27,14,13,0,0,0
2019-01-08 21:30,47,21,26,0,0,0
2019-01-08 21:45,22,8,14,0,0,0
2019-01-08 22:00,45,23,22,0,0,0
2019-01-08 22:15,33,19,14,0,0,0
2019-01-08 22:30,19,9,10,0,0,0
2019-01-08 22:45,29,11,18,0,0,0
2019-01-08 23:00,15,9,6,0,0,0
2019-01-08 23:15,12,4,8,0,0,0
2019-01-08 23:30,6,2,4,0,0,0
2019-01-08 23:45,7,2,5,0,0,0
2019-01-09 00:00,8,1,7,0,0,0
2019-01-09 00:15,3,2,1,0,0,0
2019-01-09 00:30,3,0,3,0,0,0
2019-01-09 00:45,5,2,3,0,0,0
2019-01-09 01:00,1,1,0,0,0,0
2019-01-09 01:15,2,0,2,0,0,0
2019-01-09 01:30,1,1,0,0,0,0
2019-01-09 01:45,2,1,1,0,0,0
2019-01-09 02:00,3,2,1,0,0,0
2019-01-09 02:15,0,0,0,0,0,0
2019-01-09 02:30,1,0,1,0,0,0
2019-01-09 02:45,1,0,1,0,0,0
2019-01-09 03:00,1,0,1,0,0,0
2019-01-09 03:15,2,2,0,0,0,0
2019-01-09 03:30,0,0,0,0,0,0
2019-01-09 03:45,1,0,1,0,0,0
2019-01-09 04:00,0,0,0,0,0,0
2019-01-09 04:15,0,0,0,0,0,0
2019-01-09 04:30,1,0,1,0,0,0
2019-01-09 04:45,1,1,0,0,0,0
2019-01-09 05:00,0,0,0,0,0,0
2019-01-09 05:15,6,4,2,0,0,0
2019-01-09 05:30,8,6,2,0,0,0
2019-01-09 05:45,14,8,6,0,0,0
2019-01-09 06:00,13,10,3,0,0,0
2019-01-09 06:15,25,23,2,0,0,0
2019-01-09 06:30,42,23,19,0,0,0
2019-01-09 06:45,66,48,18,0,0,0
2019-01-09 07:00,73,52,21,0,0,0
2019-01-09 07:15,162,129,33,0,0,0
2019-01-09 07:30,298,268,30,0,0,0
2019-01-09 07:45,245,203,42,0,0,0
2019-01-09 08:00,180,151,29,0,0,0
2019-01-09 08:15,165,129,36,0,0,0
2019-01-09 08:30,139,100,39,0,0,0
2019-01-09 08:45,183,147,36,0,0,0
2019-01-09 09:00,122,98,24,0,0,0
2019-01-09 09:15,112,93,19,0,0,0
2019-01-09 09:30,120,99,21,0,0,0
2019-01-09 09:45,163,137,26,0,0,0
2019-01-09 10:00,116,87,29,0,0,0
2019-01-09 10:15,110,85,25,0,0,0
2019-01-09 10:30,115,90,25,0,0,0
2019-01-09 10:45,99,74,25,0,0,0
2019-01-09 11:00,84,64,20,0,0,0
2019-01-09 11:15,91,47,44,0,0,0
2019-01-09 11:30,116,73,43,0,0,0
2019-01-09 11:45,144,95,49,0,0,0
2019-01-09 12:00,145,87,58,0,0,0
2019-01-09 12:15,129,69,60,0,0,0
2019-01-09 12:30,119,60,59,0,0,0
2019-01-09 12:45,138,80,58,0,0,0
2019-01-09 13:00,119,57,62,0,0,0
2019-01-09 13:15,141,71,70,0,0,0
2019-01-09 13:30,119,73,46,0,0,0
2019-01-09 13:45,146,75,71,0,0,0
2019-01-09 14:00,146,56,90,0,0,0
2019-01-09 14:15,85,35,50,0,0,0
2019-01-09 14:30,103,51,52,0,0,0
2019-01-09 14:45,132,56,76,0,0,0
2019-01-09 15:00,123,53,70,0,0,0
2019-01-09 15:15,131,69,62,0,0,0
2019-01-09 15:30,147,74,73,0,0,0
2019-01-09 15:45,175,89,86,0,0,0
2019-01-09 16:00,171,79,92,0,0,0
2019-01-09 16:15,144,69,75,0,0,0
2019-01-09 16:30,145,66,79,0,0,0
2019-01-09 16:45,154,92,62,0,0,0
2019-01-09 17:00,139,70,69,0,0,0
2019-01-09 17:15,166,89,77,0,0,0
2019-01-09 17:30,171,85,86,0,0,0
2019-01-09 17:45,190,92,98,0,0,0
2019-01-09 18:00,154,65,89,0,0,0
2019-01-09 18:15,111,51,60,0,0,0
2019-01-09 18:30,121,66,55,0,0,0
2019-01-09 18:45,125,68,57,0,0,0
2019-01-09 19:00,98,65,33,0,0,0
2019-01-09 19:15,101,56,45,0,0,0
2019-01-09 19:30,103,52,51,0,0,0
2019-01-09 19:45,103,47,56,0,0,0
2019-01-09 20:00,79,38,41,0,0,0
2019-01-09 20:15,67,32,35,0,0,0
2019-01-09 20:30,51,24,27,0,0,0
2019-01-09 20:45,62,29,33,0,0,0
2019-01-09 21:00,42,24,18,0,0,0
2019-01-09 21:15,47,16,31,0,0,0
2019-01-09 21:30,26,9,17,0,0,0
2019-01-09 21:45,29,11,18,0,0,0
2019-01-09 22:00,53,17,36,0,0,0
2019-01-09 22:15,42,21,21,0,0,0
2019-01-09 22:30,48,30,18,0,0,0
2019-01-09 22:45,50,26,24,0,0,0
2019-01-09 23:00,36,27,9,0,0,0
2019-01-09 23:15,28,14,14,0,0,0
2019-01-09 23:30,26,19,7,0,0,0
2019-01-09 23:45,13,9,4,0,0,0
2019-01-10 00:00,9,4,5,0,0,0
2019-01-10 00:15,10,2,8,0,0,0
2019-01-10 00:30,5,1,4,0,0,0
2019-01-10 00:45,9,6,3,0,0,0
2019-01-10 01:00,2,0,2,0,0,0
2019-01-10 01:15,4,1,3,0,0,0
2019-01-10 01:30,9,2,7,0,0,0
2019-01-10 01:45,0,0,0,0,0,0
2019-01-10 02:00,3,0,3,0,0,0
2019-01-10 02:15,2,1,1,0,0,0
2019-01-10 02:30,6,0,6,0,0,0
2019-01-10 02:45,1,0,1,0,0,0
2019-01-10 03:00,1,0,1,0,0,0
2019-01-10 03:15,2,0,2,0,0,0
2019-01-10 03:30,5,3,2,0,0,0
2019-01-10 03:45,2,1,1,0,0,0
2019-01-10 04:00,1,0,1,0,0,0
2019-01-10 04:15,2,1,1,0,0,0
2019-01-10 04:30,0,0,0,0,0,0
2019-01-10 04:45,0,0,0,0,0,0
2019-01-10 05:00,1,1,0,0,0,0
2019-01-10 05:15,7,4,3,0,0,0
2019-01-10 05:30,14,9,5,0,0,0
2019-01-10 05:45,8,3,5,0,0,0
2019-01-10 06:00,12,9,3,0,0,0
2019-01-10 06:15,25,22,3,0,0,0
2019-01-10 06:30,41,22,19,0,0,0
2019-01-10 06:45,68,49,19,0,0,0
2019-01-10 07:00,81,61,20,0,0,0
2019-01-10 07:15,162,131,31,0,0,0
2019-01-10 07:30,291,264,27,0,0,0
2019-01-10 07:45,232,173,59,0,0,0
2019-01-10 08:00,186,157,29,0,0,0
2019-01-10 08:15,150,115,35,0,0,0
2019-01-10 08:30,148,113,35,0,0,0
2019-01-10 08:45,158,125,33,0,0,0
2019-01-10 09:00,104,88,16,0,0,0
2019-01-10 09:15,101,84,17,0,0,0
2019-01-10 09:30,117,97,20,0,0,0
2019-01-10 09:45,150,131,19,0,0,0
2019-01-10 10:00,108,84,24,0,0,0
2019-01-10 10:15,73,48,25,0,0,0
2019-01-10 10:30,54,39,15,0,0,0
2019-01-10 10:45,78,56,22,0,0,0
2019-01-10 11:00,51,39,12,0,0,0
2019-01-10 11:15,69,42,27,0,0,0
2019-01-10 11:30,81,55,26,0,0,0
2019-01-10 11:45,132,95,37,0,0,0
2019-01-10 12:00,111,66,45,0,0,0
2019-01-10 12:15,112,64,48,0,0,0
2019-01-10 12:30,85,47,38,0,0,0
2019-01-10 12:45,105,54,51,0,0,0
2019-01-10 13:00,107,42,65,0,0,0
2019-01-10 13:15,90,39,51,0,0,0
2019-01-10 13:30,111,56,55,0,0,0
2019-01-10 13:45,122,73,49,0,0,0
2019-01-10 14:00,170,88,82,0,0,0
2019-01-10 14:15,103,52,51,0,0,0
2019-01-10 14:30,88,50,38,0,0,0
2019-01-10 14:45,140,86,54,0,0,0
2019-01-10 15:00,140,72,68,0,0,0
2019-01-10 15:15,131,86,45,0,0,0
2019-01-10 15:30,132,71,61,0,0,0
2019-01-10 15:45,168,87,81,0,0,0
2019-01-10 16:00,185,101,84,0,0,0
2019-01-10 16:15,163,81,82,0,0,0
2019-01-10 16:30,138,71,67,0,0,0
2019-01-10 16:45,143,73,70,0,0,0
2019-01-10 17:00,159,73,86,0,0,0
2019-01-10 17:15,163,89,74,0,0,0
2019-01-10 17:30,128,69,59,0,0,0
2019-01-10 17:45,186,102,84,0,0,0
2019-01-10 18:00,148,63,85,0,0,0
2019-01-10 18:15,129,63,66,0,0,0
2019-01-10 18:30,115,66,49,0,0,0
2019-01-10 18:45,139,80,59,0,0,0
2019-01-10 19:00,98,42,56,0,0,0
2019-01-10 19:15,80,45,35,0,0,0
2019-01-10 19:30,91,42,49,0,0,0
2019-01-10 19:45,99,51,48,0,0,0
2019-01-10 20:00,81,40,41,0,0,0
2019-01-10 20:15,73,31,42,0,0,0
2019-01-10 20:30,62,23,39,0,0,0
2019-01-10 20:45,42,21,21,0,0,0
2019-01-10 21:00,49,18,31,0,0,0
2019-01-10 21:15,26,15,11,0,0,0
2019-01-10 21:30,44,19,25,0,0,0
2019-01-10 21:45,42,14,28,0,0,0
2019-01-10 22:00,57,24,33,0,0,0
2019-01-10 22:15,58,38,20,0,0,0
2019-01-10 22:30,41,23,18,0,0,0
2019-01-10 22:45,23,6,17,0,0,0
2019-01-10 23:00,25,10,15,0,0,0
2019-01-10 23:15,14,7,7,0,0,0
2019-01-10 23:30,16,6,10,0,0,0
2019-01-10 23:45,14,7,7,0,0,0
2019-01-11 00:00,14,5,9,0,0,0
2019-01-11 00:15,13,7,6,0,0,0
2019-01-11 00:30,3,0,3,0,0,0
2019-01-11 00:45,7,3,4,0,0,0
2019-01-11 01:00,9,3,6,0,0,0
2019-01-11 01:15,2,1,1,0,0,0
2019-01-11 01:30,1,0,1,0,0,0
2019-01-11 01:45,1,1,0,0,0,0
2019-01-11 02:00,3,0,3,0,0,0
2019-01-11 02:15,2,1,1,0,0,0
2019-01-11 02:30,2,1,1,0,0,0
2019-01-11 02:45,2,1,1,0,0,0
2019-01-11 03:00,2,0,2,0,0,0
2019-01-11 03:15,0,0,0,0,0,0
2019-01-11 03:30,3,0,3,0,0,0
2019-01-11 03:45,2,2,0,0,0,0
2019-01-11 04:00,0,0,0,0,0,0
2019-01-11 04:15,0,0,0,0,0,0
2019-01-11 04:30,0,0,0,0,0,0
2019-01-11 04:45,0,0,0,0,0,0
2019-01-11 05:00,0,0,0,0,0,0
2019-01-11 05:15,8,5,3,0,0,0
2019-01-11 05:30,6,3,3,0,0,0
2019-01-11 05:45,9,7,2,0,0,0
2019-01-11 06:00,9,8,1,0,0,0
2019-01-11 06:15,20,15,5,0,0,0
2019-01-11 06:30,39,29,10,0,0,0
2019-01-11 06:45,60,45,15,0,0,0
2019-01-11 07:00,58,43,15,0,0,0
2019-01-11 07:15,132,107,25,0,0,0
2019-01-11 07:30,292,271,21,0,0,0
2019-01-11 07:45,239,181,58,0,0,0
2019-01-11 08:00,166,143,23,0,0,0
2019-01-11 08:15,133,102,31,0,0,0
2019-01-11 08:30,133,100,33,0,0,0
2019-01-11 08:45,158,127,31,0,0,0
2019-01-11 09:00,99,76,23,0,0,0
2019-01-11 09:15,83,59,24,0,0,0
2019-01-11 09:30,104,80,24,0,0,0
2019-01-11 09:45,130,99,31,0,0,0
2019-01-11 10:00,108,75,33,0,0,0
2019-01-11 10:15,75,52,23,0,0,0
2019-01-11 10:30,71,45,26,0,0,0
2019-01-11 10:45,86,51,35,0,0,0
2019-01-11 11:00,85,59,26,0,0,0
2019-01-11 11:15,80,46,34,0,0,0
2019-01-11 11:30,92,63,29,0,0,0
2019-01-11 11:45,136,89,47,0,0,0
2019-01-11 12:00,120,70,50,0,0,0
2019-01-11 12:15,100,64,36,0,0,0
2019-01-11 12:30,128,64,64,0,0,0
2019-01-11 12:45,95,46,49,0,0,0
2019-01-11 13:00,126,51,75,0,0,0
2019-01-11 13:15,133,58,75,0,0,0
2019-01-11 13:30,112,55,57,0,0,0
2019-01-11 13:45,149,82,67,0,0,0
2019-01-11 14:00,160,60,100,0,0,0
2019-01-11 14:15,115,50,65,0,0,0
2019-01-11 14:30,101,49,52,0,0,0
2019-01-11 14:45,132,62,70,0,0,0
2019-01-11 15:00,155,79,76,0,0,0
2019-01-11 15:15,130,73,57,0,0,0
2019-01-11 15:30,116,58,58,0,0,0
2019-01-11 15:45,151,77,74,0,0,0
2019-01-11 16:00,133,65,68,0,0,0
2019-01-11 16:15,119,53,66,0,0,0
2019-01-11 16:30,110,48,62,0,0,0
2019-01-11 16:45,118,64,54,0,0,0
2019-01-11 17:00,120,65,55,0,0,0
2019-01-11 17:15,124,57,67,0,0,0
2019-01-11 17:30,120,65,55,0,0,0
2019-01-11 17:45,107,56,51,0,0,0
2019-01-11 18:00,125,51,74,0,0,0
2019-01-11 18:15,118,61,57,0,0,0
2019-01-11 18:30,68,41,27,0,0,0
2019-01-11 18:45,111,66,45,0,0,0
2019-01-11 19:00,125,68,57,0,0,0
2019-01-11 19:15,92,60,32,0,0,0
2019-01-11 19:30,78,46,32,0,0,0
2019-01-11 19:45,70,41,29,0,0,0
2019-01-11 20:00,71,35,36,0,0,0
2019-01-11 20:15,54,31,23,0,0,0
2019-01-11 20:30,58,29,29,0,0,0
2019-01-11 20:45,49,34,15,0,0,0
2019-01-11 21:00,46,25,21,0,0,0
2019-01-11 21:15,43,19,24,0,0,0
2019-01-11 21:30,32,13,19,0,0,0
2019-01-11 21:45,36,19,17,0,0,0
2019-01-11 22:00,37,22,15,0,0,0
2019-01-11 22:15,51,25,26,0,0,0
2019-01-11 22:30,46,17,29,0,0,0
2019-01-11 22:45,35,16,19,0,0,0
2019-01-11 23:00,36,14,22,0,0,0
2019-01-11 23:15,26,11,15,0,0,0
2019-01-11 23:30,43,19,24,0,0,0
2019-01-11 23:45,31,12,19,0,0,0
2019-01-12 00:00,38,23,15,0,0,0
2019-01-12 00:15,31,16,15,0,0,0
2019-01-12 00:30,35,16,19,0,0,0
2019-01-12 00:45,23,6,17,0,0,0
2019-01-12 01:00,15,5,10,0,0,0
2019-01-12 01:15,22,13,9,0,0,0
2019-01-12 01:30,22,11,11,0,0,0
2019-01-12 01:45,13,2,11,0,0,0
2019-01-12 02:00,17,8,9,0,0,0
2019-01-12 02:15,11,7,4,0,0,0
2019-01-12 02:30,10,1,9,0,0,0
2019-01-12 02:45,6,2,4,0,0,0
2019-01-12 03:00,9,3,6,0,0,0
2019-01-12 03:15,9,3,6,0,0,0
2019-01-12 03:30,5,2,3,0,0,0
2019-01-12 03:45,6,1,5,0,0,0
2019-01-12 04:00,9,1,8,0,0,0
2019-01-12 04:15,4,2,2,0,0,0
2019-01-12 04:30,3,1,2,0,0,0
2019-01-12 04:45,4,1,3,0,0,0
2019-01-12 05:00,6,3,3,0,0,0
2019-01-12 05:15,3,3,0,0,0,0
2019-01-12 05:30,6,6,0,0,0,0
2019-01-12 05:45,4,1,3,0,0,0
2019-01-12 06:00,3,1,2,0,0,0
2019-01-12 06:15,2,1,1,0,0,0
2019-01-12 06:30,1,1,0,0,0,0
2019-01-12 06:45,9,3,6,0,0,0
2019-01-12 07:00,11,9,2,0,0,0
2019-01-12 07:15,7,3,4,0,0,0
2019-01-12 07:30,14,8,6,0,0,0
2019-01-12 07:45,28,24,4,0,0,0
2019-01-12 08:00,13,8,5,0,0,0
2019-01-12 08:15,27,20,7,0,0,0
2019-01-12 08:30,33,27,6,0,0,0
2019-01-12 08:45,53,44,9,0,0,0
2019-01-12 09:00,52,42,10,0,0,0
2019-01-12 09:15,68,59,9,0,0,0
2019-01-12 09:30,73,60,13,0,0,0
2019-01-12 09:45,102,87,15,0,0,0
2019-01-12 10:00,95,80,15,0,0,0
2019-01-12 10:15,93,65,28,0,0,0
2019-01-12 10:30,105,84,21,0,0,0
2019-01-12 10:45,84,66,18,0,0,0
2019-01-12 11:00,109,80,29,0,0,0
2019-01-12 11:15,106,71,35,0,0,0
2019-01-12 11:30,82,51,31,0,0,0
2019-01-12 11:45,104,66,38,0,0,0
2019-01-12 12:00,113,66,47,0,0,0
2019-01-12 12:15,96,57,39,0,0,0
2019-01-12 12:30,110,61,49,0,0,0
2019-01-12 12:45,106,49,57,0,0,0
2019-01-12 13:00,98,56,42,0,0,0
2019-01-12 13:15,85,47,38,0,0,0
2019-01-12 13:30,97,44,53,0,0,0
2019-01-12 13:45,97,58,39,0,0,0
2019-01-12 14:00,76,34,42,0,0,0
2019-01-12 14:15,79,41,38,0,0,0
2019-01-12 14:30,72,32,40,0,0,0
2019-01-12 14:45,78,48,30,0,0,0
2019-01-12 15:00,79,38,41,0,0,0
2019-01-12 15:15,61,30,31,0,0,0
2019-01-12 15:30,67,28,39,0,0,0
2019-01-12 15:45,61,26,35,0,0,0
2019-01-12 16:00,58,22,36,0,0,0
2019-01-12 16:15,51,20,31,0,0,0
2019-01-12 16:30,56,36,20,0,0,0
2019-01-12 16:45,53,27,26,0,0,0
2019-01-12 17:00,52,34,18,0,0,0
2019-01-12 17:15,62,30,32,0,0,0
2019-01-12 17:30,57,31,26,0,0,0
2019-01-12 17:45,71,35,36,0,0,0
2019-01-12 18:00,47,23,24,0,0,0
2019-01-12 18:15,50,27,23,0,0,0
2019-01-12 18:30,58,22,36,0,0,0
2019-01-12 18:45,76,50,26,0,0,0
2019-01-12 19:00,64,29,35,0,0,0
2019-01-12 19:15,67,41,26,0,0,0
2019-01-12 19:30,69,37,32,0,0,0
2019-01-12 19:45,57,37,20,0,0,0
2019-01-12 20:00,30,13,17,0,0,0
2019-01-12 20:15,36,15,21,0,0,0
2019-01-12 20:30,27,17,10,0,0,0
2019-01-12 20:45,27,19,8,0,0,0
2019-01-12 21:00,30,20,10,0,0,0
2019-01-12 21:15,33,21,12,0,0,0
2019-01-12 21:30,24,13,11,0,0,0
2019-01-12 21:45,32,22,10,0,0,0
2019-01-12 22:00,24,14,10,0,0,0
2019-01-12 22:15,42,33,9,0,0,0
2019-01-12 22:30,18,9,9,0,0,0
2019-01-12 22:45,18,9,9,0,0,0
2019-01-12 23:00,10,2,8,0,0,0
2019-01-12 23:15,35,20,15,0,0,0
2019-01-12 23:30,43,23,20,0,0,0
2019-01-12 23:45,10,7,3,0,0,0
2019-01-13 00:00,19,10,9,0,0,0
2019-01-13 00:15,26,11,15,0,0,0
2019-01-13 00:30,27,20,7,0,0,0
2019-01-13 00:45,21,7,14,0,0,0
2019-01-13 01:00,26,10,16,0,0,0
2019-01-13 01:15,26,19,7,0,0,0
2019-01-13 01:30,16,2,14,0,0,0
2019-01-13 01:45,16,12,4,0,0,0
2019-01-13 02:00,12,5,7,0,0,0
2019-01-13 02:15,8,3,5,0,0,0
2019-01-13 02:30,7,4,3,0,0,0
2019-01-13 02:45,8,4,4,0,0,0
2019-01-13 03:00,4,2,2,0,0,0
2019-01-13 03:15,6,1,5,0,0,0
2019-01-13 03:30,9,3,6,0,0,0
2019-01-13 03:45,6,0,6,0,0,0
2019-01-13 04:00,7,3,4,0,0,0
2019-01-13 04:15,6,1,5,0,0,0
2019-01-13 04:30,1,0,1,0,0,0
2019-01-13 04:45,7,2,5,0,0,0
2019-01-13 05:00,4,0,4,0,0,0
2019-01-13 05:15,0,0,0,0,0,0
2019-01-13 05:30,10,7,3,0,0,0
2019-01-13 05:45,4,3,1,0,0,0
2019-01-13 06:00,3,1,2,0,0,0
2019-01-13 06:15,2,0,2,0,0,0
2019-01-13 06:30,2,1,1,0,0,0
2019-01-13 06:45,3,1,2,0,0,0
2019-01-13 07:00,1,0,1,0,0,0
2019-01-13 07:15,6,5,1,0,0,0
2019-01-13 07:30,4,2,2,0,0,0
2019-01-13 07:45,15,12,3,0,0,0
2019-01-13 08:00,7,6,1,0,0,0
2019-01-13 08:15,14,12,2,0,0,0
2019-01-13 08:30,4,4,0,0,0,0
2019-01-13 08:45,12,6,6,0,0,0
2019-01-13 09:00,21,16,5,0,0,0
2019-01-13 09:15,5,4,1,0,0,0
2019-01-13 09:30,9,7,2,0,0,0
2019-01-13 09:45,19,15,4,0,0,0
2019-01-13 10:00,29,21,8,0,0,0
2019-01-13 10:15,19,18,1,0,0,0
2019-01-13 10:30,16,8,8,0,0,0
2019-01-13 10:45,24,14,10,0,0,0
2019-01-13 11:00,29,21,8,0,0,0
2019-01-13 11:15,17,16,1,0,0,0
2019-01-13 11:30,27,21,6,0,0,0
2019-01-13 11:45,24,13,11,0,0,0
2019-01-13 12:00,15,5,10,0,0,0
2019-01-13 12:15,25,11,14,0,0,0
2019-01-13 12:30,30,15,15,0,0,0
2019-01-13 12:45,31,18,13,0,0,0
2019-01-13 13:00,25,12,13,0,0,0
2019-01-13 13:15,26,15,11,0,0,0
2019-01-13 13:30,38,20,18,0,0,0
2019-01-13 13:45,33,20,13,0,0,0
2019-01-13 14:00,34,18,16,0,0,0
2019-01-13 14:15,40,29,11,0,0,0
2019-01-13 14:30,34,22,12,0,0,0
2019-01-13 14:45,43,29,14,0,0,0
2019-01-13 15:00,35,24,11,0,0,0
2019-01-13 15:15,31,13,18,0,0,0
2019-01-13 15:30,18,7,11,0,0,0
2019-01-13 15:45,39,18,21,0,0,0
2019-01-13 16:00,30,17,13,0,0,0
2019-01-13 16:15,29,15,14,0,0,0
2019-01-13 16:30,31,17,14,0,0,0
2019-01-13 16:45,36,22,14,0,0,0
2019-01-13 17:00,32,19,13,0,0,0
2019-01-13 17:15,27,15,12,0,0,0
2019-01-13 17:30,34,17,17,0,0,0
2019-01-13 17:45,19,5,14,0,0,0
2019-01-13 18:00,27,10,17,0,0,0
2019-01-13 18:15,40,17,23,0,0,0
2019-01-13 18:30,24,10,14,0,0,0
2019-01-13 18:45,53,24,29,0,0,0
2019-01-13 19:00,26,12,14,0,0,0
2019-01-13 19:15,32,21,11,0,0,0
2019-01-13 19:30,25,9,16,0,0,0
2019-01-13 19:45,21,13,8,0,0,0
2019-01-13 20:00,32,19,13,0,0,0
2019-01-13 20:15,25,17,8,0,0,0
2019-01-13 20:30,15,8,7,0,0,0
2019-01-13 20:45,17,11,6,0,0,0
2019-01-13 21:00,12,5,7,0,0,0
2019-01-13 21:15,13,5,8,0,0,0
2019-01-13 21:30,11,5,6,0,0,0
2019-01-13 21:45,17,8,9,0,0,0
2019-01-13 22:00,28,21,7,0,0,0
2019-01-13 22:15,12,10,2,0,0,0
2019-01-13 22:30,15,6,9,0,0,0
2019-01-13 22:45,13,9,4,0,0,0
2019-01-13 23:00,12,6,6,0,0,0
2019-01-13 23:15,7,4,3,0,0,0
2019-01-13 23:30,5,2,3,0,0,0
2019-01-13 23:45,3,1,2,0,0,0
2019-01-14 00:00,7,2,5,0,0,0
2019-01-14 00:15,1,0,1,0,0,0
2019-01-14 00:30,3,1,2,0,0,0
2019-01-14 00:45,2,0,2,0,0,0
2019-01-14 01:00,0,0,0,0,0,0
2019-01-14 01:15,1,0,1,0,0,0
2019-01-14 01:30,0,0,0,0,0,0
2019-01-14 01:45,6,3,3,0,0,0
2019-01-14 02:00,0,0,0,0,0,0
2019-01-14 02:15,0,0,0,0,0,0
2019-01-14 02:30,0,0,0,0,0,0
2019-01-14 02:45,0,0,0,0,0,0
2019-01-14 03:00,1,0,1,0,0,0
2019-01-14 03:15,0,0,0,0,0,0
2019-01-14 03:30,0,0,0,0,0,0
2019-01-14 03:45,0,0,0,0,0,0
2019-01-14 04:00,1,0,1,0,0,0
2019-01-14 04:15,1,1,0,0,0,0
2019-01-14 04:30,0,0,0,0,0,0
2019-01-14 04:45,0,0,0,0,0,0
2019-01-14 05:00,0,0,0,0,0,0
2019-01-14 05:15,7,3,4,0,0,0
2019-01-14 05:30,16,12,4,0,0,0
2019-01-14 05:45,12,6,6,0,0,0
2019-01-14 06:00,13,10,3,0,0,0
2019-01-14 06:15,25,14,11,0,0,0
2019-01-14 06:30,47,29,18,0,0,0
2019-01-14 06:45,67,48,19,0,0,0
2019-01-14 07:00,75,53,22,0,0,0
2019-01-14 07:15,145,122,23,0,0,0
2019-01-14 07:30,312,264,48,0,0,0
2019-01-14 07:45,222,174,48,0,0,0
2019-01-14 08:00,170,141,29,0,0,0
2019-01-14 08:15,164,128,36,0,0,0
2019-01-14 08:30,139,110,29,0,0,0
2019-01-14 08:45,150,122,28,0,0,0
2019-01-14 09:00,95,74,21,0,0,0
2019-01-14 09:15,120,89,31,0,0,0
2019-01-14 09:30,101,85,16,0,0,0
2019-01-14 09:45,174,138,36,0,0,0
2019-01-14 10:00,101,77,24,0,0,0
2019-01-14 10:15,85,57,28,0,0,0
2019-01-14 10:30,74,51,23,0,0,0
2019-01-14 10:45,108,70,38,0,0,0
2019-01-14 11:00,76,47,29,0,0,0
2019-01-14 11:15,90,64,26,0,0,0
2019-01-14 11:30,81,48,33,0,0,0
2019-01-14 11:45,122,72,50,0,0,0
2019-01-14 12:00,124,80,44,0,0,0
2019-01-14 12:15,107,66,41,0,0,0
2019-01-14 12:30,98,52,46,0,0,0
2019-01-14 12:45,114,61,53,0,0,0
2019-01-14 13:00,146,69,77,0,0,0
2019-01-14 13:15,113,59,54,0,0,0
2019-01-14 13:30,96,56,40,0,0,0
2019-01-14 13:45,154,103,51,0,0,0
2019-01-14 14:00,140,55,85,0,0,0
2019-01-14 14:15,75,34,41,0,0,0
2019-01-14 14:30,77,39,38,0,0,0
2019-01-14 14:45,109,68,41,0,0,0
2019-01-14 15:00,111,58,53,0,0,0
2019-01-14 15:15,110,60,50,0,0,0
2019-01-14 15:30,134,56,78,0,0,0
2019-01-14 15:45,173,83,90,0,0,0
2019-01-14 16:00,137,68,69,0,0,0
2019-01-14 16:15,166,90,76,0,0,0
2019-01-14 16:30,164,97,67,0,0,0
2019-01-14 16:45,154,80,74,0,0,0
2019-01-14 17:00,133,57,76,0,0,0
2019-01-14 17:15,132,60,72,0,0,0
2019-01-14 17:30,208,104,104,0,0,0
2019-01-14 17:45,170,73,97,0,0,0
2019-01-14 18:00,159,67,92,0,0,0
2019-01-14 18:15,124,61,63,0,0,0
2019-01-14 18:30,102,39,63,0,0,0
2019-01-14 18:45,119,72,47,0,0,0
2019-01-14 19:00,88,37,51,0,0,0
2019-01-14 19:15,97,45,52,0,0,0
2019-01-14 19:30,73,38,35,0,0,0
2019-01-14 19:45,112,58,54,0,0,0
2019-01-14 20:00,68,29,39,0,0,0
2019-01-14 20:15,48,22,26,0,0,0
2019-01-14 20:30,35,14,21,0,0,0
2019-01-14 20:45,29,8,21,0,0,0
2019-01-14 21:00,35,20,15,0,0,0
2019-01-14 21:15,43,19,24,0,0,0
2019-01-14 21:30,41,19,22,0,0,0
2019-01-14 21:45,35,12,23,0,0,0
2019-01-14 22:00,39,19,20,0,0,0
2019-01-14 22:15,39,17,22,0,0,0
2019-01-14 22:30,26,16,10,0,0,0
2019-01-14 22:45,37,24,13,0,0,0
2019-01-14 23:00,19,10,9,0,0,0
2019-01-14 23:15,15,10,5,0,0,0
2019-01-14 23:30,7,2,5,0,0,0
2019-01-14 23:45,10,4,6,0,0,0
2019-01-15 00:00,15,8,7,0,0,0
2019-01-15 00:15,10,6,4,0,0,0
2019-01-15 00:30,0,0,0,0,0,0
2019-01-15 00:45,7,0,7,0,0,0
2019-01-15 01:00,1,1,0,0,0,0
2019-01-15 01:15,4,0,4,0,0,0
2019-01-15 01:30,0,0,0,0,0,0
2019-01-15 01:45,2,1,1,0,0,0
2019-01-15 02:00,2,1,1,0,0,0
2019-01-15 02:15,4,2,2,0,0,0
2019-01-15 02:30,2,2,0,0,0,0
2019-01-15 02:45,3,2,1,0,0,0
2019-01-15 03:00,1,1,0,0,0,0
2019-01-15 03:15,1,0,1,0,0,0
2019-01-15 03:30,0,0,0,0,0,0
2019-01-15 03:45,1,1,0,0,0,0
2019-01-15 04:00,1,0,1,0,0,0
2019-01-15 04:15,0,0,0,0,0,0
2019-01-15 04:30,0,0,0,0,0,0
2019-01-15 04:45,0,0,0,0,0,0
2019-01-15 05:00,2,0,2,0,0,0
2019-01-15 05:15,7,6,1,0,0,0
2019-01-15 05:30,17,12,5,0,0,0
2019-01-15 05:45,18,12,6,0,0,0
2019-01-15 06:00,15,12,3,0,0,0
2019-01-15 06:15,27,17,10,0,0,0
2019-01-15 06:30,46,34,12,0,0,0
2019-01-15 06:45,73,52,21,0,0,0
2019-01-15 07:00,96,62,34,0,0,0
2019-01-15 07:15,163,122,41,0,0,0
2019-01-15 07:30,296,272,24,0,0,0
2019-01-15 07:45,252,197,55,0,0,0
2019-01-15 08:00,191,163,28,0,0,0
2019-01-15 08:15,159,128,31,0,0,0
2019-01-15 08:30,144,107,37,0,0,0
2019-01-15 08:45,150,121,29,0,0,0
2019-01-15 09:00,95,69,26,0,0,0
2019-01-15 09:15,105,85,20,0,0,0
2019-01-15 09:30,116,99,17,0,0,0
2019-01-15 09:45,159,137,22,0,0,0
2019-01-15 10:00,120,96,24,0,0,0
2019-01-15 10:15,78,56,22,0,0,0
2019-01-15 10:30,76,49,27,0,0,0
2019-01-15 10:45,103,82,21,0,0,0
2019-01-15 11:00,94,60,34,0,0,0
2019-01-15 11:15,95,53,42,0,0,0
2019-01-15 11:30,77,45,32,0,0,0
2019-01-15 11:45,104,62,42,0,0,0
2019-01-15 12:00,114,67,47,0,0,0
2019-01-15 12:15,113,74,39,0,0,0
2019-01-15 12:30,102,55,47,0,0,0
2019-01-15 12:45,105,52,53,0,0,0
2019-01-15 13:00,122,56,66,0,0,0
2019-01-15 13:15,129,67,62,0,0,0
2019-01-15 13:30,113,68,45,0,0,0
2019-01-15 13:45,143,85,58,0,0,0
2019-01-15 14:00,143,66,77,0,0,0
2019-01-15 14:15,102,51,51,0,0,0
2019-01-15 14:30,87,47,40,0,0,0
2019-01-15 14:45,122,77,45,0,0,0
2019-01-15 15:00,107,56,51,0,0,0
2019-01-15 15:15,143,80,63,0,0,0
2019-01-15 15:30,123,63,60,0,0,0
2019-01-15 15:45,190,110,80,0,0,0
2019-01-15 16:00,176,103,73,0,0,0
2019-01-15 16:15,148,72,76,0,0,0
2019-01-15 16:30,134,72,62,0,0,0
2019-01-15 16:45,162,90,72,0,0,0
2019-01-15 17:00,167,81,86,0,0,0
2019-01-15 17:15,146,70,76,0,0,0
2019-01-15 17:30,151,77,74,0,0,0
2019-01-15 17:45,191,91,100,0,0,0
2019-01-15 18:00,158,71,87,0,0,0
2019-01-15 18:15,126,55,71,0,0,0
2019-01-15 18:30,121,55,66,0,0,0
2019-01-15 18:45,91,47,44,0,0,0
2019-01-15 19:00,87,31,56,0,0,0
2019-01-15 19:15,101,57,44,0,0,0
2019-01-15 19:30,92,44,48,0,0,0
2019-01-15 19:45,98,53,45,0,0,0
2019-01-15 20:00,72,39,33,0,0,0
2019-01-15 20:15,58,23,35,0,0,0
2019-01-15 20:30,51,33,18,0,0,0
2019-01-15 20:45,36,17,19,0,0,0
2019-01-15 21:00,55,27,28,0,0,0
2019-01-15 21:15,32,15,17,0,0,0
2019-01-15 21:30,45,18,27,0,0,0
2019-01-15 21:45,37,15,22,0,0,0
2019-01-15 22:00,64,36,28,0,0,0
2019-01-15 22:15,51,26,25,0,0,0
2019-01-15 22:30,38,23,15,0,0,0
2019-01-15 22:45,23,12,11,0,0,0
2019-01-15 23:00,29,15,14,0,0,0
2019-01-15 23:15,15,5,10,0,0,0
2019-01-15 23:30,11,4,7,0,0,0
2019-01-15 23:45,12,6,6,0,0,0
2019-01-16 00:00,3,0,3,0,0,0
2019-01-16 00:15,5,2,3,0,0,0
2019-01-16 00:30,4,2,2,0,0,0
2019-01-16 00:45,4,2,2,0,0,0
2019-01-16 01:00,1,0,1,0,0,0
2019-01-16 01:15,1,0,1,0,0,0
2019-01-16 01:30,0,0,0,0,0,0
2019-01-16 01:45,1,1,0,0,0,0
2019-01-16 02:00,3,0,3,0,0,0
2019-01-16 02:15,1,1,0,0,0,0
2019-01-16 02:30,1,0,1,0,0,0
2019-01-16 02:45,0,0,0,0,0,0
2019-01-16 03:00,2,2,0,0,0,0
2019-01-16 03:15,0,0,0,0,0,0
2019-01-16 03:30,1,0,1,0,0,0
2019-01-16 03:45,0,0,0,0,0,0
2019-01-16 04:00,0,0,0,0,0,0
2019-01-16 04:15,1,0,1,0,0,0
2019-01-16 04:30,2,2,0,0,0,0
2019-01-16 04:45,1,0,1,0,0,0
2019-01-16 05:00,3,2,1,0,0,0
2019-01-16 05:15,6,5,1,0,0,0
2019-01-16 05:30,7,7,0,0,0,0
2019-01-16 05:45,16,9,7,0,0,0
2019-01-16 06:00,12,11,1,0,0,0
2019-01-16 06:15,15,10,5,0,0,0
2019-01-16 06:30,48,28,20,0,0,0
2019-01-16 06:45,71,49,22,0,0,0
2019-01-16 07:00,85,62,23,0,0,0
2019-01-16 07:15,160,131,29,0,0,0
2019-01-16 07:30,297,269,28,0,0,0
2019-01-16 07:45,234,177,57,0,0,0
2019-01-16 08:00,193,159,34,0,0,0
2019-01-16 08:15,181,143,38,0,0,0
2019-01-16 08:30,138,106,32,0,0,0
2019-01-16 08:45,160,121,39,0,0,0
2019-01-16 09:00,125,100,25,0,0,0
2019-01-16 09:15,108,85,23,0,0,0
2019-01-16 09:30,113,87,26,0,0,0
2019-01-16 09:45,157,140,17,0,0,0
2019-01-16 10:00,119,92,27,0,0,0
2019-01-16 10:15,94,75,19,0,0,0
2019-01-16 10:30,113,79,34,0,0,0
2019-01-16 10:45,97,65,32,0,0,0
2019-01-16 11:00,92,65,27,0,0,0
2019-01-16 11:15,77,52,25,0,0,0
2019-01-16 11:30,107,69,38,0,0,0
2019-01-16 11:45,137,80,57,0,0,0
2019-01-16 12:00,125,76,49,0,0,0
2019-01-16 12:15,117,64,53,0,0,0
2019-01-16 12:30,123,64,59,0,0,0
2019-01-16 12:45,149,83,66,0,0,0
2019-01-16 13:00,109,55,54,0,0,0
2019-01-16 13:15,138,71,67,0,0,0
2019-01-16 13:30,100,53,47,0,0,0
2019-01-16 13:45,143,78,65,0,0,0
2019-01-16 14:00,128,59,69,0,0,0
2019-01-16 14:15,105,49,56,0,0,0
2019-01-16 14:30,121,55,66,0,0,0
2019-01-16 14:45,125,66,59,0,0,0
2019-01-16 15:00,137,70,67,0,0,0
2019-01-16 15:15,111,61,50,0,0,0
2019-01-16 15:30,138,57,81,0,0,0
2019-01-16 15:45,179,95,84,0,0,0
2019-01-16 16:00,166,75,91,0,0,0
2019-01-16 16:15,131,72,59,0,0,0
2019-01-16 16:30,151,69,82,0,0,0
2019-01-16 16:45,163,79,84,0,0,0
2019-01-16 17:00,160,94,66,0,0,0
2019-01-16 17:15,163,80,83,0,0,0
2019-01-16 17:30,136,64,72,0,0,0
2019-01-16 17:45,158,93,65,0,0,0
2019-01-16 18:00,156,89,67,0,0,0
2019-01-16 18:15,123,57,66,0,0,0
2019-01-16 18:30,113,67,46,0,0,0
2019-01-16 18:45,136,80,56,0,0,0
2019-01-16 19:00,99,43,56,0,0,0
2019-01-16 19:15,122,74,48,0,0,0
2019-01-16 19:30,104,59,45,0,0,0
2019-01-16 19:45,118,65,53,0,0,0
2019-01-16 20:00,75,28,47,0,0,0
2019-01-16 20:15,58,26,32,0,0,0
2019-01-16 20:30,59,28,31,0,0,0
2019-01-16 20:45,42,21,21,0,0,0
2019-01-16 21:00,46,19,27,0,0,0
2019-01-16 21:15,37,10,27,0,0,0
2019-01-16 21:30,45,24,21,0,0,0
2019-01-16 21:45,47,19,28,0,0,0
2019-01-16 22:00,45,21,24,0,0,0
2019-01-16 22:15,57,14,43,0,0,0
2019-01-16 22:30,66,37,29,0,0,0
2019-01-16 22:45,49,20,29,0,0,0
2019-01-16 23:00,22,13,9,0,0,0
2019-01-16 23:15,25,10,15,0,0,0
2019-01-16 23:30,34,22,12,0,0,0
2019-01-16 23:45,13,7,6,0,0,0
2019-01-17 00:00,16,3,13,0,0,0
2019-01-17 00:15,15,5,10,0,0,0
2019-01-17 00:30,3,2,1,0,0,0
2019-01-17 00:45,3,2,1,0,0,0
2019-01-17 01:00,0,0,0,0,0,0
2019-01-17 01:15,1,0,1,0,0,0
2019-01-17 01:30,5,3,2,0,0,0
2019-01-17 01:45,20,17,3,0,0,0
2019-01-17 02:00,2,2,0,0,0,0
2019-01-17 02:15,4,3,1,0,0,0
2019-01-17 02:30,2,2,0,0,0,0
2019-01-17 02:45,1,0,1,0,0,0
2019-01-17 03:00,2,1,1,0,0,0
2019-01-17 03:15,1,0,1,0,0,0
2019-01-17 03:30,0,0,0,0,0,0
2019-01-17 03:45,3,1,2,0,0,0
2019-01-17 04:00,2,2,0,0,0,0
2019-01-17 04:15,1,0,1,0,0,0
2019-01-17 04:30,2,2,0,0,0,0
2019-01-17 04:45,0,0,0,0,0,0
2019-01-17 05:00,1,0,1,0,0,0
2019-01-17 05:15,5,4,1,0,0,0
2019-01-17 05:30,8,7,1,0,0,0
2019-01-17 05:45,10,5,5,0,0,0
2019-01-17 06:00,13,8,5,0,0,0
2019-01-17 06:15,23,14,9,0,0,0
2019-01-17 06:30,46,29,17,0,0,0
2019-01-17 06:45,73,54,19,0,0,0
2019-01-17 07:00,62,43,19,0,0,0
2019-01-17 07:15,161,128,33,0,0,0
2019-01-17 07:30,318,286,32,0,0,0
2019-01-17 07:45,213,170,43,0,0,0
2019-01-17 08:00,190,160,30,0,0,0
2019-01-17 08:15,152,112,40,0,0,0
2019-01-17 08:30,139,112,27,0,0,0
2019-01-17 08:45,151,121,30,0,0,0
2019-01-17 09:00,95,78,17,0,0,0
2019-01-17 09:15,89,68,21,0,0,0
2019-01-17 09:30,107,80,27,0,0,0
2019-01-17 09:45,156,135,21,0,0,0
2019-01-17 10:00,95,73,22,0,0,0
2019-01-17 10:15,107,81,26,0,0,0
2019-01-17 10:30,68,42,26,0,0,0
2019-01-17 10:45,69,52,17,0,0,0
2019-01-17 11:00,57,41,16,0,0,0
2019-01-17 11:15,89,55,34,0,0,0
2019-01-17 11:30,98,61,37,0,0,0
2019-01-17 11:45,114,73,41,0,0,0
2019-01-17 12:00,85,44,41,0,0,0
2019-01-17 12:15,89,43,46,0,0,0
2019-01-17 12:30,76,42,34,0,0,0
2019-01-17 12:45,76,44,32,0,0,0
2019-01-17 13:00,105,37,68,0,0,0
2019-01-17 13:15,97,41,56,0,0,0
2019-01-17 13:30,87,46,41,0,0,0
2019-01-17 13:45,99,58,41,0,0,0
2019-01-17 14:00,147,58,89,0,0,0
2019-01-17 14:15,84,32,52,0,0,0
2019-01-17 14:30,65,30,35,0,0,0
2019-01-17 14:45,86,46,40,0,0,0
2019-01-17 15:00,74,34,40,0,0,0
2019-01-17 15:15,105,56,49,0,0,0
2019-01-17 15:30,131,58,73,0,0,0
2019-01-17 15:45,159,86,73,0,0,0
2019-01-17 16:00,171,94,77,0,0,0
2019-01-17 16:15,131,64,67,0,0,0
2019-01-17 16:30,119,58,61,0,0,0
2019-01-17 16:45,154,84,70,0,0,0
2019-01-17 17:00,143,67,76,0,0,0
2019-01-17 17:15,149,73,76,0,0,0
2019-01-17 17:30,119,55,64,0,0,0
2019-01-17 17:45,157,94,63,0,0,0
2019-01-17 18:00,135,73,62,0,0,0
2019-01-17 18:15,115,62,53,0,0,0
2019-01-17 18:30,107,50,57,0,0,0
2019-01-17 18:45,112,71,41,0,0,0
2019-01-17 19:00,77,28,49,0,0,0
2019-01-17 19:15,99,47,52,0,0,0
2019-01-17 19:30,87,48,39,0,0,0
2019-01-17 19:45,100,50,50,0,0,0
2019-01-17 20:00,82,36,46,0,0,0
2019-01-17 20:15,56,22,34,0,0,0
2019-01-17 20:30,32,14,18,0,0,0
2019-01-17 20:45,52,15,37,0,0,0
2019-01-17 21:00,30,14,16,0,0,0
2019-01-17 21:15,49,21,28,0,0,0
2019-01-17 21:30,41,21,20,0,0,0
2019-01-17 21:45,34,22,12,0,0,0
2019-01-17 22:00,43,12,31,0,0,0
2019-01-17 22:15,35,9,26,0,0,0
2019-01-17 22:30,33,11,22,0,0,0
2019-01-17 22:45,27,14,13,0,0,0
2019-01-17 23:00,23,4,19,0,0,0
2019-01-17 23:15,23,12,11,0,0,0
2019-01-17 23:30,19,13,6,0,0,0
2019-01-17 23:45,24,19,5,0,0,0
2019-01-18 00:00,18,7,11,0,0,0
2019-01-18 00:15,4,2,2,0,0,0
2019-01-18 00:30,4,0,4,0,0,0
2019-01-18 00:45,8,7,1,0,0,0
2019-01-18 01:00,5,2,3,0,0,0
2019-01-18 01:15,0,0,0,0,0,0
2019-01-18 01:30,2,2,0,0,0,0
2019-01-18 01:45,5,3,2,0,0,0
2019-01-18 02:00,7,4,3,0,0,0
2019-01-18 02:15,0,0,0,0,0,0
2019-01-18 02:30,3,1,2,0,0,0
2019-01-18 02:45,1,0,1,0,0,0
2019-01-18 03:00,2,0,2,0,0,0
2019-01-18 03:15,0,0,0,0,0,0
2019-01-18 03:30,2,1,1,0,0,0
2019-01-18 03:45,3,2,1,0,0,0
2019-01-18 04:00,1,0,1,0,0,0
2019-01-18 04:15,0,0,0,0,0,0
2019-01-18 04:30,3,0,3,0,0,0
2019-01-18 04:45,3,3,0,0,0,0
2019-01-18 05:00,2,1,1,0,0,0
2019-01-18 05:15,2,0,2,0,0,0
2019-01-18 05:30,11,9,2,0,0,0
2019-01-18 05:45,11,6,5,0,0,0
2019-01-18 06:00,9,4,5,0,0,0
2019-01-18 06:15,19,12,7,0,0,0
2019-01-18 06:30,38,28,10,0,0,0
2019-01-18 06:45,47,32,15,0,0,0
2019-01-18 07:00,67,46,21,0,0,0
2019-01-18 07:15,142,117,25,0,0,0
2019-01-18 07:30,281,251,30,0,0,0
2019-01-18 07:45,187,145,42,0,0,0
2019-01-18 08:00,177,159,18,0,0,0
2019-01-18 08:15,131,105,26,0,0,0
2019-01-18 08:30,119,91,28,0,0,0
2019-01-18 08:45,157,137,20,0,0,0
2019-01-18 09:00,110,93,17,0,0,0
2019-01-18 09:15,80,66,14,0,0,0
2019-01-18 09:30,105,86,19,0,0,0
2019-01-18 09:45,149,121,28,0,0,0
2019-01-18 10:00,90,64,26,0,0,0
2019-01-18 10:15,90,65,25,0,0,0
2019-01-18 10:30,81,62,19,0,0,0
2019-01-18 10:45,86,62,24,0,0,0
2019-01-18 11:00,83,52,31,0,0,0
2019-01-18 11:15,103,68,35,0,0,0
2019-01-18 11:30,92,63,29,0,0,0
2019-01-18 11:45,125,75,50,0,0,0
2019-01-18 12:00,119,66,53,0,0,0
2019-01-18 12:15,113,51,62,0,0,0
2019-01-18 12:30,138,75,63,0,0,0
2019-01-18 12:45,130,65,65,0,0,0
2019-01-18 13:00,146,70,76,0,0,0
2019-01-18 13:15,150,57,93,0,0,0
2019-01-18 13:30,122,57,65,0,0,0
2019-01-18 13:45,144,67,77,0,0,0
2019-01-18 14:00,135,54,81,0,0,0
2019-01-18 14:15,135,75,60,0,0,0
2019-01-18 14:30,101,50,51,0,0,0
2019-01-18 14:45,122,56,66,0,0,0
2019-01-18 15:00,157,82,75,0,0,0
2019-01-18 15:15,135,77,58,0,0,0
2019-01-18 15:30,160,105,55,0,0,0
2019-01-18 15:45,160,108,52,0,0,0
2019-01-18 16:00,120,76,44,0,0,0
2019-01-18 16:15,145,79,66,0,0,0
2019-01-18 16:30,123,80,43,0,0,0
2019-01-18 16:45,118,68,50,0,0,0
2019-01-18 17:00,107,55,52,0,0,0
2019-01-18 17:15,122,65,57,0,0,0
2019-01-18 17:30,126,66,60,0,0,0
2019-01-18 17:45,138,82,56,0,0,0
2019-01-18 18:00,118,53,65,0,0,0
2019-01-18 18:15,110,52,58,0,0,0
2019-01-18 18:30,117,48,69,0,0,0
2019-01-18 18:45,105,54,51,0,0,0
2019-01-18 19:00,98,47,51,0,0,0
2019-01-18 19:15,88,44,44,0,0,0
2019-01-18 19:30,74,47,27,0,0,0
2019-01-18 19:45,78,43,35,0,0,0
2019-01-18 20:00,73,38,35,0,0,0
2019-01-18 20:15,59,27,32,0,0,0
2019-01-18 20:30,39,21,18,0,0,0
2019-01-18 20:45,36,17,19,0,0,0
2019-01-18 21:00,51,29,22,0,0,0
2019-01-18 21:15,35,14,21,0,0,0
2019-01-18 21:30,52,33,19,0,0,0
2019-01-18 21:45,29,18,11,0,0,0
2019-01-18 22:00,32,18,14,0,0,0
2019-01-18 22:15,38,22,16,0,0,0
2019-01-18 22:30,24,16,8,0,0,0
2019-01-18 22:45,45,24,21,0,0,0
2019-01-18 23:00,26,10,16,0,0,0
2019-01-18 23:15,49,26,23,0,0,0
2019-01-18 23:30,30,18,12,0,0,0
2019-01-18 23:45,33,18,15,0,0,0
2019-01-19 00:00,36,21,15,0,0,0
2019-01-19 00:15,27,11,16,0,0,0
2019-01-19 00:30,22,9,13,0,0,0
2019-01-19 00:45,20,13,7,0,0,0
2019-01-19 01:00,21,14,7,0,0,0
2019-01-19 01:15,15,8,7,0,0,0
2019-01-19 01:30,15,10,5,0,0,0
2019-01-19 01:45,14,2,12,0,0,0
2019-01-19 02:00,15,10,5,0,0,0
2019-01-19 02:15,10,2,8,0,0,0
2019-01-19 02:30,9,4,5,0,0,0
2019-01-19 02:45,12,3,9,0,0,0
2019-01-19 03:00,6,2,4,0,0,0
2019-01-19 03:15,6,0,6,0,0,0
2019-01-19 03:30,8,4,4,0,0,0
2019-01-19 03:45,6,1,5,0,0,0
2019-01-19 04:00,3,1,2,0,0,0
2019-01-19 04:15,2,2,0,0,0,0
2019-01-19 04:30,3,2,1,0,0,0
2019-01-19 04:45,1,0,1,0,0,0
2019-01-19 05:00,2,0,2,0,0,0
2019-01-19 05:15,4,2,2,0,0,0
2019-01-19 05:30,8,4,4,0,0,0
2019-01-19 05:45,11,5,6,0,0,0
2019-01-19 06:00,8,6,2,0,0,0
2019-01-19 06:15,8,6,2,0,0,0
2019-01-19 06:30,5,5,0,0,0,0
2019-01-19 06:45,5,3,2,0,0,0
2019-01-19 07:00,7,5,2,0,0,0
2019-01-19 07:15,12,11,1,0,0,0
2019-01-19 07:30,27,20,7,0,0,0
2019-01-19 07:45,46,41,5,0,0,0
2019-01-19 08:00,23,20,3,0,0,0
2019-01-19 08:15,25,21,4,0,0,0
2019-01-19 08:30,27,20,7,0,0,0
2019-01-19 08:45,65,54,11,0,0,0
2019-01-19 09:00,47,41,6,0,0,0
2019-01-19 09:15,52,43,9,0,0,0
2019-01-19 09:30,73,64,9,0,0,0
2019-01-19 09:45,86,69,17,0,0,0
2019-01-19 10:00,95,78,17,0,0,0
2019-01-19 10:15,109,94,15,0,0,0
2019-01-19 10:30,102,85,17,0,0,0
2019-01-19 10:45,122,94,28,0,0,0
2019-01-19 11:00,108,79,29,0,0,0
2019-01-19 11:15,108,76,32,0,0,0
2019-01-19 11:30,136,89,47,0,0,0
2019-01-19 11:45,138,107,31,0,0,0
2019-01-19 12:00,142,103,39,0,0,0
2019-01-19 12:15,145,93,52,0,0,0
2019-01-19 12:30,138,91,47,0,0,0
2019-01-19 12:45,148,87,61,0,0,0
2019-01-19 13:00,137,84,53,0,0,0
2019-01-19 13:15,131,84,47,0,0,0
2019-01-19 13:30,145,77,68,0,0,0
2019-01-19 13:45,134,82,52,0,0,0
2019-01-19 14:00,122,70,52,0,0,0
2019-01-19 14:15,105,48,57,0,0,0
2019-01-19 14:30,120,58,62,0,0,0
2019-01-19 14:45,109,49,60,0,0,0
2019-01-19 15:00,103,55,48,0,0,0
2019-01-19 15:15,109,60,49,0,0,0
2019-01-19 15:30,117,68,49,0,0,0
2019-01-19 15:45,97,51,46,0,0,0
2019-01-19 16:00,103,54,49,0,0,0
2019-01-19 16:15,101,47,54,0,0,0
2019-01-19 16:30,76,22,54,0,0,0
2019-01-19 16:45,83,48,35,0,0,0
2019-01-19 17:00,57,25,32,0,0,0
2019-01-19 17:15,64,34,30,0,0,0
2019-01-19 17:30,74,39,35,0,0,0
2019-01-19 17:45,76,41,35,0,0,0
2019-01-19 18:00,94,41,53,0,0,0
2019-01-19 18:15,98,59,39,0,0,0
2019-01-19 18:30,74,38,36,0,0,0
2019-01-19 18:45,84,51,33,0,0,0
2019-01-19 19:00,79,54,25,0,0,0
2019-01-19 19:15,62,42,20,0,0,0
2019-01-19 19:30,58,40,18,0,0,0
2019-01-19 19:45,45,26,19,0,0,0
2019-01-19 20:00,51,22,29,0,0,0
2019-01-19 20:15,60,34,26,0,0,0
2019-01-19 20:30,62,32,30,0,0,0
2019-01-19 20:45,34,19,15,0,0,0
2019-01-19 21:00,30,19,11,0,0,0
2019-01-19 21:15,43,16,27,0,0,0
2019-01-19 21:30,21,14,7,0,0,0
2019-01-19 21:45,37,12,25,0,0,0
2019-01-19 22:00,42,20,22,0,0,0
2019-01-19 22:15,21,5,16,0,0,0
2019-01-19 22:30,23,14,9,0,0,0
2019-01-19 22:45,29,18,11,0,0,0
2019-01-19 23:00,41,26,15,0,0,0
2019-01-19 23:15,39,22,17,0,0,0
2019-01-19 23:30,42,16,26,0,0,0
2019-01-19 23:45,32,16,16,0,0,0
2019-01-20 00:00,26,15,11,0,0,0
2019-01-20 00:15,20,13,7,0,0,0
2019-01-20 00:30,26,13,13,0,0,0
2019-01-20 00:45,20,9,11,0,0,0
2019-01-20 01:00,19,9,10,0,0,0
2019-01-20 01:15,21,10,11,0,0,0
2019-01-20 01:30,20,5,15,0,0,0
2019-01-20 01:45,18,6,12,0,0,0
2019-01-20 02:00,17,2,15,0,0,0
2019-01-20 02:15,10,6,4,0,0,0
2019-01-20 02:30,10,6,4,0,0,0
2019-01-20 02:45,9,6,3,0,0,0
2019-01-20 03:00,8,0,8,0,0,0
2019-01-20 03:15,3,1,2,0,0,0
2019-01-20 03:30,4,2,2,0,0,0
2019-01-20 03:45,6,3,3,0,0,0
2019-01-20 04:00,13,7,6,0,0,0
2019-01-20 04:15,0,0,0,0,0,0
2019-01-20 04:30,3,2,1,0,0,0
2019-01-20 04:45,8,2,6,0,0,0
2019-01-20 05:00,1,0,1,0,0,0
2019-01-20 05:15,3,1,2,0,0,0
2019-01-20 05:30,6,3,3,0,0,0
2019-01-20 05:45,8,3,5,0,0,0
2019-01-20 06:00,2,0,2,0,0,0
2019-01-20 06:15,7,4,3,0,0,0
2019-01-20 06:30,2,2,0,0,0,0
2019-01-20 06:45,1,0,1,0,0,0
2019-01-20 07:00,1,0,1,0,0,0
2019-01-20 07:15,3,2,1,0,0,0
2019-01-20 07:30,5,4,1,0,0,0
2019-01-20 07:45,27,22,5,0,0,0
2019-01-20 08:00,12,10,2,0,0,0
2019-01-20 08:15,15,9,6,0,0,0
2019-01-20 08:30,11,10,1,0,0,0
2019-01-20 08:45,18,14,4,0,0,0
2019-01-20 09:00,11,7,4,0,0,0
2019-01-20 09:15,19,15,4,0,0,0
2019-01-20 09:30,23,15,8,0,0,0
2019-01-20 09:45,33,28,5,0,0,0
2019-01-20 10:00,31,26,5,0,0,0
2019-01-20 10:15,37,31,6,0,0,0
2019-01-20 10:30,29,19,10,0,0,0
2019-01-20 10:45,44,37,7,0,0,0
2019-01-20 11:00,48,31,17,0,0,0
2019-01-20 11:15,41,27,14,0,0,0
2019-01-20 11:30,37,20,17,0,0,0
2019-01-20 11:45,31,20,11,0,0,0
2019-01-20 12:00,31,23,8,0,0,0
2019-01-20 12:15,29,22,7,0,0,0
2019-01-20 12:30,54,31,23,0,0,0
2019-01-20 12:45,55,36,19,0,0,0
2019-01-20 13:00,41,20,21,0,0,0
2019-01-20 13:15,47,35,12,0,0,0
2019-01-20 13:30,53,39,14,0,0,0
2019-01-20 13:45,63,48,15,0,0,0
2019-01-20 14:00,43,27,16,0,0,0
2019-01-20 14:15,74,52,22,0,0,0
2019-01-20 14:30,40,19,21,0,0,0
2019-01-20 14:45,78,48,30,0,0,0
2019-01-20 15:00,52,29,23,0,0,0
2019-01-20 15:15,70,40,30,0,0,0
2019-01-20 15:30,46,24,22,0,0,0
2019-01-20 15:45,72,49,23,0,0,0
2019-01-20 16:00,49,29,20,0,0,0
2019-01-20 16:15,51,29,22,0,0,0
2019-01-20 16:30,43,21,22,0,0,0
2019-01-20 16:45,65,35,30,0,0,0
2019-01-20 17:00,61,32,29,0,0,0
2019-01-20 17:15,61,34,27,0,0,0
2019-01-20 17:30,51,32,19,0,0,0
2019-01-20 17:45,66,44,22,0,0,0
2019-01-20 18:00,48,33,15,0,0,0
2019-01-20 18:15,30,18,12,0,0,0
2019-01-20 18:30,44,22,22,0,0,0
2019-01-20 18:45,33,23,10,0,0,0
2019-01-20 19:00,38,15,23,0,0,0
2019-01-20 19:15,35,16,19,0,0,0
2019-01-20 19:30,26,12,14,0,0,0
2019-01-20 19:45,38,19,19,0,0,0
2019-01-20 20:00,52,22,30,0,0,0
2019-01-20 20:15,25,10,15,0,0,0
2019-01-20 20:30,25,13,12,0,0,0
2019-01-20 20:45,17,7,10,0,0,0
2019-01-20 21:00,11,5,6,0,0,0
2019-01-20 21:15,16,10,6,0,0,0
2019-01-20 21:30,21,15,6,0,0,0
2019-01-20 21:45,18,6,12,0,0,0
2019-01-20 22:00,10,5,5,0,0,0
2019-01-20 22:15,19,10,9,0,0,0
2019-01-20 22:30,27,12,15,0,0,0
2019-01-20 22:45,14,11,3,0,0,0
2019-01-20 23:00,13,9,4,0,0,0
2019-01-20 23:15,11,1,10,0,0,0
2019-01-20 23:30,8,5,3,0,0,0
2019-01-20 23:45,10,3,7,0,0,0
2019-01-21 00:00,5,3,2,0,0,0
2019-01-21 00:15,8,3,5,0,0,0
2019-01-21 00:30,5,2,3,0,0,0
2019-01-21 00:45,2,0,2,0,0,0
2019-01-21 01:00,1,1,0,0,0,0
2019-01-21 01:15,0,0,0,0,0,0
2019-01-21 01:30,0,0,0,0,0,0
2019-01-21 01:45,2,0,2,0,0,0
2019-01-21 02:00,1,0,1,0,0,0
2019-01-21 02:15,1,1,0,0,0,0
2019-01-21 02:30,1,1,0,0,0,0
2019-01-21 02:45,0,0,0,0,0,0
2019-01-21 03:00,0,0,0,0,0,0
2019-01-21 03:15,0,0,0,0,0,0
2019-01-21 03:30,0,0,0,0,0,0
2019-01-21 03:45,0,0,0,0,0,0
2019-01-21 04:00,0,0,0,0,0,0
2019-01-21 04:15,2,0,2,0,0,0
2019-01-21 04:30,4,3,1,0,0,0
2019-01-21 04:45,1,0,1,0,0,0
2019-01-21 05:00,0,0,0,0,0,0
2019-01-21 05:15,6,3,3,0,0,0
2019-01-21 05:30,12,10,2,0,0,0
2019-01-21 05:45,15,8,7,0,0,0
2019-01-21 06:00,7,5,2,0,0,0
2019-01-21 06:15,23,16,7,0,0,0
2019-01-21 06:30,45,31,14,0,0,0
2019-01-21 06:45,47,37,10,0,0,0
2019-01-21 07:00,69,53,16,0,0,0
2019-01-21 07:15,140,116,24,0,0,0
2019-01-21 07:30,268,246,22,0,0,0
2019-01-21 07:45,179,135,44,0,0,0
2019-01-21 08:00,162,138,24,0,0,0
2019-01-21 08:15,157,133,24,0,0,0
2019-01-21 08:30,141,115,26,0,0,0
2019-01-21 08:45,131,113,18,0,0,0
2019-01-21 09:00,89,64,25,0,0,0
2019-01-21 09:15,93,75,18,0,0,0
2019-01-21 09:30,113,96,17,0,0,0
2019-01-21 09:45,126,106,20,0,0,0
2019-01-21 10:00,96,79,17,0,0,0
2019-01-21 10:15,59,47,12,0,0,0
2019-01-21 10:30,60,37,23,0,0,0
2019-01-21 10:45,69,51,18,0,0,0
2019-01-21 11:00,69,45,24,0,0,0
2019-01-21 11:15,77,46,31,0,0,0
2019-01-21 11:30,81,47,34,0,0,0
2019-01-21 11:45,102,68,34,0,0,0
2019-01-21 12:00,92,58,34,0,0,0
2019-01-21 12:15,85,50,35,0,0,0
2019-01-21 12:30,93,51,42,0,0,0
2019-01-21 12:45,104,58,46,0,0,0
2019-01-21 13:00,107,57,50,0,0,0
2019-01-21 13:15,100,49,51,0,0,0
2019-01-21 13:30,103,68,35,0,0,0
2019-01-21 13:45,97,58,39,0,0,0
2019-01-21 14:00,131,60,71,0,0,0
2019-01-21 14:15,88,37,51,0,0,0
2019-01-21 14:30,92,52,40,0,0,0
2019-01-21 14:45,124,80,44,0,0,0
2019-01-21 15:00,121,58,63,0,0,0
2019-01-21 15:15,109,76,33,0,0,0
2019-01-21 15:30,137,73,64,0,0,0
2019-01-21 15:45,167,95,72,0,0,0
2019-01-21 16:00,172,104,68,0,0,0
2019-01-21 16:15,135,65,70,0,0,0
2019-01-21 16:30,118,60,58,0,0,0
2019-01-21 16:45,114,59,55,0,0,0
2019-01-21 17:00,128,64,64,0,0,0
2019-01-21 17:15,113,50,63,0,0,0
2019-01-21 17:30,144,72,72,0,0,0
2019-01-21 17:45,170,79,91,0,0,0
2019-01-21 18:00,117,67,50,0,0,0
2019-01-21 18:15,102,55,47,0,0,0
2019-01-21 18:30,77,40,37,0,0,0
2019-01-21 18:45,106,58,48,0,0,0
2019-01-21 19:00,77,45,32,0,0,0
2019-01-21 19:15,85,47,38,0,0,0
2019-01-21 19:30,67,33,34,0,0,0
2019-01-21 19:45,92,40,52,0,0,0
2019-01-21 20:00,73,27,46,0,0,0
2019-01-21 20:15,63,29,34,0,0,0
2019-01-21 20:30,40,15,25,0,0,0
2019-01-21 20:45,40,14,26,0,0,0
2019-01-21 21:00,47,31,16,0,0,0
2019-01-21 21:15,32,11,21,0,0,0
2019-01-21 21:30,34,16,18,0,0,0
2019-01-21 21:45,39,14,25,0,0,0
2019-01-21 22:00,32,11,21,0,0,0
2019-01-21 22:15,47,22,25,0,0,0
2019-01-21 22:30,26,15,11,0,0,0
2019-01-21 22:45,40,31,9,0,0,0
2019-01-21 23:00,26,15,11,0,0,0
2019-01-21 23:15,19,10,9,0,0,0
2019-01-21 23:30,11,8,3,0,0,0
2019-01-21 23:45,4,1,3,0,0,0
2019-01-22 00:00,6,1,5,0,0,0
2019-01-22 00:15,1,0,1,0,0,0
2019-01-22 00:30,6,2,4,0,0,0
2019-01-22 00:45,3,1,2,0,0,0
2019-01-22 01:00,2,0,2,0,0,0
2019-01-22 01:15,1,0,1,0,0,0
2019-01-22 01:30,1,0,1,0,0,0
2019-01-22 01:45,3,2,1,0,0,0
2019-01-22 02:00,0,0,0,0,0,0
2019-01-22 02:15,0,0,0,0,0,0
2019-01-22 02:30,3,1,2,0,0,0
2019-01-22 02:45,1,0,1,0,0,0
2019-01-22 03:00,0,0,0,0,0,0
2019-01-22 03:15,1,0,1,0,0,0
2019-01-22 03:30,0,0,0,0,0,0
2019-01-22 03:45,0,0,0,0,0,0
2019-01-22 04:00,1,1,0,0,0,0
2019-01-22 04:15,1,0,1,0,0,0
2019-01-22 04:30,1,1,0,0,0,0
2019-01-22 04:45,3,2,1,0,0,0
2019-01-22 05:00,0,0,0,0,0,0
2019-01-22 05:15,1,1,0,0,0,0
2019-01-22 05:30,6,5,1,0,0,0
2019-01-22 05:45,10,6,4,0,0,0
2019-01-22 06:00,10,7,3,0,0,0
2019-01-22 06:15,23,19,4,0,0,0
2019-01-22 06:30,35,23,12,0,0,0
2019-01-22 06:45,55,39,16,0,0,0
2019-01-22 07:00,67,50,17,0,0,0
2019-01-22 07:15,139,121,18,0,0,0
2019-01-22 07:30,291,241,50,0,0,0
2019-01-22 07:45,244,202,42,0,0,0
2019-01-22 08:00,147,115,32,0,0,0
2019-01-22 08:15,180,134,46,0,0,0
2019-01-22 08:30,109,75,34,0,0,0
2019-01-22 08:45,156,130,26,0,0,0
2019-01-22 09:00,104,67,37,0,0,0
2019-01-22 09:15,99,78,21,0,0,0
2019-01-22 09:30,105,83,22,0,0,0
2019-01-22 09:45,130,102,28,0,0,0
2019-01-22 10:00,98,65,33,0,0,0
2019-01-22 10:15,63,45,18,0,0,0
2019-01-22 10:30,78,54,24,0,0,0
2019-01-22 10:45,69,47,22,0,0,0
2019-01-22 11:00,85,51,34,0,0,0
2019-01-22 11:15,96,59,37,0,0,0
2019-01-22 11:30,79,45,34,0,0,0
2019-01-22 11:45,114,73,41,0,0,0
2019-01-22 12:00,80,37,43,0,0,0
2019-01-22 12:15,105,57,48,0,0,0
2019-01-22 12:30,129,60,69,0,0,0
2019-01-22 12:45,102,56,46,0,0,0
2019-01-22 13:00,129,51,78,0,0,0
2019-01-22 13:15,184,55,129,0,0,0
2019-01-22 13:30,121,63,58,0,0,0
2019-01-22 13:45,110,65,45,0,0,0
2019-01-22 14:00,105,43,62,0,0,0
2019-01-22 14:15,104,54,50,0,0,0
2019-01-22 14:30,94,49,45,0,0,0
2019-01-22 14:45,112,67,45,0,0,0
2019-01-22 15:00,127,79,48,0,0,0
2019-01-22 15:15,133,91,42,0,0,0
2019-01-22 15:30,141,81,60,0,0,0
2019-01-22 15:45,155,80,75,0,0,0
2019-01-22 16:00,143,85,58,0,0,0
2019-01-22 16:15,125,71,54,0,0,0
2019-01-22 16:30,128,73,55,0,0,0
2019-01-22 16:45,181,99,82,0,0,0
2019-01-22 17:00,145,69,76,0,0,0
2019-01-22 17:15,112,50,62,0,0,0
2019-01-22 17:30,138,75,63,0,0,0
2019-01-22 17:45,129,74,55,0,0,0
2019-01-22 18:00,132,70,62,0,0,0
2019-01-22 18:15,147,66,81,0,0,0
2019-01-22 18:30,112,58,54,0,0,0
2019-01-22 18:45,89,51,38,0,0,0
2019-01-22 19:00,66,40,26,0,0,0
2019-01-22 19:15,64,33,31,0,0,0
2019-01-22 19:30,76,34,42,0,0,0
2019-01-22 19:45,90,35,55,0,0,0
2019-01-22 20:00,84,41,43,0,0,0
2019-01-22 20:15,65,25,40,0,0,0
2019-01-22 20:30,46,15,31,0,0,0
2019-01-22 20:45,30,16,14,0,0,0
2019-01-22 21:00,35,16,19,0,0,0
2019-01-22 21:15,38,17,21,0,0,0
2019-01-22 21:30,54,29,25,0,0,0
2019-01-22 21:45,31,16,15,0,0,0
2019-01-22 22:00,55,31,24,0,0,0
2019-01-22 22:15,40,19,21,0,0,0
2019-01-22 22:30,23,11,12,0,0,0
2019-01-22 22:45,25,12,13,0,0,0
2019-01-22 23:00,22,8,14,0,0,0
2019-01-22 23:15,17,10,7,0,0,0
2019-01-22 23:30,12,9,3,0,0,0
2019-01-22 23:45,7,2,5,0,0,0
2019-01-23 00:00,4,2,2,0,0,0
2019-01-23 00:15,5,2,3,0,0,0
2019-01-23 00:30,4,3,1,0,0,0
2019-01-23 00:45,0,0,0,0,0,0
2019-01-23 01:00,6,5,1,0,0,0
2019-01-23 01:15,1,0,1,0,0,0
2019-01-23 01:30,6,5,1,0,0,0
2019-01-23 01:45,2,1,1,0,0,0
2019-01-23 02:00,1,0,1,0,0,0
2019-01-23 02:15,0,0,0,0,0,0
2019-01-23 02:30,0,0,0,0,0,0
2019-01-23 02:45,2,0,2,0,0,0
2019-01-23 03:00,1,1,0,0,0,0
2019-01-23 03:15,0,0,0,0,0,0
2019-01-23 03:30,0,0,0,0,0,0
2019-01-23 03:45,0,0,0,0,0,0
2019-01-23 04:00,1,1,0,0,0,0
2019-01-23 04:15,4,1,3,0,0,0
2019-01-23 04:30,1,1,0,0,0,0
2019-01-23 04:45,3,3,0,0,0,0
2019-01-23 05:00,3,2,1,0,0,0
2019-01-23 05:15,3,1,2,0,0,0
2019-01-23 05:30,9,7,2,0,0,0
2019-01-23 05:45,13,10,3,0,0,0
2019-01-23 06:00,10,7,3,0,0,0
2019-01-23 06:15,23,16,7,0,0,0
2019-01-23 06:30,29,17,12,0,0,0
2019-01-23 06:45,57,33,24,0,0,0
2019-01-23 07:00,77,58,19,0,0,0
2019-01-23 07:15,109,82,27,0,0,0
2019-01-23 07:30,260,232,28,0,0,0
2019-01-23 07:45,221,175,46,0,0,0
2019-01-23 08:00,155,115,40,0,0,0
2019-01-23 08:15,126,84,42,0,0,0
2019-01-23 08:30,120,91,29,0,0,0
2019-01-23 08:45,152,121,31,0,0,0
2019-01-23 09:00,109,87,22,0,0,0
2019-01-23 09:15,94,61,33,0,0,0
2019-01-23 09:30,100,78,22,0,0,0
2019-01-23 09:45,128,115,13,0,0,0
2019-01-23 10:00,78,62,16,0,0,0
2019-01-23 10:15,64,45,19,0,0,0
2019-01-23 10:30,71,52,19,0,0,0
2019-01-23 10:45,66,49,17,0,0,0
2019-01-23 11:00,52,40,12,0,0,0
2019-01-23 11:15,54,37,17,0,0,0
2019-01-23 11:30,76,45,31,0,0,0
2019-01-23 11:45,114,77,37,0,0,0
2019-01-23 12:00,95,56,39,0,0,0
2019-01-23 12:15,91,52,39,0,0,0
2019-01-23 12:30,101,48,53,0,0,0
2019-01-23 12:45,101,56,45,0,0,0
2019-01-23 13:00,117,47,70,0,0,0
2019-01-23 13:15,102,56,46,0,0,0
2019-01-23 13:30,68,33,35,0,0,0
2019-01-23 13:45,139,83,56,0,0,0
2019-01-23 14:00,102,43,59,0,0,0
2019-01-23 14:15,92,33,59,0,0,0
2019-01-23 14:30,82,39,43,0,0,0
2019-01-23 14:45,117,55,62,0,0,0
2019-01-23 15:00,102,55,47,0,0,0
2019-01-23 15:15,98,51,47,0,0,0
2019-01-23 15:30,121,58,63,0,0,0
2019-01-23 15:45,121,70,51,0,0,0
2019-01-23 16:00,143,76,67,0,0,0
2019-01-23 16:15,112,67,45,0,0,0
2019-01-23 16:30,109,48,61,0,0,0
2019-01-23 16:45,118,56,62,0,0,0
2019-01-23 17:00,125,63,62,0,0,0
2019-01-23 17:15,115,58,57,0,0,0
2019-01-23 17:30,125,64,61,0,0,0
2019-01-23 17:45,129,76,53,0,0,0
2019-01-23 18:00,126,60,66,0,0,0
2019-01-23 18:15,137,65,72,0,0,0
2019-01-23 18:30,102,51,51,0,0,0
2019-01-23 18:45,110,51,59,0,0,0
2019-01-23 19:00,82,39,43,0,0,0
2019-01-23 19:15,86,42,44,0,0,0
2019-01-23 19:30,74,33,41,0,0,0
2019-01-23 19:45,111,51,60,0,0,0
2019-01-23 20:00,88,33,55,0,0,0
2019-01-23 20:15,65,35,30,0,0,0
2019-01-23 20:30,24,10,14,0,0,0
2019-01-23 20:45,43,17,26,0,0,0
2019-01-23 21:00,33,13,20,0,0,0
2019-01-23 21:15,33,13,20,0,0,0
2019-01-23 21:30,40,16,24,0,0,0
2019-01-23 21:45,31,12,19,0,0,0
2019-01-23 22:00,36,19,17,0,0,0
2019-01-23 22:15,51,20,31,0,0,0
2019-01-23 22:30,31,12,19,0,0,0
2019-01-23 22:45,26,16,10,0,0,0
2019-01-23 23:00,23,10,13,0,0,0
2019-01-23 23:15,21,12,9,0,0,0
2019-01-23 23:30,17,11,6,0,0,0
2019-01-23 23:45,17,10,7,0,0,0
2019-01-24 00:00,7,1,6,0,0,0
2019-01-24 00:15,6,2,4,0,0,0
2019-01-24 00:30,6,3,3,0,0,0
2019-01-24 00:45,7,5,2,0,0,0
2019-01-24 01:00,3,1,2,0,0,0
2019-01-24 01:15,3,0,3,0,0,0
2019-01-24 01:30,6,2,4,0,0,0
2019-01-24 01:45,2,2,0,0,0,0
2019-01-24 02:00,2,1,1,0,0,0
2019-01-24 02:15,3,0,3,0,0,0
2019-01-24 02:30,1,0,1,0,0,0
2019-01-24 02:45,1,0,1,0,0,0
2019-01-24 03:00,1,0,1,0,0,0
2019-01-24 03:15,2,0,2,0,0,0
2019-01-24 03:30,1,0,1,0,0,0
2019-01-24 03:45,4,1,3,0,0,0
2019-01-24 04:00,2,2,0,0,0,0
2019-01-24 04:15,0,0,0,0,0,0
2019-01-24 04:30,0,0,0,0,0,0
2019-01-24 04:45,1,1,0,0,0,0
2019-01-24 05:00,1,0,1,0,0,0
2019-01-24 05:15,3,1,2,0,0,0
2019-01-24 05:30,8,6,2,0,0,0
2019-01-24 05:45,12,8,4,0,0,0
2019-01-24 06:00,9,5,4,0,0,0
2019-01-24 06:15,24,16,8,0,0,0
2019-01-24 06:30,53,34,19,0,0,0
2019-01-24 06:45,61,47,14,0,0,0
2019-01-24 07:00,89,63,26,0,0,0
2019-01-24 07:15,129,97,32,0,0,0
2019-01-24 07:30,274,236,38,0,0,0
2019-01-24 07:45,208,158,50,0,0,0
2019-01-24 08:00,161,131,30,0,0,0
2019-01-24 08:15,108,73,35,0,0,0
2019-01-24 08:30,149,119,30,0,0,0
2019-01-24 08:45,151,113,38,0,0,0
2019-01-24 09:00,122,83,39,0,0,0
2019-01-24 09:15,97,64,33,0,0,0
2019-01-24 09:30,89,70,19,0,0,0
2019-01-24 09:45,120,96,24,0,0,0
2019-01-24 10:00,95,66,29,0,0,0
2019-01-24 10:15,82,61,21,0,0,0
2019-01-24 10:30,55,33,22,0,0,0
2019-01-24 10:45,58,39,19,0,0,0
2019-01-24 11:00,58,37,21,0,0,0
2019-01-24 11:15,77,43,34,0,0,0
2019-01-24 11:30,77,55,22,0,0,0
2019-01-24 11:45,98,55,43,0,0,0
2019-01-24 12:00,102,58,44,0,0,0
2019-01-24 12:15,84,44,40,0,0,0
2019-01-24 12:30,79,42,37,0,0,0
2019-01-24 12:45,107,46,61,0,0,0
2019-01-24 13:00,120,51,69,0,0,0
2019-01-24 13:15,110,52,58,0,0,0
2019-01-24 13:30,108,63,45,0,0,0
2019-01-24 13:45,98,54,44,0,0,0
2019-01-24 14:00,139,44,95,0,0,0
2019-01-24 14:15,93,40,53,0,0,0
2019-01-24 14:30,91,48,43,0,0,0
2019-01-24 14:45,130,56,74,0,0,0
2019-01-24 15:00,106,47,59,0,0,0
2019-01-24 15:15,112,56,56,0,0,0
2019-01-24 15:30,137,64,73,0,0,0
2019-01-24 15:45,157,75,82,0,0,0
2019-01-24 16:00,141,87,54,0,0,0
2019-01-24 16:15,149,57,92,0,0,0
2019-01-24 16:30,123,58,65,0,0,0
2019-01-24 16:45,132,70,62,0,0,0
2019-01-24 17:00,134,64,70,0,0,0
2019-01-24 17:15,128,51,77,0,0,0
2019-01-24 17:30,133,60,73,0,0,0
2019-01-24 17:45,136,69,67,0,0,0
2019-01-24 18:00,131,65,66,0,0,0
2019-01-24 18:15,124,62,62,0,0,0
2019-01-24 18:30,96,44,52,0,0,0
2019-01-24 18:45,101,47,54,0,0,0
2019-01-24 19:00,85,35,50,0,0,0
2019-01-24 19:15,93,46,47,0,0,0
2019-01-24 19:30,88,38,50,0,0,0
2019-01-24 19:45,79,33,46,0,0,0
2019-01-24 20:00,95,43,52,0,0,0
2019-01-24 20:15,72,28,44,0,0,0
2019-01-24 20:30,49,14,35,0,0,0
2019-01-24 20:45,35,10,25,0,0,0
2019-01-24 21:00,30,10,20,0,0,0
2019-01-24 21:15,30,10,20,0,0,0
2019-01-24 21:30,49,23,26,0,0,0
2019-01-24 21:45,41,13,28,0,0,0
2019-01-24 22:00,53,19,34,0,0,0
2019-01-24 22:15,49,21,28,0,0,0
2019-01-24 22:30,41,18,23,0,0,0
2019-01-24 22:45,16,3,13,0,0,0
2019-01-24 23:00,30,19,11,0,0,0
2019-01-24 23:15,25,8,17,0,0,0
2019-01-24 23:30,14,4,10,0,0,0
2019-01-24 23:45,13,7,6,0,0,0
2019-01-25 00:00,13,5,8,0,0,0
2019-01-25 00:15,8,5,3,0,0,0
2019-01-25 00:30,12,11,1,0,0,0
2019-01-25 00:45,4,4,0,0,0,0
2019-01-25 01:00,4,1,3,0,0,0
2019-01-25 01:15,4,0,4,0,0,0
2019-01-25 01:30,3,0,3,0,0,0
2019-01-25 01:45,7,3,4,0,0,0
2019-01-25 02:00,0,0,0,0,0,0
2019-01-25 02:15,0,0,0,0,0,0
2019-01-25 02:30,1,0,1,0,0,0
2019-01-25 02:45,1,0,1,0,0,0
2019-01-25 03:00,1,0,1,0,0,0
2019-01-25 03:15,1,1,0,0,0,0
2019-01-25 03:30,0,0,0,0,0,0
2019-01-25 03:45,2,2,0,0,0,0
2019-01-25 04:00,0,0,0,0,0,0
2019-01-25 04:15,1,0,1,0,0,0
2019-01-25 04:30,1,0,1,0,0,0
2019-01-25 04:45,0,0,0,0,0,0
2019-01-25 05:00,0,0,0,0,0,0
2019-01-25 05:15,3,2,1,0,0,0
2019-01-25 05:30,11,7,4,0,0,0
2019-01-25 05:45,8,7,1,0,0,0
2019-01-25 06:00,6,4,2,0,0,0
2019-01-25 06:15,20,11,9,0,0,0
2019-01-25 06:30,40,24,16,0,0,0
2019-01-25 06:45,57,39,18,0,0,0
2019-01-25 07:00,66,46,20,0,0,0
2019-01-25 07:15,112,88,24,0,0,0
2019-01-25 07:30,282,245,37,0,0,0
2019-01-25 07:45,194,147,47,0,0,0
2019-01-25 08:00,150,125,25,0,0,0
2019-01-25 08:15,114,84,30,0,0,0
2019-01-25 08:30,99,68,31,0,0,0
2019-01-25 08:45,163,136,27,0,0,0
2019-01-25 09:00,100,80,20,0,0,0
2019-01-25 09:15,93,75,18,0,0,0
2019-01-25 09:30,70,56,14,0,0,0
2019-01-25 09:45,138,113,25,0,0,0
2019-01-25 10:00,87,59,28,0,0,0
2019-01-25 10:15,70,48,22,0,0,0
2019-01-25 10:30,76,49,27,0,0,0
2019-01-25 10:45,66,43,23,0,0,0
2019-01-25 11:00,68,47,21,0,0,0
2019-01-25 11:15,63,36,27,0,0,0
2019-01-25 11:30,78,39,39,0,0,0
2019-01-25 11:45,88,50,38,0,0,0
2019-01-25 12:00,80,48,32,0,0,0
2019-01-25 12:15,103,53,50,0,0,0
2019-01-25 12:30,107,49,58,0,0,0
2019-01-25 12:45,134,63,71,0,0,0
2019-01-25 13:00,136,45,91,0,0,0
2019-01-25 13:15,136,54,82,0,0,0
2019-01-25 13:30,110,58,52,0,0,0
2019-01-25 13:45,116,47,69,0,0,0
2019-01-25 14:00,139,37,102,0,0,0
2019-01-25 14:15,114,58,56,0,0,0
2019-01-25 14:30,101,49,52,0,0,0
2019-01-25 14:45,131,68,63,0,0,0
2019-01-25 15:00,97,48,49,0,0,0
2019-01-25 15:15,127,59,68,0,0,0
2019-01-25 15:30,117,61,56,0,0,0
2019-01-25 15:45,79,49,30,0,0,0
2019-01-25 16:00,85,41,44,0,0,0
2019-01-25 16:15,108,60,48,0,0,0
2019-01-25 16:30,117,58,59,0,0,0
2019-01-25 16:45,87,46,41,0,0,0
2019-01-25 17:00,85,35,50,0,0,0
2019-01-25 17:15,90,45,45,0,0,0
2019-01-25 17:30,101,42,59,0,0,0
2019-01-25 17:45,77,33,44,0,0,0
2019-01-25 18:00,86,31,55,0,0,0
2019-01-25 18:15,64,34,30,0,0,0
2019-01-25 18:30,55,27,28,0,0,0
2019-01-25 18:45,58,36,22,0,0,0
2019-01-25 19:00,60,31,29,0,0,0
2019-01-25 19:15,51,24,27,0,0,0
2019-01-25 19:30,55,24,31,0,0,0
2019-01-25 19:45,72,34,38,0,0,0
2019-01-25 20:00,76,42,34,0,0,0
2019-01-25 20:15,38,18,20,0,0,0
2019-01-25 20:30,19,12,7,0,0,0
2019-01-25 20:45,22,12,10,0,0,0
2019-01-25 21:00,17,9,8,0,0,0
2019-01-25 21:15,28,13,15,0,0,0
2019-01-25 21:30,24,9,15,0,0,0
2019-01-25 21:45,17,9,8,0,0,0
2019-01-25 22:00,28,15,13,0,0,0
2019-01-25 22:15,32,14,18,0,0,0
2019-01-25 22:30,36,20,16,0,0,0
2019-01-25 22:45,22,4,18,0,0,0
2019-01-25 23:00,20,14,6,0,0,0
2019-01-25 23:15,11,7,4,0,0,0
2019-01-25 23:30,20,14,6,0,0,0
2019-01-25 23:45,27,16,11,0,0,0
2019-01-26 00:00,24,15,9,0,0,0
2019-01-26 00:15,29,18,11,0,0,0
2019-01-26 00:30,19,17,2,0,0,0
2019-01-26 00:45,14,5,9,0,0,0
2019-01-26 01:00,13,5,8,0,0,0
2019-01-26 01:15,10,4,6,0,0,0
2019-01-26 01:30,9,3,6,0,0,0
2019-01-26 01:45,6,6,0,0,0,0
2019-01-26 02:00,16,6,10,0,0,0
2019-01-26 02:15,7,4,3,0,0,0
2019-01-26 02:30,4,3,1,0,0,0
2019-01-26 02:45,8,0,8,0,0,0
2019-01-26 03:00,5,3,2,0,0,0
2019-01-26 03:15,3,1,2,0,0,0
2019-01-26 03:30,4,2,2,0,0,0
2019-01-26 03:45,4,2,2,0,0,0
2019-01-26 04:00,2,0,2,0,0,0
2019-01-26 04:15,2,0,2,0,0,0
2019-01-26 04:30,1,1,0,0,0,0
2019-01-26 04:45,5,2,3,0,0,0
2019-01-26 05:00,4,0,4,0,0,0
2019-01-26 05:15,7,5,2,0,0,0
2019-01-26 05:30,4,3,1,0,0,0
2019-01-26 05:45,4,3,1,0,0,0
2019-01-26 06:00,6,5,1,0,0,0
2019-01-26 06:15,10,7,3,0,0,0
2019-01-26 06:30,8,7,1,0,0,0
2019-01-26 06:45,9,8,1,0,0,0
2019-01-26 07:00,10,10,0,0,0,0
2019-01-26 07:15,16,10,6,0,0,0
2019-01-26 07:30,6,3,3,0,0,0
2019-01-26 07:45,24,20,4,0,0,0
2019-01-26 08:00,34,32,2,0,0,0
2019-01-26 08:15,14,13,1,0,0,0
2019-01-26 08:30,26,20,6,0,0,0
2019-01-26 08:45,32,24,8,0,0,0
2019-01-26 09:00,34,22,12,0,0,0
2019-01-26 09:15,38,30,8,0,0,0
2019-01-26 09:30,48,36,12,0,0,0
2019-01-26 09:45,67,57,10,0,0,0
2019-01-26 10:00,46,34,12,0,0,0
2019-01-26 10:15,46,35,11,0,0,0
2019-01-26 10:30,45,35,10,0,0,0
2019-01-26 10:45,90,66,24,0,0,0
2019-01-26 11:00,67,50,17,0,0,0
2019-01-26 11:15,57,32,25,0,0,0
2019-01-26 11:30,52,33,19,0,0,0
2019-01-26 11:45,86,57,29,0,0,0
2019-01-26 12:00,65,45,20,0,0,0
2019-01-26 12:15,77,58,19,0,0,0
2019-01-26 12:30,81,50,31,0,0,0
2019-01-26 12:45,101,62,39,0,0,0
2019-01-26 13:00,87,54,33,0,0,0
2019-01-26 13:15,89,57,32,0,0,0
2019-01-26 13:30,75,46,29,0,0,0
2019-01-26 13:45,91,49,42,0,0,0
2019-01-26 14:00,76,37,39,0,0,0
2019-01-26 14:15,85,46,39,0,0,0
2019-01-26 14:30,75,41,34,0,0,0
2019-01-26 14:45,87,47,40,0,0,0
2019-01-26 15:00,62,27,35,0,0,0
2019-01-26 15:15,83,54,29,0,0,0
2019-01-26 15:30,51,26,25,0,0,0
2019-01-26 15:45,84,45,39,0,0,0
2019-01-26 16:00,73,37,36,0,0,0
2019-01-26 16:15,63,34,29,0,0,0
2019-01-26 16:30,81,32,49,0,0,0
2019-01-26 16:45,72,44,28,0,0,0
2019-01-26 17:00,80,34,46,0,0,0
2019-01-26 17:15,67,32,35,0,0,0
2019-01-26 17:30,61,27,34,0,0,0
2019-01-26 17:45,57,28,29,0,0,0
2019-01-26 18:00,68,35,33,0,0,0
2019-01-26 18:15,61,38,23,0,0,0
2019-01-26 18:30,58,33,25,0,0,0
2019-01-26 18:45,69,46,23,0,0,0
2019-01-26 19:00,63,38,25,0,0,0
2019-01-26 19:15,93,51,42,0,0,0
2019-01-26 19:30,49,32,17,0,0,0
2019-01-26 19:45,73,50,23,0,0,0
2019-01-26 20:00,35,17,18,0,0,0
2019-01-26 20:15,29,14,15,0,0,0
2019-01-26 20:30,37,16,21,0,0,0
2019-01-26 20:45,40,24,16,0,0,0
2019-01-26 21:00,34,24,10,0,0,0
2019-01-26 21:15,24,14,10,0,0,0
2019-01-26 21:30,28,13,15,0,0,0
2019-01-26 21:45,29,13,16,0,0,0
2019-01-26 22:00,28,16,12,0,0,0
2019-01-26 22:15,18,9,9,0,0,0
2019-01-26 22:30,39,22,17,0,0,0
2019-01-26 22:45,24,14,10,0,0,0
2019-01-26 23:00,24,7,17,0,0,0
2019-01-26 23:15,28,15,13,0,0,0
2019-01-26 23:30,41,23,18,0,0,0
2019-01-26 23:45,21,10,11,0,0,0
2019-01-27 00:00,26,14,12,0,0,0
2019-01-27 00:15,18,12,6,0,0,0
2019-01-27 00:30,20,7,13,0,0,0
2019-01-27 00:45,8,1,7,0,0,0
2019-01-27 01:00,17,8,9,0,0,0
2019-01-27 01:15,20,8,12,0,0,0
2019-01-27 01:30,13,2,11,0,0,0
2019-01-27 01:45,14,8,6,0,0,0
2019-01-27 02:00,12,2,10,0,0,0
2019-01-27 02:15,5,2,3,0,0,0
2019-01-27 02:30,10,1,9,0,0,0
2019-01-27 02:45,10,5,5,0,0,0
2019-01-27 03:00,6,2,4,0,0,0
2019-01-27 03:15,2,0,2,0,0,0
2019-01-27 03:30,12,4,8,0,0,0
2019-01-27 03:45,5,0,5,0,0,0
2019-01-27 04:00,2,0,2,0,0,0
2019-01-27 04:15,5,0,5,0,0,0
2019-01-27 04:30,7,1,6,0,0,0
2019-01-27 04:45,3,1,2,0,0,0
2019-01-27 05:00,1,0,1,0,0,0
2019-01-27 05:15,2,2,0,0,0,0
2019-01-27 05:30,4,4,0,0,0,0
2019-01-27 05:45,3,0,3,0,0,0
2019-01-27 06:00,1,0,1,0,0,0
2019-01-27 06:15,6,2,4,0,0,0
2019-01-27 06:30,7,6,1,0,0,0
2019-01-27 06:45,3,2,1,0,0,0
2019-01-27 07:00,4,2,2,0,0,0
2019-01-27 07:15,1,1,0,0,0,0
2019-01-27 07:30,8,5,3,0,0,0
2019-01-27 07:45,26,23,3,0,0,0
2019-01-27 08:00,9,6,3,0,0,0
2019-01-27 08:15,6,6,0,0,0,0
2019-01-27 08:30,7,4,3,0,0,0
2019-01-27 08:45,19,14,5,0,0,0
2019-01-27 09:00,17,14,3,0,0,0
2019-01-27 09:15,13,11,2,0,0,0
2019-01-27 09:30,34,26,8,0,0,0
2019-01-27 09:45,38,33,5,0,0,0
2019-01-27 10:00,31,22,9,0,0,0
2019-01-27 10:15,40,35,5,0,0,0
2019-01-27 10:30,41,33,8,0,0,0
2019-01-27 10:45,37,26,11,0,0,0
2019-01-27 11:00,23,14,9,0,0,0
2019-01-27 11:15,38,27,11,0,0,0
2019-01-27 11:30,18,12,6,0,0,0
2019-01-27 11:45,26,13,13,0,0,0
2019-01-27 12:00,33,14,19,0,0,0
2019-01-27 12:15,40,23,17,0,0,0
2019-01-27 12:30,28,16,12,0,0,0
2019-01-27 12:45,44,26,18,0,0,0
2019-01-27 13:00,35,19,16,0,0,0
2019-01-27 13:15,22,12,10,0,0,0
2019-01-27 13:30,22,10,12,0,0,0
2019-01-27 13:45,35,20,15,0,0,0
2019-01-27 14:00,42,19,23,0,0,0
2019-01-27 14:15,35,23,12,0,0,0
2019-01-27 14:30,46,32,14,0,0,0
2019-01-27 14:45,55,28,27,0,0,0
2019-01-27 15:00,35,19,16,0,0,0
2019-01-27 15:15,33,18,15,0,0,0
2019-01-27 15:30,29,18,11,0,0,0
2019-01-27 15:45,33,24,9,0,0,0
2019-01-27 16:00,28,13,15,0,0,0
2019-01-27 16:15,38,17,21,0,0,0
2019-01-27 16:30,30,19,11,0,0,0
2019-01-27 16:45,52,26,26,0,0,0
2019-01-27 17:00,31,9,22,0,0,0
2019-01-27 17:15,52,24,28,0,0,0
2019-01-27 17:30,34,20,14,0,0,0
2019-01-27 17:45,44,24,20,0,0,0
2019-01-27 18:00,18,7,11,0,0,0
2019-01-27 18:15,28,19,9,0,0,0
2019-01-27 18:30,26,14,12,0,0,0
2019-01-27 18:45,35,18,17,0,0,0
2019-01-27 19:00,29,11,18,0,0,0
2019-01-27 19:15,36,23,13,0,0,0
2019-01-27 19:30,34,23,11,0,0,0
2019-01-27 19:45,30,17,13,0,0,0
2019-01-27 20:00,40,23,17,0,0,0
2019-01-27 20:15,19,8,11,0,0,0
2019-01-27 20:30,23,14,9,0,0,0
2019-01-27 20:45,18,9,9,0,0,0
2019-01-27 21:00,28,9,19,0,0,0
2019-01-27 21:15,25,15,10,0,0,0
2019-01-27 21:30,16,11,5,0,0,0
2019-01-27 21:45,16,5,11,0,0,0
2019-01-27 22:00,14,6,8,0,0,0
2019-01-27 22:15,29,24,5,0,0,0
2019-01-27 22:30,23,21,2,0,0,0
2019-01-27 22:45,9,5,4,0,0,0
2019-01-27 23:00,12,8,4,0,0,0
2019-01-27 23:15,8,6,2,0,0,0
2019-01-27 23:30,5,1,4,0,0,0
2019-01-27 23:45,5,1,4,0,0,0
2019-01-28 00:00,2,1,1,0,0,0
2019-01-28 00:15,1,0,1,0,0,0
2019-01-28 00:30,2,2,0,0,0,0
2019-01-28 00:45,3,3,0,0,0,0
2019-01-28 01:00,1,0,1,0,0,0
2019-01-28 01:15,1,0,1,0,0,0
2019-01-28 01:30,4,3,1,0,0,0
2019-01-28 01:45,1,0,1,0,0,0
2019-01-28 02:00,1,0,1,0,0,0
2019-01-28 02:15,1,0,1,0,0,0
2019-01-28 02:30,0,0,0,0,0,0
2019-01-28 02:45,0,0,0,0,0,0
2019-01-28 03:00,1,0,1,0,0,0
2019-01-28 03:15,0,0,0,0,0,0
2019-01-28 03:30,0,0,0,0,0,0
2019-01-28 03:45,2,2,0,0,0,0
2019-01-28 04:00,0,0,0,0,0,0
2019-01-28 04:15,1,0,1,0,0,0
2019-01-28 04:30,1,0,1,0,0,0
2019-01-28 04:45,0,0,0,0,0,0
2019-01-28 05:00,0,0,0,0,0,0
2019-01-28 05:15,2,2,0,0,0,0
2019-01-28 05:30,15,12,3,0,0,0
2019-01-28 05:45,15,4,11,0,0,0
2019-01-28 06:00,10,6,4,0,0,0
2019-01-28 06:15,20,14,6,0,0,0
2019-01-28 06:30,50,33,17,0,0,0
2019-01-28 06:45,60,41,19,0,0,0
2019-01-28 07:00,66,47,19,0,0,0
2019-01-28 07:15,146,111,35,0,0,0
2019-01-28 07:30,299,259,40,0,0,0
2019-01-28 07:45,202,145,57,0,0,0
2019-01-28 08:00,139,104,35,0,0,0
2019-01-28 08:15,133,97,36,0,0,0
2019-01-28 08:30,139,106,33,0,0,0
2019-01-28 08:45,124,99,25,0,0,0
2019-01-28 09:00,95,71,24,0,0,0
2019-01-28 09:15,94,69,25,0,0,0
2019-01-28 09:30,98,74,24,0,0,0
2019-01-28 09:45,95,78,17,0,0,0
2019-01-28 10:00,69,53,16,0,0,0
2019-01-28 10:15,58,41,17,0,0,0
2019-01-28 10:30,70,51,19,0,0,0
2019-01-28 10:45,55,33,22,0,0,0
2019-01-28 11:00,49,27,22,0,0,0
2019-01-28 11:15,68,43,25,0,0,0
2019-01-28 11:30,68,49,19,0,0,0
2019-01-28 11:45,70,40,30,0,0,0
2019-01-28 12:00,80,49,31,0,0,0
2019-01-28 12:15,87,53,34,0,0,0
2019-01-28 12:30,88,48,40,0,0,0
2019-01-28 12:45,87,49,38,0,0,0
2019-01-28 13:00,73,35,38,0,0,0
2019-01-28 13:15,79,38,41,0,0,0
2019-01-28 13:30,73,38,35,0,0,0
2019-01-28 13:45,96,58,38,0,0,0
2019-01-28 14:00,121,53,68,0,0,0
2019-01-28 14:15,79,42,37,0,0,0
2019-01-28 14:30,91,49,42,0,0,0
2019-01-28 14:45,87,48,39,0,0,0
2019-01-28 15:00,91,58,33,0,0,0
2019-01-28 15:15,88,39,49,0,0,0
2019-01-28 15:30,118,66,52,0,0,0
2019-01-28 15:45,131,65,66,0,0,0
2019-01-28 16:00,125,54,71,0,0,0
2019-01-28 16:15,123,66,57,0,0,0
2019-01-28 16:30,99,58,41,0,0,0
2019-01-28 16:45,127,73,54,0,0,0
2019-01-28 17:00,108,48,60,0,0,0
2019-01-28 17:15,104,43,61,0,0,0
2019-01-28 17:30,94,44,50,0,0,0
2019-01-28 17:45,128,67,61,0,0,0
2019-01-28 18:00,126,56,70,0,0,0
2019-01-28 18:15,103,49,54,0,0,0
2019-01-28 18:30,106,50,56,0,0,0
2019-01-28 18:45,76,40,36,0,0,0
2019-01-28 19:00,72,34,38,0,0,0
2019-01-28 19:15,84,49,35,0,0,0
2019-01-28 19:30,62,29,33,0,0,0
2019-01-28 19:45,73,37,36,0,0,0
2019-01-28 20:00,53,18,35,0,0,0
2019-01-28 20:15,52,17,35,0,0,0
2019-01-28 20:30,23,10,13,0,0,0
2019-01-28 20:45,37,16,21,0,0,0
2019-01-28 21:00,31,11,20,0,0,0
2019-01-28 21:15,22,10,12,0,0,0
2019-01-28 21:30,38,16,22,0,0,0
2019-01-28 21:45,26,15,11,0,0,0
2019-01-28 22:00,32,5,27,0,0,0
2019-01-28 22:15,42,26,16,0,0,0
2019-01-28 22:30,35,29,6,0,0,0
2019-01-28 22:45,20,6,14,0,0,0
2019-01-28 23:00,22,6,16,0,0,0
2019-01-28 23:15,19,14,5,0,0,0
2019-01-28 23:30,9,6,3,0,0,0
2019-01-28 23:45,11,6,5,0,0,0
2019-01-29 00:00,6,3,3,0,0,0
2019-01-29 00:15,2,1,1,0,0,0
2019-01-29 00:30,2,2,0,0,0,0
2019-01-29 00:45,4,1,3,0,0,0
2019-01-29 01:00,2,1,1,0,0,0
2019-01-29 01:15,0,0,0,0,0,0
2019-01-29 01:30,1,1,0,0,0,0
2019-01-29 01:45,4,3,1,0,0,0
2019-01-29 02:00,1,0,1,0,0,0
2019-01-29 02:15,0,0,0,0,0,0
2019-01-29 02:30,0,0,0,0,0,0
2019-01-29 02:45,0,0,0,0,0,0
2019-01-29 03:00,0,0,0,0,0,0
2019-01-29 03:15,0,0,0,0,0,0
2019-01-29 03:30,2,0,2,0,0,0
2019-01-29 03:45,5,4,1,0,0,0
2019-01-29 04:00,0,0,0,0,0,0
2019-01-29 04:15,0,0,0,0,0,0
2019-01-29 04:30,2,1,1,0,0,0
2019-01-29 04:45,2,1,1,0,0,0
2019-01-29 05:00,1,0,1,0,0,0
2019-01-29 05:15,1,1,0,0,0,0
2019-01-29 05:30,10,6,4,0,0,0
2019-01-29 05:45,12,8,4,0,0,0
2019-01-29 06:00,16,13,3,0,0,0
2019-01-29 06:15,18,12,6,0,0,0
2019-01-29 06:30,55,37,18,0,0,0
2019-01-29 06:45,60,45,15,0,0,0
2019-01-29 07:00,79,58,21,0,0,0
2019-01-29 07:15,136,111,25,0,0,0
2019-01-29 07:30,285,258,27,0,0,0
2019-01-29 07:45,221,173,48,0,0,0
2019-01-29 08:00,148,119,29,0,0,0
2019-01-29 08:15,150,104,46,0,0,0
2019-01-29 08:30,128,97,31,0,0,0
2019-01-29 08:45,178,145,33,0,0,0
2019-01-29 09:00,94,73,21,0,0,0
2019-01-29 09:15,99,78,21,0,0,0
2019-01-29 09:30,102,82,20,0,0,0
2019-01-29 09:45,123,93,30,0,0,0
2019-01-29 10:00,81,65,16,0,0,0
2019-01-29 10:15,68,43,25,0,0,0
2019-01-29 10:30,90,71,19,0,0,0
2019-01-29 10:45,80,60,20,0,0,0
2019-01-29 11:00,70,53,17,0,0,0
2019-01-29 11:15,79,52,27,0,0,0
2019-01-29 11:30,81,53,28,0,0,0
2019-01-29 11:45,117,79,38,0,0,0
2019-01-29 12:00,98,50,48,0,0,0
2019-01-29 12:15,103,65,38,0,0,0
2019-01-29 12:30,99,46,53,0,0,0
2019-01-29 12:45,87,51,36,0,0,0
2019-01-29 13:00,128,65,63,0,0,0
2019-01-29 13:15,149,64,85,0,0,0
2019-01-29 13:30,98,54,44,0,0,0
2019-01-29 13:45,129,72,57,0,0,0
2019-01-29 14:00,130,56,74,0,0,0
2019-01-29 14:15,97,49,48,0,0,0
2019-01-29 14:30,94,53,41,0,0,0
2019-01-29 14:45,129,77,52,0,0,0
2019-01-29 15:00,118,55,63,0,0,0
2019-01-29 15:15,138,77,61,0,0,0
2019-01-29 15:30,165,87,78,0,0,0
2019-01-29 15:45,156,95,61,0,0,0
2019-01-29 16:00,146,74,72,0,0,0
2019-01-29 16:15,132,62,70,0,0,0
2019-01-29 16:30,140,74,66,0,0,0
2019-01-29 16:45,167,88,79,0,0,0
2019-01-29 17:00,142,69,73,0,0,0
2019-01-29 17:15,174,90,84,0,0,0
2019-01-29 17:30,162,83,79,0,0,0
2019-01-29 17:45,162,85,77,0,0,0
2019-01-29 18:00,132,71,61,0,0,0
2019-01-29 18:15,139,71,68,0,0,0
2019-01-29 18:30,138,63,75,0,0,0
2019-01-29 18:45,104,57,47,0,0,0
2019-01-29 19:00,89,41,48,0,0,0
2019-01-29 19:15,96,46,50,0,0,0
2019-01-29 19:30,72,36,36,0,0,0
2019-01-29 19:45,103,59,44,0,0,0
2019-01-29 20:00,80,36,44,0,0,0
2019-01-29 20:15,56,23,33,0,0,0
2019-01-29 20:30,52,19,33,0,0,0
2019-01-29 20:45,53,27,26,0,0,0
2019-01-29 21:00,40,22,18,0,0,0
2019-01-29 21:15,46,27,19,0,0,0
2019-01-29 21:30,47,22,25,0,0,0
2019-01-29 21:45,50,25,25,0,0,0
2019-01-29 22:00,55,20,35,0,0,0
2019-01-29 22:15,35,13,22,0,0,0
2019-01-29 22:30,38,26,12,0,0,0
2019-01-29 22:45,26,12,14,0,0,0
2019-01-29 23:00,21,14,7,0,0,0
2019-01-29 23:15,19,7,12,0,0,0
2019-01-29 23:30,8,4,4,0,0,0
2019-01-29 23:45,19,10,9,0,0,0
2019-01-30 00:00,7,3,4,0,0,0
2019-01-30 00:15,1,1,0,0,0,0
2019-01-30 00:30,2,1,1,0,0,0
2019-01-30 00:45,1,1,0,0,0,0
2019-01-30 01:00,6,3,3,0,0,0
2019-01-30 01:15,5,0,5,0,0,0
2019-01-30 01:30,4,2,2,0,0,0
2019-01-30 01:45,2,1,1,0,0,0
2019-01-30 02:00,1,0,1,0,0,0
2019-01-30 02:15,1,0,1,0,0,0
2019-01-30 02:30,1,0,1,0,0,0
2019-01-30 02:45,1,0,1,0,0,0
2019-01-30 03:00,0,0,0,0,0,0
2019-01-30 03:15,1,0,1,0,0,0
2019-01-30 03:30,0,0,0,0,0,0
2019-01-30 03:45,2,1,1,0,0,0
2019-01-30 04:00,0,0,0,0,0,0
2019-01-30 04:15,0,0,0,0,0,0
2019-01-30 04:30,1,0,1,0,0,0
2019-01-30 04:45,0,0,0,0,0,0
2019-01-30 05:00,0,0,0,0,0,0
2019-01-30 05:15,1,1,0,0,0,0
2019-01-30 05:30,9,8,1,0,0,0
2019-01-30 05:45,18,12,6,0,0,0
2019-01-30 06:00,21,16,5,0,0,0
2019-01-30 06:15,26,16,10,0,0,0
2019-01-30 06:30,46,30,16,0,0,0
2019-01-30 06:45,69,49,20,0,0,0
2019-01-30 07:00,79,56,23,0,0,0
2019-01-30 07:15,135,114,21,0,0,0
2019-01-30 07:30,285,255,30,0,0,0
2019-01-30 07:45,220,176,44,0,0,0
2019-01-30 08:00,143,109,34,0,0,0
2019-01-30 08:15,155,124,31,0,0,0
2019-01-30 08:30,156,119,37,0,0,0
2019-01-30 08:45,177,138,39,0,0,0
2019-01-30 09:00,119,95,24,0,0,0
2019-01-30 09:15,124,104,20,0,0,0
2019-01-30 09:30,144,122,22,0,0,0
2019-01-30 09:45,130,106,24,0,0,0
2019-01-30 10:00,109,92,17,0,0,0
2019-01-30 10:15,82,54,28,0,0,0
2019-01-30 10:30,90,62,28,0,0,0
2019-01-30 10:45,101,76,25,0,0,0
2019-01-30 11:00,85,51,34,0,0,0
2019-01-30 11:15,125,77,48,0,0,0
2019-01-30 11:30,105,71,34,0,0,0
2019-01-30 11:45,138,91,47,0,0,0
2019-01-30 12:00,92,45,47,0,0,0
2019-01-30 12:15,121,71,50,0,0,0
2019-01-30 12:30,106,39,67,0,0,0
2019-01-30 12:45,105,49,56,0,0,0
2019-01-30 13:00,101,43,58,0,0,0
2019-01-30 13:15,111,53,58,0,0,0
2019-01-30 13:30,86,46,40,0,0,0
2019-01-30 13:45,102,49,53,0,0,0
2019-01-30 14:00,106,38,68,0,0,0
2019-01-30 14:15,77,32,45,0,0,0
2019-01-30 14:30,88,45,43,0,0,0
2019-01-30 14:45,113,57,56,0,0,0
2019-01-30 15:00,104,66,38,0,0,0
2019-01-30 15:15,121,59,62,0,0,0
2019-01-30 15:30,119,39,80,0,0,0
2019-01-30 15:45,136,70,66,0,0,0
2019-01-30 16:00,126,74,52,0,0,0
2019-01-30 16:15,116,53,63,0,0,0
2019-01-30 16:30,105,49,56,0,0,0
2019-01-30 16:45,121,63,58,0,0,0
2019-01-30 17:00,141,63,78,0,0,0
2019-01-30 17:15,123,50,73,0,0,0
2019-01-30 17:30,144,65,79,0,0,0
2019-01-30 17:45,137,80,57,0,0,0
2019-01-30 18:00,121,51,70,0,0,0
2019-01-30 18:15,112,48,64,0,0,0
2019-01-30 18:30,88,40,48,0,0,0
2019-01-30 18:45,90,47,43,0,0,0
2019-01-30 19:00,56,26,30,0,0,0
2019-01-30 19:15,82,44,38,0,0,0
2019-01-30 19:30,82,50,32,0,0,0
2019-01-30 19:45,56,40,16,0,0,0
2019-01-30 20:00,37,19,18,0,0,0
2019-01-30 20:15,31,21,10,0,0,0
2019-01-30 20:30,15,9,6,0,0,0
2019-01-30 20:45,34,21,13,0,0,0
2019-01-30 21:00,24,9,15,0,0,0
2019-01-30 21:15,20,12,8,0,0,0
2019-01-30 21:30,34,19,15,0,0,0
2019-01-30 21:45,33,16,17,0,0,0
2019-01-30 22:00,21,5,16,0,0,0
2019-01-30 22:15,27,12,15,0,0,0
2019-01-30 22:30,40,12,28,0,0,0
2019-01-30 22:45,27,6,21,0,0,0
2019-01-30 23:00,27,10,17,0,0,0
2019-01-30 23:15,13,10,3,0,0,0
2019-01-30 23:30,15,10,5,0,0,0
2019-01-30 23:45,19,12,7,0,0,0
2019-01-31 00:00,13,6,7,0,0,0
2019-01-31 00:15,7,5,2,0,0,0
2019-01-31 00:30,5,0,5,0,0,0
2019-01-31 00:45,1,0,1,0,0,0
2019-01-31 01:00,8,5,3,0,0,0
2019-01-31 01:15,5,1,4,0,0,0
2019-01-31 01:30,3,1,2,0,0,0
2019-01-31 01:45,5,2,3,0,0,0
2019-01-31 02:00,2,0,2,0,0,0
2019-01-31 02:15,0,0,0,0,0,0
2019-01-31 02:30,5,1,4,0,0,0
2019-01-31 02:45,3,3,0,0,0,0
2019-01-31 03:00,2,0,2,0,0,0
2019-01-31 03:15,2,0,2,0,0,0
2019-01-31 03:30,0,0,0,0,0,0
2019-01-31 03:45,1,0,1,0,0,0
2019-01-31 04:00,3,3,0,0,0,0
2019-01-31 04:15,2,1,1,0,0,0
2019-01-31 04:30,0,0,0,0,0,0
2019-01-31 04:45,0,0,0,0,0,0
2019-01-31 05:00,0,0,0,0,0,0
2019-01-31 05:15,6,3,3,0,0,0
2019-01-31 05:30,14,8,6,0,0,0
2019-01-31 05:45,13,8,5,0,0,0
2019-01-31 06:00,19,14,5,0,0,0
2019-01-31 06:15,23,16,7,0,0,0
2019-01-31 06:30,51,28,23,0,0,0
2019-01-31 06:45,57,41,16,0,0,0
2019-01-31 07:00,77,61,16,0,0,0
2019-01-31 07:15,112,91,21,0,0,0
2019-01-31 07:30,260,222,38,0,0,0
2019-01-31 07:45,162,114,48,0,0,0
2019-01-31 08:00,148,120,28,0,0,0
2019-01-31 08:15,122,82,40,0,0,0
2019-01-31 08:30,104,79,25,0,0,0
2019-01-31 08:45,147,117,30,0,0,0
2019-01-31 09:00,79,59,20,0,0,0
2019-01-31 09:15,89,68,21,0,0,0
2019-01-31 09:30,89,74,15,0,0,0
2019-01-31 09:45,115,92,23,0,0,0
2019-01-31 10:00,65,46,19,0,0,0
2019-01-31 10:15,56,41,15,0,0,0
2019-01-31 10:30,68,49,19,0,0,0
2019-01-31 10:45,91,65,26,0,0,0
2019-01-31 11:00,63,39,24,0,0,0
2019-01-31 11:15,73,43,30,0,0,0
2019-01-31 11:30,74,43,31,0,0,0
2019-01-31 11:45,59,42,17,0,0,0
2019-01-31 12:00,81,40,41,0,0,0
2019-01-31 12:15,85,50,35,0,0,0
2019-01-31 12:30,60,26,34,0,0,0
2019-01-31 12:45,97,48,49,0,0,0
2019-01-31 13:00,62,31,31,0,0,0
2019-01-31 13:15,80,35,45,0,0,0
2019-01-31 13:30,64,48,16,0,0,0
2019-01-31 13:45,103,50,53,0,0,0
2019-01-31 14:00,108,34,74,0,0,0
2019-01-31 14:15,87,45,42,0,0,0
2019-01-31 14:30,94,49,45,0,0,0
2019-01-31 14:45,97,47,50,0,0,0
2019-01-31 15:00,93,50,43,0,0,0
2019-01-31 15:15,119,72,47,0,0,0
2019-01-31 15:30,103,47,56,0,0,0
2019-01-31 15:45,156,70,86,0,0,0
2019-01-31 16:00,133,71,62,0,0,0
2019-01-31 16:15,118,47,71,0,0,0
2019-01-31 16:30,117,64,53,0,0,0
2019-01-31 16:45,140,69,71,0,0,0
2019-01-31 17:00,119,60,59,0,0,0
2019-01-31 17:15,125,51,74,0,0,0
2019-01-31 17:30,111,46,65,0,0,0
2019-01-31 17:45,132,71,61,0,0,0
2019-01-31 18:00,122,55,67,0,0,0
2019-01-31 18:15,122,68,54,0,0,0
2019-01-31 18:30,97,48,49,0,0,0
2019-01-31 18:45,97,47,50,0,0,0
2019-01-31 19:00,85,34,51,0,0,0
2019-01-31 19:15,83,49,34,0,0,0
2019-01-31 19:30,71,35,36,0,0,0
2019-01-31 19:45,95,50,45,0,0,0
2019-01-31 20:00,83,35,48,0,0,0
2019-01-31 20:15,46,19,27,0,0,0
2019-01-31 20:30,31,16,15,0,0,0
2019-01-31 20:45,34,19,15,0,0,0
2019-01-31 21:00,38,17,21,0,0,0
2019-01-31 21:15,34,14,20,0,0,0
2019-01-31 21:30,37,14,23,0,0,0
2019-01-31 21:45,23,10,13,0,0,0
2019-01-31 22:00,36,22,14,0,0,0
2019-01-31 22:15,37,10,27,0,0,0
2019-01-31 22:30,37,17,20,0,0,0
2019-01-31 22:45,24,12,12,0,0,0
2019-01-31 23:00,25,10,15,0,0,0
2019-01-31 23:15,32,19,13,0,0,0
2019-01-31 23:30,20,8,12,0,0,0
2019-01-31 23:45,10,7,3,0,0,0
