Datetime,100034983 (Warendorfer Straße),101034983 (Warendorfer Straße stadteinwärts),102034983 (Warendorfer Straße stadtauswärts),100034983-status,101034983-status,102034983-status
2022-06-01 00:00,7,5,2,0,0,0
2022-06-01 00:15,15,5,10,0,0,0
2022-06-01 00:30,8,2,6,0,0,0
2022-06-01 00:45,4,0,4,0,0,0
2022-06-01 01:00,2,1,1,0,0,0
2022-06-01 01:15,5,1,4,0,0,0
2022-06-01 01:30,2,0,2,0,0,0
2022-06-01 01:45,3,2,1,0,0,0
2022-06-01 02:00,1,1,0,0,0,0
2022-06-01 02:15,4,0,4,0,0,0
2022-06-01 02:30,4,1,3,0,0,0
2022-06-01 02:45,0,0,0,0,0,0
2022-06-01 03:00,2,1,1,0,0,0
2022-06-01 03:15,0,0,0,0,0,0
2022-06-01 03:30,0,0,0,0,0,0
2022-06-01 03:45,0,0,0,0,0,0
2022-06-01 04:00,0,0,0,0,0,0
2022-06-01 04:15,4,2,2,0,0,0
2022-06-01 04:30,0,0,0,0,0,0
2022-06-01 04:45,4,2,2,0,0,0
2022-06-01 05:00,1,1,0,0,0,0
2022-06-01 05:15,3,3,0,0,0,0
2022-06-01 05:30,12,10,2,0,0,0
2022-06-01 05:45,24,16,8,0,0,0
2022-06-01 06:00,19,11,8,0,0,0
2022-06-01 06:15,37,28,9,0,0,0
2022-06-01 06:30,51,29,22,0,0,0
2022-06-01 06:45,78,48,30,0,0,0
2022-06-01 07:00,87,64,23,0,0,0
2022-06-01 07:15,169,129,40,0,0,0
2022-06-01 07:30,310,257,53,0,0,0
2022-06-01 07:45,223,154,69,0,0,0
2022-06-01 08:00,205,158,47,0,0,0
2022-06-01 08:15,188,129,59,0,0,0
2022-06-01 08:30,164,115,49,0,0,0
2022-06-01 08:45,246,182,64,0,0,0
2022-06-01 09:00,127,89,38,0,0,0
2022-06-01 09:15,127,97,30,0,0,0
2022-06-01 09:30,190,142,48,0,0,0
2022-06-01 09:45,205,162,43,0,0,0
2022-06-01 10:00,130,91,39,0,0,0
2022-06-01 10:15,133,97,36,0,0,0
2022-06-01 10:30,145,107,38,0,0,0
2022-06-01 10:45,154,103,51,0,0,0
2022-06-01 11:00,136,87,49,0,0,0
2022-06-01 11:15,134,87,47,0,0,0
2022-06-01 11:30,157,97,60,0,0,0
2022-06-01 11:45,164,93,71,0,0,0
2022-06-01 12:00,158,89,69,0,0,0
2022-06-01 12:15,175,109,66,0,0,0
2022-06-01 12:30,167,94,73,0,0,0
2022-06-01 12:45,166,95,71,0,0,0
2022-06-01 13:00,128,76,52,0,0,0
2022-06-01 13:15,200,108,92,0,0,0
2022-06-01 13:30,134,76,58,0,0,0
2022-06-01 13:45,143,71,72,0,0,0
2022-06-01 14:00,143,88,55,0,0,0
2022-06-01 14:15,122,75,47,0,0,0
2022-06-01 14:30,118,65,53,0,0,0
2022-06-01 14:45,149,84,65,0,0,0
2022-06-01 15:00,136,65,71,0,0,0
2022-06-01 15:15,68,40,28,0,0,0
2022-06-01 15:30,110,60,50,0,0,0
2022-06-01 15:45,157,93,64,0,0,0
2022-06-01 16:00,172,102,70,0,0,0
2022-06-01 16:15,143,71,72,0,0,0
2022-06-01 16:30,156,88,68,0,0,0
2022-06-01 16:45,150,87,63,0,0,0
2022-06-01 17:00,162,84,78,0,0,0
2022-06-01 17:15,149,75,74,0,0,0
2022-06-01 17:30,146,73,73,0,0,0
2022-06-01 17:45,158,90,68,0,0,0
2022-06-01 18:00,142,73,69,0,0,0
2022-06-01 18:15,146,65,81,0,0,0
2022-06-01 18:30,82,40,42,0,0,0
2022-06-01 18:45,101,50,51,0,0,0
2022-06-01 19:00,85,46,39,0,0,0
2022-06-01 19:15,106,51,55,0,0,0
2022-06-01 19:30,82,43,39,0,0,0
2022-06-01 19:45,91,54,37,0,0,0
2022-06-01 20:00,97,49,48,0,0,0
2022-06-01 20:15,64,31,33,0,0,0
2022-06-01 20:30,59,36,23,0,0,0
2022-06-01 20:45,46,27,19,0,0,0
2022-06-01 21:00,51,15,36,0,0,0
2022-06-01 21:15,54,28,26,0,0,0
2022-06-01 21:30,48,14,34,0,0,0
2022-06-01 21:45,49,16,33,0,0,0
2022-06-01 22:00,48,21,27,0,0,0
2022-06-01 22:15,47,23,24,0,0,0
2022-06-01 22:30,51,28,23,0,0,0
2022-06-01 22:45,37,8,29,0,0,0
2022-06-01 23:00,27,9,18,0,0,0
2022-06-01 23:15,30,8,22,0,0,0
2022-06-01 23:30,40,20,20,0,0,0
2022-06-01 23:45,31,22,9,0,0,0
2022-06-02 00:00,26,10,16,0,0,0
2022-06-02 00:15,10,5,5,0,0,0
2022-06-02 00:30,20,9,11,0,0,0
2022-06-02 00:45,8,3,5,0,0,0
2022-06-02 01:00,15,13,2,0,0,0
2022-06-02 01:15,29,19,10,0,0,0
2022-06-02 01:30,6,4,2,0,0,0
2022-06-02 01:45,6,2,4,0,0,0
2022-06-02 02:00,4,0,4,0,0,0
2022-06-02 02:15,2,0,2,0,0,0
2022-06-02 02:30,4,2,2,0,0,0
2022-06-02 02:45,5,2,3,0,0,0
2022-06-02 03:00,1,0,1,0,0,0
2022-06-02 03:15,7,3,4,0,0,0
2022-06-02 03:30,3,0,3,0,0,0
2022-06-02 03:45,3,1,2,0,0,0
2022-06-02 04:00,4,1,3,0,0,0
2022-06-02 04:15,6,4,2,0,0,0
2022-06-02 04:30,5,3,2,0,0,0
2022-06-02 04:45,4,2,2,0,0,0
2022-06-02 05:00,2,2,0,0,0,0
2022-06-02 05:15,7,5,2,0,0,0
2022-06-02 05:30,14,13,1,0,0,0
2022-06-02 05:45,27,14,13,0,0,0
2022-06-02 06:00,23,15,8,0,0,0
2022-06-02 06:15,28,17,11,0,0,0
2022-06-02 06:30,52,34,18,0,0,0
2022-06-02 06:45,67,49,18,0,0,0
2022-06-02 07:00,84,56,28,0,0,0
2022-06-02 07:15,161,114,47,0,0,0
2022-06-02 07:30,335,278,57,0,0,0
2022-06-02 07:45,229,173,56,0,0,0
2022-06-02 08:00,173,131,42,0,0,0
2022-06-02 08:15,166,122,44,0,0,0
2022-06-02 08:30,169,128,41,0,0,0
2022-06-02 08:45,170,116,54,0,0,0
2022-06-02 09:00,110,77,33,0,0,0
2022-06-02 09:15,96,65,31,0,0,0
2022-06-02 09:30,119,88,31,0,0,0
2022-06-02 09:45,174,138,36,0,0,0
2022-06-02 10:00,113,77,36,0,0,0
2022-06-02 10:15,122,88,34,0,0,0
2022-06-02 10:30,107,75,32,0,0,0
2022-06-02 10:45,116,68,48,0,0,0
2022-06-02 11:00,111,69,42,0,0,0
2022-06-02 11:15,107,64,43,0,0,0
2022-06-02 11:30,116,73,43,0,0,0
2022-06-02 11:45,160,111,49,0,0,0
2022-06-02 12:00,140,79,61,0,0,0
2022-06-02 12:15,140,85,55,0,0,0
2022-06-02 12:30,121,52,69,0,0,0
2022-06-02 12:45,116,69,47,0,0,0
2022-06-02 13:00,142,79,63,0,0,0
2022-06-02 13:15,137,71,66,0,0,0
2022-06-02 13:30,145,98,47,0,0,0
2022-06-02 13:45,154,98,56,0,0,0
2022-06-02 14:00,142,81,61,0,0,0
2022-06-02 14:15,151,78,73,0,0,0
2022-06-02 14:30,134,81,53,0,0,0
2022-06-02 14:45,163,84,79,0,0,0
2022-06-02 15:00,179,111,68,0,0,0
2022-06-02 15:15,155,104,51,0,0,0
2022-06-02 15:30,178,100,78,0,0,0
2022-06-02 15:45,211,117,94,0,0,0
2022-06-02 16:00,193,116,77,0,0,0
2022-06-02 16:15,172,97,75,0,0,0
2022-06-02 16:30,196,126,70,0,0,0
2022-06-02 16:45,199,116,83,0,0,0
2022-06-02 17:00,175,105,70,0,0,0
2022-06-02 17:15,181,98,83,0,0,0
2022-06-02 17:30,165,87,78,0,0,0
2022-06-02 17:45,188,92,96,0,0,0
2022-06-02 18:00,191,88,103,0,0,0
2022-06-02 18:15,177,98,79,0,0,0
2022-06-02 18:30,137,74,63,0,0,0
2022-06-02 18:45,160,97,63,0,0,0
2022-06-02 19:00,127,65,62,0,0,0
2022-06-02 19:15,123,67,56,0,0,0
2022-06-02 19:30,103,62,41,0,0,0
2022-06-02 19:45,114,58,56,0,0,0
2022-06-02 20:00,91,50,41,0,0,0
2022-06-02 20:15,54,21,33,0,0,0
2022-06-02 20:30,56,29,27,0,0,0
2022-06-02 20:45,52,25,27,0,0,0
2022-06-02 21:00,70,32,38,0,0,0
2022-06-02 21:15,87,48,39,0,0,0
2022-06-02 21:30,57,24,33,0,0,0
2022-06-02 21:45,58,33,25,0,0,0
2022-06-02 22:00,65,29,36,0,0,0
2022-06-02 22:15,61,22,39,0,0,0
2022-06-02 22:30,44,18,26,0,0,0
2022-06-02 22:45,35,14,21,0,0,0
2022-06-02 23:00,28,11,17,0,0,0
2022-06-02 23:15,30,13,17,0,0,0
2022-06-02 23:30,21,7,14,0,0,0
2022-06-02 23:45,25,9,16,0,0,0
2022-06-03 00:00,13,5,8,0,0,0
2022-06-03 00:15,11,5,6,0,0,0
2022-06-03 00:30,14,8,6,0,0,0
2022-06-03 00:45,7,1,6,0,0,0
2022-06-03 01:00,11,4,7,0,0,0
2022-06-03 01:15,7,1,6,0,0,0
2022-06-03 01:30,6,2,4,0,0,0
2022-06-03 01:45,5,1,4,0,0,0
2022-06-03 02:00,3,1,2,0,0,0
2022-06-03 02:15,2,1,1,0,0,0
2022-06-03 02:30,9,3,6,0,0,0
2022-06-03 02:45,4,0,4,0,0,0
2022-06-03 03:00,0,0,0,0,0,0
2022-06-03 03:15,1,0,1,0,0,0
2022-06-03 03:30,4,0,4,0,0,0
2022-06-03 03:45,3,1,2,0,0,0
2022-06-03 04:00,2,1,1,0,0,0
2022-06-03 04:15,4,1,3,0,0,0
2022-06-03 04:30,3,2,1,0,0,0
2022-06-03 04:45,1,0,1,0,0,0
2022-06-03 05:00,2,2,0,0,0,0
2022-06-03 05:15,3,3,0,0,0,0
2022-06-03 05:30,16,14,2,0,0,0
2022-06-03 05:45,20,11,9,0,0,0
2022-06-03 06:00,24,18,6,0,0,0
2022-06-03 06:15,32,20,12,0,0,0
2022-06-03 06:30,42,26,16,0,0,0
2022-06-03 06:45,59,40,19,0,0,0
2022-06-03 07:00,85,57,28,0,0,0
2022-06-03 07:15,162,122,40,0,0,0
2022-06-03 07:30,314,256,58,0,0,0
2022-06-03 07:45,180,127,53,0,0,0
2022-06-03 08:00,146,108,38,0,0,0
2022-06-03 08:15,136,107,29,0,0,0
2022-06-03 08:30,142,109,33,0,0,0
2022-06-03 08:45,156,111,45,0,0,0
2022-06-03 09:00,114,78,36,0,0,0
2022-06-03 09:15,133,81,52,0,0,0
2022-06-03 09:30,137,103,34,0,0,0
2022-06-03 09:45,153,119,34,0,0,0
2022-06-03 10:00,120,84,36,0,0,0
2022-06-03 10:15,118,84,34,0,0,0
2022-06-03 10:30,123,81,42,0,0,0
2022-06-03 10:45,115,67,48,0,0,0
2022-06-03 11:00,123,78,45,0,0,0
2022-06-03 11:15,124,73,51,0,0,0
2022-06-03 11:30,116,67,49,0,0,0
2022-06-03 11:45,138,82,56,0,0,0
2022-06-03 12:00,146,92,54,0,0,0
2022-06-03 12:15,124,70,54,0,0,0
2022-06-03 12:30,113,69,44,0,0,0
2022-06-03 12:45,132,73,59,0,0,0
2022-06-03 13:00,175,91,84,0,0,0
2022-06-03 13:15,130,54,76,0,0,0
2022-06-03 13:30,139,74,65,0,0,0
2022-06-03 13:45,162,91,71,0,0,0
2022-06-03 14:00,161,83,78,0,0,0
2022-06-03 14:15,142,87,55,0,0,0
2022-06-03 14:30,136,72,64,0,0,0
2022-06-03 14:45,154,76,78,0,0,0
2022-06-03 15:00,162,108,54,0,0,0
2022-06-03 15:15,155,89,66,0,0,0
2022-06-03 15:30,153,86,67,0,0,0
2022-06-03 15:45,177,107,70,0,0,0
2022-06-03 16:00,130,79,51,0,0,0
2022-06-03 16:15,138,86,52,0,0,0
2022-06-03 16:30,138,78,60,0,0,0
2022-06-03 16:45,155,88,67,0,0,0
2022-06-03 17:00,133,77,56,0,0,0
2022-06-03 17:15,119,66,53,0,0,0
2022-06-03 17:30,153,89,64,0,0,0
2022-06-03 17:45,143,73,70,0,0,0
2022-06-03 18:00,143,85,58,0,0,0
2022-06-03 18:15,142,81,61,0,0,0
2022-06-03 18:30,122,67,55,0,0,0
2022-06-03 18:45,139,87,52,0,0,0
2022-06-03 19:00,99,54,45,0,0,0
2022-06-03 19:15,88,54,34,0,0,0
2022-06-03 19:30,76,43,33,0,0,0
2022-06-03 19:45,96,67,29,0,0,0
2022-06-03 20:00,83,47,36,0,0,0
2022-06-03 20:15,74,48,26,0,0,0
2022-06-03 20:30,59,31,28,0,0,0
2022-06-03 20:45,53,29,24,0,0,0
2022-06-03 21:00,52,32,20,0,0,0
2022-06-03 21:15,52,21,31,0,0,0
2022-06-03 21:30,73,28,45,0,0,0
2022-06-03 21:45,42,20,22,0,0,0
2022-06-03 22:00,56,25,31,0,0,0
2022-06-03 22:15,30,16,14,0,0,0
2022-06-03 22:30,38,18,20,0,0,0
2022-06-03 22:45,40,14,26,0,0,0
2022-06-03 23:00,46,22,24,0,0,0
2022-06-03 23:15,31,15,16,0,0,0
2022-06-03 23:30,29,9,20,0,0,0
2022-06-03 23:45,31,16,15,0,0,0
2022-06-04 00:00,40,29,11,0,0,0
2022-06-04 00:15,32,15,17,0,0,0
2022-06-04 00:30,22,9,13,0,0,0
2022-06-04 00:45,24,15,9,0,0,0
2022-06-04 01:00,21,10,11,0,0,0
2022-06-04 01:15,18,12,6,0,0,0
2022-06-04 01:30,7,0,7,0,0,0
2022-06-04 01:45,10,5,5,0,0,0
2022-06-04 02:00,8,2,6,0,0,0
2022-06-04 02:15,14,3,11,0,0,0
2022-06-04 02:30,8,4,4,0,0,0
2022-06-04 02:45,4,4,0,0,0,0
2022-06-04 03:00,6,2,4,0,0,0
2022-06-04 03:15,8,0,8,0,0,0
2022-06-04 03:30,7,2,5,0,0,0
2022-06-04 03:45,5,1,4,0,0,0
2022-06-04 04:00,4,1,3,0,0,0
2022-06-04 04:15,3,2,1,0,0,0
2022-06-04 04:30,4,2,2,0,0,0
2022-06-04 04:45,2,2,0,0,0,0
2022-06-04 05:00,2,1,1,0,0,0
2022-06-04 05:15,10,3,7,0,0,0
2022-06-04 05:30,11,8,3,0,0,0
2022-06-04 05:45,9,5,4,0,0,0
2022-06-04 06:00,8,2,6,0,0,0
2022-06-04 06:15,8,4,4,0,0,0
2022-06-04 06:30,14,11,3,0,0,0
2022-06-04 06:45,31,16,15,0,0,0
2022-06-04 07:00,14,9,5,0,0,0
2022-06-04 07:15,27,17,10,0,0,0
2022-06-04 07:30,17,9,8,0,0,0
2022-06-04 07:45,36,24,12,0,0,0
2022-06-04 08:00,35,22,13,0,0,0
2022-06-04 08:15,43,31,12,0,0,0
2022-06-04 08:30,54,41,13,0,0,0
2022-06-04 08:45,57,37,20,0,0,0
2022-06-04 09:00,68,48,20,0,0,0
2022-06-04 09:15,89,62,27,0,0,0
2022-06-04 09:30,93,70,23,0,0,0
2022-06-04 09:45,140,116,24,0,0,0
2022-06-04 10:00,96,71,25,0,0,0
2022-06-04 10:15,137,101,36,0,0,0
2022-06-04 10:30,117,83,34,0,0,0
2022-06-04 10:45,165,114,51,0,0,0
2022-06-04 11:00,142,96,46,0,0,0
2022-06-04 11:15,143,91,52,0,0,0
2022-06-04 11:30,161,122,39,0,0,0
2022-06-04 11:45,162,105,57,0,0,0
2022-06-04 12:00,149,103,46,0,0,0
2022-06-04 12:15,157,110,47,0,0,0
2022-06-04 12:30,135,94,41,0,0,0
2022-06-04 12:45,164,108,56,0,0,0
2022-06-04 13:00,130,89,41,0,0,0
2022-06-04 13:15,157,101,56,0,0,0
2022-06-04 13:30,154,99,55,0,0,0
2022-06-04 13:45,151,95,56,0,0,0
2022-06-04 14:00,134,73,61,0,0,0
2022-06-04 14:15,147,62,85,0,0,0
2022-06-04 14:30,112,46,66,0,0,0
2022-06-04 14:45,111,53,58,0,0,0
2022-06-04 15:00,134,73,61,0,0,0
2022-06-04 15:15,108,61,47,0,0,0
2022-06-04 15:30,123,71,52,0,0,0
2022-06-04 15:45,109,69,40,0,0,0
2022-06-04 16:00,135,73,62,0,0,0
2022-06-04 16:15,110,63,47,0,0,0
2022-06-04 16:30,95,60,35,0,0,0
2022-06-04 16:45,79,50,29,0,0,0
2022-06-04 17:00,121,78,43,0,0,0
2022-06-04 17:15,123,85,38,0,0,0
2022-06-04 17:30,110,70,40,0,0,0
2022-06-04 17:45,105,76,29,0,0,0
2022-06-04 18:00,108,58,50,0,0,0
2022-06-04 18:15,96,49,47,0,0,0
2022-06-04 18:30,85,46,39,0,0,0
2022-06-04 18:45,102,55,47,0,0,0
2022-06-04 19:00,76,43,33,0,0,0
2022-06-04 19:15,100,61,39,0,0,0
2022-06-04 19:30,60,36,24,0,0,0
2022-06-04 19:45,64,41,23,0,0,0
2022-06-04 20:00,72,44,28,0,0,0
2022-06-04 20:15,60,28,32,0,0,0
2022-06-04 20:30,52,22,30,0,0,0
2022-06-04 20:45,51,26,25,0,0,0
2022-06-04 21:00,41,24,17,0,0,0
2022-06-04 21:15,58,25,33,0,0,0
2022-06-04 21:30,30,15,15,0,0,0
2022-06-04 21:45,29,14,15,0,0,0
2022-06-04 22:00,38,20,18,0,0,0
2022-06-04 22:15,43,25,18,0,0,0
2022-06-04 22:30,42,20,22,0,0,0
2022-06-04 22:45,52,28,24,0,0,0
2022-06-04 23:00,29,18,11,0,0,0
2022-06-04 23:15,29,10,19,0,0,0
2022-06-04 23:30,33,17,16,0,0,0
2022-06-04 23:45,25,13,12,0,0,0
2022-06-05 00:00,28,19,9,0,0,0
2022-06-05 00:15,29,15,14,0,0,0
2022-06-05 00:30,13,1,12,0,0,0
2022-06-05 00:45,13,8,5,0,0,0
2022-06-05 01:00,17,5,12,0,0,0
2022-06-05 01:15,13,3,10,0,0,0
2022-06-05 01:30,19,9,10,0,0,0
2022-06-05 01:45,9,2,7,0,0,0
2022-06-05 02:00,16,9,7,0,0,0
2022-06-05 02:15,10,0,10,0,0,0
2022-06-05 02:30,10,5,5,0,0,0
2022-06-05 02:45,4,1,3,0,0,0
2022-06-05 03:00,7,2,5,0,0,0
2022-06-05 03:15,6,2,4,0,0,0
2022-06-05 03:30,6,1,5,0,0,0
2022-06-05 03:45,3,0,3,0,0,0
2022-06-05 04:00,3,1,2,0,0,0
2022-06-05 04:15,5,3,2,0,0,0
2022-06-05 04:30,8,1,7,0,0,0
2022-06-05 04:45,2,1,1,0,0,0
2022-06-05 05:00,2,2,0,0,0,0
2022-06-05 05:15,3,3,0,0,0,0
2022-06-05 05:30,6,1,5,0,0,0
2022-06-05 05:45,4,2,2,0,0,0
2022-06-05 06:00,3,2,1,0,0,0
2022-06-05 06:15,4,3,1,0,0,0
2022-06-05 06:30,8,6,2,0,0,0
2022-06-05 06:45,8,4,4,0,0,0
2022-06-05 07:00,6,4,2,0,0,0
2022-06-05 07:15,6,3,3,0,0,0
2022-06-05 07:30,9,4,5,0,0,0
2022-06-05 07:45,13,11,2,0,0,0
2022-06-05 08:00,9,4,5,0,0,0
2022-06-05 08:15,10,7,3,0,0,0
2022-06-05 08:30,19,10,9,0,0,0
2022-06-05 08:45,25,20,5,0,0,0
2022-06-05 09:00,19,14,5,0,0,0
2022-06-05 09:15,22,11,11,0,0,0
2022-06-05 09:30,35,23,12,0,0,0
2022-06-05 09:45,47,39,8,0,0,0
2022-06-05 10:00,41,29,12,0,0,0
2022-06-05 10:15,33,24,9,0,0,0
2022-06-05 10:30,35,27,8,0,0,0
2022-06-05 10:45,47,33,14,0,0,0
2022-06-05 11:00,52,39,13,0,0,0
2022-06-05 11:15,45,34,11,0,0,0
2022-06-05 11:30,65,36,29,0,0,0
2022-06-05 11:45,62,46,16,0,0,0
2022-06-05 12:00,60,36,24,0,0,0
2022-06-05 12:15,50,29,21,0,0,0
2022-06-05 12:30,48,25,23,0,0,0
2022-06-05 12:45,56,25,31,0,0,0
2022-06-05 13:00,67,35,32,0,0,0
2022-06-05 13:15,52,31,21,0,0,0
2022-06-05 13:30,52,27,25,0,0,0
2022-06-05 13:45,33,19,14,0,0,0
2022-06-05 14:00,42,26,16,0,0,0
2022-06-05 14:15,33,20,13,0,0,0
2022-06-05 14:30,38,27,11,0,0,0
2022-06-05 14:45,31,19,12,0,0,0
2022-06-05 15:00,33,23,10,0,0,0
2022-06-05 15:15,33,25,8,0,0,0
2022-06-05 15:30,37,24,13,0,0,0
2022-06-05 15:45,26,16,10,0,0,0
2022-06-05 16:00,37,29,8,0,0,0
2022-06-05 16:15,30,18,12,0,0,0
2022-06-05 16:30,26,19,7,0,0,0
2022-06-05 16:45,40,29,11,0,0,0
2022-06-05 17:00,33,19,14,0,0,0
2022-06-05 17:15,34,22,12,0,0,0
2022-06-05 17:30,38,24,14,0,0,0
2022-06-05 17:45,25,14,11,0,0,0
2022-06-05 18:00,20,8,12,0,0,0
2022-06-05 18:15,36,20,16,0,0,0
2022-06-05 18:30,29,17,12,0,0,0
2022-06-05 18:45,51,32,19,0,0,0
2022-06-05 19:00,43,23,20,0,0,0
2022-06-05 19:15,43,19,24,0,0,0
2022-06-05 19:30,39,23,16,0,0,0
2022-06-05 19:45,33,14,19,0,0,0
2022-06-05 20:00,34,19,15,0,0,0
2022-06-05 20:15,21,10,11,0,0,0
2022-06-05 20:30,29,20,9,0,0,0
2022-06-05 20:45,21,15,6,0,0,0
2022-06-05 21:00,27,12,15,0,0,0
2022-06-05 21:15,16,5,11,0,0,0
2022-06-05 21:30,29,15,14,0,0,0
2022-06-05 21:45,16,10,6,0,0,0
2022-06-05 22:00,23,15,8,0,0,0
2022-06-05 22:15,15,9,6,0,0,0
2022-06-05 22:30,18,15,3,0,0,0
2022-06-05 22:45,33,27,6,0,0,0
2022-06-05 23:00,15,5,10,0,0,0
2022-06-05 23:15,8,3,5,0,0,0
2022-06-05 23:30,8,1,7,0,0,0
2022-06-05 23:45,17,11,6,0,0,0
2022-06-06 00:00,7,3,4,0,0,0
2022-06-06 00:15,11,4,7,0,0,0
2022-06-06 00:30,8,0,8,0,0,0
2022-06-06 00:45,9,5,4,0,0,0
2022-06-06 01:00,10,6,4,0,0,0
2022-06-06 01:15,5,3,2,0,0,0
2022-06-06 01:30,5,3,2,0,0,0
2022-06-06 01:45,3,1,2,0,0,0
2022-06-06 02:00,6,2,4,0,0,0
2022-06-06 02:15,1,1,0,0,0,0
2022-06-06 02:30,4,3,1,0,0,0
2022-06-06 02:45,0,0,0,0,0,0
2022-06-06 03:00,6,2,4,0,0,0
2022-06-06 03:15,0,0,0,0,0,0
2022-06-06 03:30,1,0,1,0,0,0
2022-06-06 03:45,2,2,0,0,0,0
2022-06-06 04:00,4,2,2,0,0,0
2022-06-06 04:15,0,0,0,0,0,0
2022-06-06 04:30,2,1,1,0,0,0
2022-06-06 04:45,0,0,0,0,0,0
2022-06-06 05:00,2,1,1,0,0,0
2022-06-06 05:15,2,1,1,0,0,0
2022-06-06 05:30,2,2,0,0,0,0
2022-06-06 05:45,6,4,2,0,0,0
2022-06-06 06:00,3,2,1,0,0,0
2022-06-06 06:15,2,1,1,0,0,0
2022-06-06 06:30,4,3,1,0,0,0
2022-06-06 06:45,8,5,3,0,0,0
2022-06-06 07:00,5,4,1,0,0,0
2022-06-06 07:15,6,4,2,0,0,0
2022-06-06 07:30,9,2,7,0,0,0
2022-06-06 07:45,4,3,1,0,0,0
2022-06-06 08:00,4,1,3,0,0,0
2022-06-06 08:15,5,3,2,0,0,0
2022-06-06 08:30,12,6,6,0,0,0
2022-06-06 08:45,22,14,8,0,0,0
2022-06-06 09:00,15,8,7,0,0,0
2022-06-06 09:15,25,18,7,0,0,0
2022-06-06 09:30,27,18,9,0,0,0
2022-06-06 09:45,38,26,12,0,0,0
2022-06-06 10:00,42,25,17,0,0,0
2022-06-06 10:15,31,22,9,0,0,0
2022-06-06 10:30,67,48,19,0,0,0
2022-06-06 10:45,51,32,19,0,0,0
2022-06-06 11:00,37,22,15,0,0,0
2022-06-06 11:15,61,34,27,0,0,0
2022-06-06 11:30,55,44,11,0,0,0
2022-06-06 11:45,66,44,22,0,0,0
2022-06-06 12:00,63,33,30,0,0,0
2022-06-06 12:15,54,40,14,0,0,0
2022-06-06 12:30,63,38,25,0,0,0
2022-06-06 12:45,70,54,16,0,0,0
2022-06-06 13:00,46,25,21,0,0,0
2022-06-06 13:15,46,26,20,0,0,0
2022-06-06 13:30,73,44,29,0,0,0
2022-06-06 13:45,88,47,41,0,0,0
2022-06-06 14:00,54,35,19,0,0,0
2022-06-06 14:15,59,27,32,0,0,0
2022-06-06 14:30,43,31,12,0,0,0
2022-06-06 14:45,91,51,40,0,0,0
2022-06-06 15:00,89,44,45,0,0,0
2022-06-06 15:15,53,28,25,0,0,0
2022-06-06 15:30,84,62,22,0,0,0
2022-06-06 15:45,90,66,24,0,0,0
2022-06-06 16:00,87,55,32,0,0,0
2022-06-06 16:15,63,42,21,0,0,0
2022-06-06 16:30,78,39,39,0,0,0
2022-06-06 16:45,67,41,26,0,0,0
2022-06-06 17:00,60,38,22,0,0,0
2022-06-06 17:15,67,38,29,0,0,0
2022-06-06 17:30,66,39,27,0,0,0
2022-06-06 17:45,84,59,25,0,0,0
2022-06-06 18:00,70,44,26,0,0,0
2022-06-06 18:15,65,35,30,0,0,0
2022-06-06 18:30,56,36,20,0,0,0
2022-06-06 18:45,64,39,25,0,0,0
2022-06-06 19:00,50,23,27,0,0,0
2022-06-06 19:15,62,48,14,0,0,0
2022-06-06 19:30,46,28,18,0,0,0
2022-06-06 19:45,45,29,16,0,0,0
2022-06-06 20:00,32,23,9,0,0,0
2022-06-06 20:15,27,14,13,0,0,0
2022-06-06 20:30,34,17,17,0,0,0
2022-06-06 20:45,37,18,19,0,0,0
2022-06-06 21:00,47,24,23,0,0,0
2022-06-06 21:15,32,14,18,0,0,0
2022-06-06 21:30,32,16,16,0,0,0
2022-06-06 21:45,19,12,7,0,0,0
2022-06-06 22:00,12,4,8,0,0,0
2022-06-06 22:15,20,12,8,0,0,0
2022-06-06 22:30,18,14,4,0,0,0
2022-06-06 22:45,14,6,8,0,0,0
2022-06-06 23:00,16,7,9,0,0,0
2022-06-06 23:15,3,2,1,0,0,0
2022-06-06 23:30,11,7,4,0,0,0
2022-06-06 23:45,7,3,4,0,0,0
2022-06-07 00:00,2,2,0,0,0,0
2022-06-07 00:15,7,1,6,0,0,0
2022-06-07 00:30,4,1,3,0,0,0
2022-06-07 00:45,2,1,1,0,0,0
2022-06-07 01:00,5,2,3,0,0,0
2022-06-07 01:15,0,0,0,0,0,0
2022-06-07 01:30,2,1,1,0,0,0
2022-06-07 01:45,4,2,2,0,0,0
2022-06-07 02:00,1,1,0,0,0,0
2022-06-07 02:15,2,0,2,0,0,0
2022-06-07 02:30,0,0,0,0,0,0
2022-06-07 02:45,0,0,0,0,0,0
2022-06-07 03:00,0,0,0,0,0,0
2022-06-07 03:15,0,0,0,0,0,0
2022-06-07 03:30,0,0,0,0,0,0
2022-06-07 03:45,0,0,0,0,0,0
2022-06-07 04:00,0,0,0,0,0,0
2022-06-07 04:15,3,2,1,0,0,0
2022-06-07 04:30,1,1,0,0,0,0
2022-06-07 04:45,1,0,1,0,0,0
2022-06-07 05:00,3,2,1,0,0,0
2022-06-07 05:15,8,4,4,0,0,0
2022-06-07 05:30,8,6,2,0,0,0
2022-06-07 05:45,19,10,9,0,0,0
2022-06-07 06:00,23,15,8,0,0,0
2022-06-07 06:15,33,16,17,0,0,0
2022-06-07 06:30,58,38,20,0,0,0
2022-06-07 06:45,60,43,17,0,0,0
2022-06-07 07:00,95,59,36,0,0,0
2022-06-07 07:15,141,106,35,0,0,0
2022-06-07 07:30,284,225,59,0,0,0
2022-06-07 07:45,237,167,70,0,0,0
2022-06-07 08:00,141,109,32,0,0,0
2022-06-07 08:15,146,101,45,0,0,0
2022-06-07 08:30,124,92,32,0,0,0
2022-06-07 08:45,153,116,37,0,0,0
2022-06-07 09:00,99,67,32,0,0,0
2022-06-07 09:15,109,73,36,0,0,0
2022-06-07 09:30,112,85,27,0,0,0
2022-06-07 09:45,108,78,30,0,0,0
2022-06-07 10:00,83,59,24,0,0,0
2022-06-07 10:15,103,72,31,0,0,0
2022-06-07 10:30,101,58,43,0,0,0
2022-06-07 10:45,101,66,35,0,0,0
2022-06-07 11:00,94,59,35,0,0,0
2022-06-07 11:15,96,63,33,0,0,0
2022-06-07 11:30,112,72,40,0,0,0
2022-06-07 11:45,96,63,33,0,0,0
2022-06-07 12:00,99,60,39,0,0,0
2022-06-07 12:15,106,54,52,0,0,0
2022-06-07 12:30,106,56,50,0,0,0
2022-06-07 12:45,116,74,42,0,0,0
2022-06-07 13:00,118,64,54,0,0,0
2022-06-07 13:15,129,70,59,0,0,0
2022-06-07 13:30,98,57,41,0,0,0
2022-06-07 13:45,123,62,61,0,0,0
2022-06-07 14:00,119,65,54,0,0,0
2022-06-07 14:15,118,71,47,0,0,0
2022-06-07 14:30,108,56,52,0,0,0
2022-06-07 14:45,148,88,60,0,0,0
2022-06-07 15:00,139,85,54,0,0,0
2022-06-07 15:15,128,78,50,0,0,0
2022-06-07 15:30,155,88,67,0,0,0
2022-06-07 15:45,177,106,71,0,0,0
2022-06-07 16:00,157,88,69,0,0,0
2022-06-07 16:15,176,90,86,0,0,0
2022-06-07 16:30,161,93,68,0,0,0
2022-06-07 16:45,172,88,84,0,0,0
2022-06-07 17:00,154,77,77,0,0,0
2022-06-07 17:15,159,90,69,0,0,0
2022-06-07 17:30,146,86,60,0,0,0
2022-06-07 17:45,204,104,100,0,0,0
2022-06-07 18:00,153,87,66,0,0,0
2022-06-07 18:15,142,71,71,0,0,0
2022-06-07 18:30,111,61,50,0,0,0
2022-06-07 18:45,125,69,56,0,0,0
2022-06-07 19:00,124,71,53,0,0,0
2022-06-07 19:15,112,61,51,0,0,0
2022-06-07 19:30,111,58,53,0,0,0
2022-06-07 19:45,90,43,47,0,0,0
2022-06-07 20:00,83,42,41,0,0,0
2022-06-07 20:15,56,25,31,0,0,0
2022-06-07 20:30,53,25,28,0,0,0
2022-06-07 20:45,53,23,30,0,0,0
2022-06-07 21:00,44,29,15,0,0,0
2022-06-07 21:15,44,23,21,0,0,0
2022-06-07 21:30,42,20,22,0,0,0
2022-06-07 21:45,53,21,32,0,0,0
2022-06-07 22:00,39,14,25,0,0,0
2022-06-07 22:15,48,20,28,0,0,0
2022-06-07 22:30,36,17,19,0,0,0
2022-06-07 22:45,23,4,19,0,0,0
2022-06-07 23:00,36,17,19,0,0,0
2022-06-07 23:15,15,12,3,0,0,0
2022-06-07 23:30,17,5,12,0,0,0
2022-06-07 23:45,16,7,9,0,0,0
2022-06-08 00:00,6,4,2,0,0,0
2022-06-08 00:15,6,2,4,0,0,0
2022-06-08 00:30,12,5,7,0,0,0
2022-06-08 00:45,9,5,4,0,0,0
2022-06-08 01:00,5,1,4,0,0,0
2022-06-08 01:15,5,3,2,0,0,0
2022-06-08 01:30,0,0,0,0,0,0
2022-06-08 01:45,4,4,0,0,0,0
2022-06-08 02:00,4,0,4,0,0,0
2022-06-08 02:15,4,1,3,0,0,0
2022-06-08 02:30,6,4,2,0,0,0
2022-06-08 02:45,1,1,0,0,0,0
2022-06-08 03:00,4,2,2,0,0,0
2022-06-08 03:15,1,1,0,0,0,0
2022-06-08 03:30,0,0,0,0,0,0
2022-06-08 03:45,0,0,0,0,0,0
2022-06-08 04:00,2,2,0,0,0,0
2022-06-08 04:15,4,2,2,0,0,0
2022-06-08 04:30,2,1,1,0,0,0
2022-06-08 04:45,0,0,0,0,0,0
2022-06-08 05:00,1,1,0,0,0,0
2022-06-08 05:15,4,4,0,0,0,0
2022-06-08 05:30,13,12,1,0,0,0
2022-06-08 05:45,15,9,6,0,0,0
2022-06-08 06:00,22,15,7,0,0,0
2022-06-08 06:15,35,24,11,0,0,0
2022-06-08 06:30,47,30,17,0,0,0
2022-06-08 06:45,70,53,17,0,0,0
2022-06-08 07:00,84,55,29,0,0,0
2022-06-08 07:15,151,103,48,0,0,0
2022-06-08 07:30,274,227,47,0,0,0
2022-06-08 07:45,239,179,60,0,0,0
2022-06-08 08:00,162,115,47,0,0,0
2022-06-08 08:15,162,109,53,0,0,0
2022-06-08 08:30,170,130,40,0,0,0
2022-06-08 08:45,170,133,37,0,0,0
2022-06-08 09:00,108,80,28,0,0,0
2022-06-08 09:15,148,116,32,0,0,0
2022-06-08 09:30,147,117,30,0,0,0
2022-06-08 09:45,163,117,46,0,0,0
2022-06-08 10:00,119,86,33,0,0,0
2022-06-08 10:15,121,83,38,0,0,0
2022-06-08 10:30,138,95,43,0,0,0
2022-06-08 10:45,141,95,46,0,0,0
2022-06-08 11:00,130,98,32,0,0,0
2022-06-08 11:15,115,71,44,0,0,0
2022-06-08 11:30,110,70,40,0,0,0
2022-06-08 11:45,111,68,43,0,0,0
2022-06-08 12:00,129,65,64,0,0,0
2022-06-08 12:15,116,75,41,0,0,0
2022-06-08 12:30,147,84,63,0,0,0
2022-06-08 12:45,143,71,72,0,0,0
2022-06-08 13:00,139,67,72,0,0,0
2022-06-08 13:15,141,72,69,0,0,0
2022-06-08 13:30,131,63,68,0,0,0
2022-06-08 13:45,119,75,44,0,0,0
2022-06-08 14:00,140,61,79,0,0,0
2022-06-08 14:15,134,69,65,0,0,0
2022-06-08 14:30,123,70,53,0,0,0
2022-06-08 14:45,165,73,92,0,0,0
2022-06-08 15:00,104,45,59,0,0,0
2022-06-08 15:15,77,39,38,0,0,0
2022-06-08 15:30,84,36,48,0,0,0
2022-06-08 15:45,97,47,50,0,0,0
2022-06-08 16:00,135,80,55,0,0,0
2022-06-08 16:15,124,57,67,0,0,0
2022-06-08 16:30,129,66,63,0,0,0
2022-06-08 16:45,126,58,68,0,0,0
2022-06-08 17:00,129,73,56,0,0,0
2022-06-08 17:15,138,67,71,0,0,0
2022-06-08 17:30,109,57,52,0,0,0
2022-06-08 17:45,117,60,57,0,0,0
2022-06-08 18:00,120,63,57,0,0,0
2022-06-08 18:15,107,51,56,0,0,0
2022-06-08 18:30,100,45,55,0,0,0
2022-06-08 18:45,87,40,47,0,0,0
2022-06-08 19:00,90,42,48,0,0,0
2022-06-08 19:15,83,36,47,0,0,0
2022-06-08 19:30,60,24,36,0,0,0
2022-06-08 19:45,69,37,32,0,0,0
2022-06-08 20:00,52,27,25,0,0,0
2022-06-08 20:15,50,17,33,0,0,0
2022-06-08 20:30,38,16,22,0,0,0
2022-06-08 20:45,62,27,35,0,0,0
2022-06-08 21:00,33,13,20,0,0,0
2022-06-08 21:15,28,8,20,0,0,0
2022-06-08 21:30,39,23,16,0,0,0
2022-06-08 21:45,42,23,19,0,0,0
2022-06-08 22:00,34,14,20,0,0,0
2022-06-08 22:15,28,15,13,0,0,0
2022-06-08 22:30,26,12,14,0,0,0
2022-06-08 22:45,25,14,11,0,0,0
2022-06-08 23:00,12,7,5,0,0,0
2022-06-08 23:15,18,12,6,0,0,0
2022-06-08 23:30,18,12,6,0,0,0
2022-06-08 23:45,17,11,6,0,0,0
2022-06-09 00:00,4,2,2,0,0,0
2022-06-09 00:15,15,11,4,0,0,0
2022-06-09 00:30,5,3,2,0,0,0
2022-06-09 00:45,10,7,3,0,0,0
2022-06-09 01:00,6,1,5,0,0,0
2022-06-09 01:15,7,2,5,0,0,0
2022-06-09 01:30,1,0,1,0,0,0
2022-06-09 01:45,3,3,0,0,0,0
2022-06-09 02:00,1,0,1,0,0,0
2022-06-09 02:15,4,1,3,0,0,0
2022-06-09 02:30,2,0,2,0,0,0
2022-06-09 02:45,3,0,3,0,0,0
2022-06-09 03:00,3,1,2,0,0,0
2022-06-09 03:15,3,0,3,0,0,0
2022-06-09 03:30,1,0,1,0,0,0
2022-06-09 03:45,1,0,1,0,0,0
2022-06-09 04:00,1,1,0,0,0,0
2022-06-09 04:15,3,2,1,0,0,0
2022-06-09 04:30,5,0,5,0,0,0
2022-06-09 04:45,5,3,2,0,0,0
2022-06-09 05:00,1,1,0,0,0,0
2022-06-09 05:15,5,4,1,0,0,0
2022-06-09 05:30,13,11,2,0,0,0
2022-06-09 05:45,21,12,9,0,0,0
2022-06-09 06:00,21,15,6,0,0,0
2022-06-09 06:15,31,24,7,0,0,0
2022-06-09 06:30,35,24,11,0,0,0
2022-06-09 06:45,74,48,26,0,0,0
2022-06-09 07:00,77,53,24,0,0,0
2022-06-09 07:15,133,103,30,0,0,0
2022-06-09 07:30,296,241,55,0,0,0
2022-06-09 07:45,205,144,61,0,0,0
2022-06-09 08:00,136,103,33,0,0,0
2022-06-09 08:15,124,90,34,0,0,0
2022-06-09 08:30,129,102,27,0,0,0
2022-06-09 08:45,133,106,27,0,0,0
2022-06-09 09:00,95,73,22,0,0,0
2022-06-09 09:15,95,74,21,0,0,0
2022-06-09 09:30,83,63,20,0,0,0
2022-06-09 09:45,139,105,34,0,0,0
2022-06-09 10:00,102,82,20,0,0,0
2022-06-09 10:15,89,64,25,0,0,0
2022-06-09 10:30,90,58,32,0,0,0
2022-06-09 10:45,114,95,19,0,0,0
2022-06-09 11:00,102,72,30,0,0,0
2022-06-09 11:15,117,79,38,0,0,0
2022-06-09 11:30,99,63,36,0,0,0
2022-06-09 11:45,112,67,45,0,0,0
2022-06-09 12:00,98,48,50,0,0,0
2022-06-09 12:15,110,60,50,0,0,0
2022-06-09 12:30,123,71,52,0,0,0
2022-06-09 12:45,115,74,41,0,0,0
2022-06-09 13:00,115,63,52,0,0,0
2022-06-09 13:15,111,57,54,0,0,0
2022-06-09 13:30,92,52,40,0,0,0
2022-06-09 13:45,137,74,63,0,0,0
2022-06-09 14:00,137,80,57,0,0,0
2022-06-09 14:15,123,65,58,0,0,0
2022-06-09 14:30,125,72,53,0,0,0
2022-06-09 14:45,133,68,65,0,0,0
2022-06-09 15:00,125,62,63,0,0,0
2022-06-09 15:15,123,71,52,0,0,0
2022-06-09 15:30,163,94,69,0,0,0
2022-06-09 15:45,176,106,70,0,0,0
2022-06-09 16:00,184,115,69,0,0,0
2022-06-09 16:15,165,100,65,0,0,0
2022-06-09 16:30,165,93,72,0,0,0
2022-06-09 16:45,165,96,69,0,0,0
2022-06-09 17:00,181,106,75,0,0,0
2022-06-09 17:15,167,84,83,0,0,0
2022-06-09 17:30,164,91,73,0,0,0
2022-06-09 17:45,169,74,95,0,0,0
2022-06-09 18:00,179,97,82,0,0,0
2022-06-09 18:15,150,75,75,0,0,0
2022-06-09 18:30,114,49,65,0,0,0
2022-06-09 18:45,162,92,70,0,0,0
2022-06-09 19:00,124,67,57,0,0,0
2022-06-09 19:15,94,47,47,0,0,0
2022-06-09 19:30,76,33,43,0,0,0
2022-06-09 19:45,79,38,41,0,0,0
2022-06-09 20:00,88,50,38,0,0,0
2022-06-09 20:15,62,30,32,0,0,0
2022-06-09 20:30,58,25,33,0,0,0
2022-06-09 20:45,57,27,30,0,0,0
2022-06-09 21:00,52,29,23,0,0,0
2022-06-09 21:15,45,23,22,0,0,0
2022-06-09 21:30,38,18,20,0,0,0
2022-06-09 21:45,41,17,24,0,0,0
2022-06-09 22:00,47,22,25,0,0,0
2022-06-09 22:15,42,19,23,0,0,0
2022-06-09 22:30,48,17,31,0,0,0
2022-06-09 22:45,29,12,17,0,0,0
2022-06-09 23:00,34,12,22,0,0,0
2022-06-09 23:15,23,15,8,0,0,0
2022-06-09 23:30,30,13,17,0,0,0
2022-06-09 23:45,12,2,10,0,0,0
2022-06-10 00:00,13,7,6,0,0,0
2022-06-10 00:15,16,8,8,0,0,0
2022-06-10 00:30,7,4,3,0,0,0
2022-06-10 00:45,15,9,6,0,0,0
2022-06-10 01:00,5,4,1,0,0,0
2022-06-10 01:15,4,4,0,0,0,0
2022-06-10 01:30,3,1,2,0,0,0
2022-06-10 01:45,12,3,9,0,0,0
2022-06-10 02:00,0,0,0,0,0,0
2022-06-10 02:15,1,0,1,0,0,0
2022-06-10 02:30,1,0,1,0,0,0
2022-06-10 02:45,2,1,1,0,0,0
2022-06-10 03:00,0,0,0,0,0,0
2022-06-10 03:15,1,1,0,0,0,0
2022-06-10 03:30,1,0,1,0,0,0
2022-06-10 03:45,0,0,0,0,0,0
2022-06-10 04:00,1,1,0,0,0,0
2022-06-10 04:15,1,1,0,0,0,0
2022-06-10 04:30,0,0,0,0,0,0
2022-06-10 04:45,3,2,1,0,0,0
2022-06-10 05:00,2,2,0,0,0,0
2022-06-10 05:15,6,2,4,0,0,0
2022-06-10 05:30,16,12,4,0,0,0
2022-06-10 05:45,18,6,12,0,0,0
2022-06-10 06:00,19,13,6,0,0,0
2022-06-10 06:15,28,16,12,0,0,0
2022-06-10 06:30,50,33,17,0,0,0
2022-06-10 06:45,54,39,15,0,0,0
2022-06-10 07:00,76,54,22,0,0,0
2022-06-10 07:15,167,127,40,0,0,0
2022-06-10 07:30,260,220,40,0,0,0
2022-06-10 07:45,196,132,64,0,0,0
2022-06-10 08:00,146,110,36,0,0,0
2022-06-10 08:15,144,101,43,0,0,0
2022-06-10 08:30,137,105,32,0,0,0
2022-06-10 08:45,157,111,46,0,0,0
2022-06-10 09:00,119,83,36,0,0,0
2022-06-10 09:15,137,92,45,0,0,0
2022-06-10 09:30,117,90,27,0,0,0
2022-06-10 09:45,115,86,29,0,0,0
2022-06-10 10:00,102,82,20,0,0,0
2022-06-10 10:15,111,70,41,0,0,0
2022-06-10 10:30,104,80,24,0,0,0
2022-06-10 10:45,110,62,48,0,0,0
2022-06-10 11:00,120,81,39,0,0,0
2022-06-10 11:15,113,76,37,0,0,0
2022-06-10 11:30,102,66,36,0,0,0
2022-06-10 11:45,103,72,31,0,0,0
2022-06-10 12:00,132,80,52,0,0,0
2022-06-10 12:15,133,78,55,0,0,0
2022-06-10 12:30,127,76,51,0,0,0
2022-06-10 12:45,150,88,62,0,0,0
2022-06-10 13:00,172,91,81,0,0,0
2022-06-10 13:15,164,72,92,0,0,0
2022-06-10 13:30,146,74,72,0,0,0
2022-06-10 13:45,157,86,71,0,0,0
2022-06-10 14:00,150,87,63,0,0,0
2022-06-10 14:15,145,77,68,0,0,0
2022-06-10 14:30,157,80,77,0,0,0
2022-06-10 14:45,156,86,70,0,0,0
2022-06-10 15:00,132,67,65,0,0,0
2022-06-10 15:15,162,107,55,0,0,0
2022-06-10 15:30,148,85,63,0,0,0
2022-06-10 15:45,157,93,64,0,0,0
2022-06-10 16:00,141,81,60,0,0,0
2022-06-10 16:15,168,95,73,0,0,0
2022-06-10 16:30,140,85,55,0,0,0
2022-06-10 16:45,135,80,55,0,0,0
2022-06-10 17:00,122,64,58,0,0,0
2022-06-10 17:15,143,92,51,0,0,0
2022-06-10 17:30,125,65,60,0,0,0
2022-06-10 17:45,182,118,64,0,0,0
2022-06-10 18:00,138,75,63,0,0,0
2022-06-10 18:15,121,49,72,0,0,0
2022-06-10 18:30,121,67,54,0,0,0
2022-06-10 18:45,148,89,59,0,0,0
2022-06-10 19:00,125,61,64,0,0,0
2022-06-10 19:15,104,58,46,0,0,0
2022-06-10 19:30,88,44,44,0,0,0
2022-06-10 19:45,96,60,36,0,0,0
2022-06-10 20:00,88,54,34,0,0,0
2022-06-10 20:15,81,45,36,0,0,0
2022-06-10 20:30,56,29,27,0,0,0
2022-06-10 20:45,70,40,30,0,0,0
2022-06-10 21:00,50,22,28,0,0,0
2022-06-10 21:15,54,25,29,0,0,0
2022-06-10 21:30,50,28,22,0,0,0
2022-06-10 21:45,48,28,20,0,0,0
2022-06-10 22:00,54,35,19,0,0,0
2022-06-10 22:15,44,26,18,0,0,0
2022-06-10 22:30,50,30,20,0,0,0
2022-06-10 22:45,51,24,27,0,0,0
2022-06-10 23:00,32,16,16,0,0,0
2022-06-10 23:15,39,17,22,0,0,0
2022-06-10 23:30,31,11,20,0,0,0
2022-06-10 23:45,30,4,26,0,0,0
2022-06-11 00:00,36,10,26,0,0,0
2022-06-11 00:15,21,8,13,0,0,0
2022-06-11 00:30,34,20,14,0,0,0
2022-06-11 00:45,19,10,9,0,0,0
2022-06-11 01:00,30,9,21,0,0,0
2022-06-11 01:15,16,3,13,0,0,0
2022-06-11 01:30,16,5,11,0,0,0
2022-06-11 01:45,15,9,6,0,0,0
2022-06-11 02:00,13,2,11,0,0,0
2022-06-11 02:15,14,8,6,0,0,0
2022-06-11 02:30,6,1,5,0,0,0
2022-06-11 02:45,11,2,9,0,0,0
2022-06-11 03:00,6,1,5,0,0,0
2022-06-11 03:15,8,3,5,0,0,0
2022-06-11 03:30,4,0,4,0,0,0
2022-06-11 03:45,2,1,1,0,0,0
2022-06-11 04:00,4,1,3,0,0,0
2022-06-11 04:15,7,3,4,0,0,0
2022-06-11 04:30,2,0,2,0,0,0
2022-06-11 04:45,5,3,2,0,0,0
2022-06-11 05:00,4,3,1,0,0,0
2022-06-11 05:15,3,3,0,0,0,0
2022-06-11 05:30,9,7,2,0,0,0
2022-06-11 05:45,9,4,5,0,0,0
2022-06-11 06:00,8,6,2,0,0,0
2022-06-11 06:15,8,3,5,0,0,0
2022-06-11 06:30,14,10,4,0,0,0
2022-06-11 06:45,19,14,5,0,0,0
2022-06-11 07:00,22,16,6,0,0,0
2022-06-11 07:15,22,15,7,0,0,0
2022-06-11 07:30,29,16,13,0,0,0
2022-06-11 07:45,52,34,18,0,0,0
2022-06-11 08:00,35,22,13,0,0,0
2022-06-11 08:15,51,32,19,0,0,0
2022-06-11 08:30,59,38,21,0,0,0
2022-06-11 08:45,66,48,18,0,0,0
2022-06-11 09:00,74,54,20,0,0,0
2022-06-11 09:15,88,68,20,0,0,0
2022-06-11 09:30,128,92,36,0,0,0
2022-06-11 09:45,135,102,33,0,0,0
2022-06-11 10:00,106,77,29,0,0,0
2022-06-11 10:15,187,128,59,0,0,0
2022-06-11 10:30,150,110,40,0,0,0
2022-06-11 10:45,163,99,64,0,0,0
2022-06-11 11:00,168,103,65,0,0,0
2022-06-11 11:15,143,87,56,0,0,0
2022-06-11 11:30,151,93,58,0,0,0
2022-06-11 11:45,188,119,69,0,0,0
2022-06-11 12:00,182,108,74,0,0,0
2022-06-11 12:15,162,98,64,0,0,0
2022-06-11 12:30,166,81,85,0,0,0
2022-06-11 12:45,164,89,75,0,0,0
2022-06-11 13:00,181,104,77,0,0,0
2022-06-11 13:15,201,110,91,0,0,0
2022-06-11 13:30,166,74,92,0,0,0
2022-06-11 13:45,209,110,99,0,0,0
2022-06-11 14:00,182,85,97,0,0,0
2022-06-11 14:15,187,108,79,0,0,0
2022-06-11 14:30,196,102,94,0,0,0
2022-06-11 14:45,229,140,89,0,0,0
2022-06-11 15:00,241,150,91,0,0,0
2022-06-11 15:15,170,115,55,0,0,0
2022-06-11 15:30,165,103,62,0,0,0
2022-06-11 15:45,183,119,64,0,0,0
2022-06-11 16:00,195,114,81,0,0,0
2022-06-11 16:15,199,122,77,0,0,0
2022-06-11 16:30,175,117,58,0,0,0
2022-06-11 16:45,195,124,71,0,0,0
2022-06-11 17:00,144,88,56,0,0,0
2022-06-11 17:15,167,103,64,0,0,0
2022-06-11 17:30,159,90,69,0,0,0
2022-06-11 17:45,149,81,68,0,0,0
2022-06-11 18:00,162,70,92,0,0,0
2022-06-11 18:15,144,76,68,0,0,0
2022-06-11 18:30,137,82,55,0,0,0
2022-06-11 18:45,108,67,41,0,0,0
2022-06-11 19:00,107,73,34,0,0,0
2022-06-11 19:15,97,74,23,0,0,0
2022-06-11 19:30,119,70,49,0,0,0
2022-06-11 19:45,64,38,26,0,0,0
2022-06-11 20:00,82,50,32,0,0,0
2022-06-11 20:15,61,29,32,0,0,0
2022-06-11 20:30,74,50,24,0,0,0
2022-06-11 20:45,68,45,23,0,0,0
2022-06-11 21:00,52,31,21,0,0,0
2022-06-11 21:15,50,28,22,0,0,0
2022-06-11 21:30,61,37,24,0,0,0
2022-06-11 21:45,52,28,24,0,0,0
2022-06-11 22:00,51,25,26,0,0,0
2022-06-11 22:15,43,25,18,0,0,0
2022-06-11 22:30,44,25,19,0,0,0
2022-06-11 22:45,42,21,21,0,0,0
2022-06-11 23:00,34,18,16,0,0,0
2022-06-11 23:15,50,39,11,0,0,0
2022-06-11 23:30,40,22,18,0,0,0
2022-06-11 23:45,20,10,10,0,0,0
2022-06-12 00:00,38,22,16,0,0,0
2022-06-12 00:15,29,17,12,0,0,0
2022-06-12 00:30,29,9,20,0,0,0
2022-06-12 00:45,22,14,8,0,0,0
2022-06-12 01:00,23,14,9,0,0,0
2022-06-12 01:15,18,11,7,0,0,0
2022-06-12 01:30,27,9,18,0,0,0
2022-06-12 01:45,16,9,7,0,0,0
2022-06-12 02:00,14,7,7,0,0,0
2022-06-12 02:15,6,4,2,0,0,0
2022-06-12 02:30,9,6,3,0,0,0
2022-06-12 02:45,7,3,4,0,0,0
2022-06-12 03:00,8,6,2,0,0,0
2022-06-12 03:15,9,5,4,0,0,0
2022-06-12 03:30,8,2,6,0,0,0
2022-06-12 03:45,4,3,1,0,0,0
2022-06-12 04:00,5,1,4,0,0,0
2022-06-12 04:15,5,3,2,0,0,0
2022-06-12 04:30,3,1,2,0,0,0
2022-06-12 04:45,5,2,3,0,0,0
2022-06-12 05:00,2,1,1,0,0,0
2022-06-12 05:15,2,1,1,0,0,0
2022-06-12 05:30,9,6,3,0,0,0
2022-06-12 05:45,6,4,2,0,0,0
2022-06-12 06:00,3,3,0,0,0,0
2022-06-12 06:15,8,5,3,0,0,0
2022-06-12 06:30,6,6,0,0,0,0
2022-06-12 06:45,9,3,6,0,0,0
2022-06-12 07:00,4,1,3,0,0,0
2022-06-12 07:15,4,1,3,0,0,0
2022-06-12 07:30,7,5,2,0,0,0
2022-06-12 07:45,10,8,2,0,0,0
2022-06-12 08:00,14,8,6,0,0,0
2022-06-12 08:15,14,13,1,0,0,0
2022-06-12 08:30,21,15,6,0,0,0
2022-06-12 08:45,18,9,9,0,0,0
2022-06-12 09:00,16,12,4,0,0,0
2022-06-12 09:15,43,28,15,0,0,0
2022-06-12 09:30,31,21,10,0,0,0
2022-06-12 09:45,51,40,11,0,0,0
2022-06-12 10:00,62,41,21,0,0,0
2022-06-12 10:15,51,30,21,0,0,0
2022-06-12 10:30,57,40,17,0,0,0
2022-06-12 10:45,71,50,21,0,0,0
2022-06-12 11:00,55,30,25,0,0,0
2022-06-12 11:15,54,37,17,0,0,0
2022-06-12 11:30,73,49,24,0,0,0
2022-06-12 11:45,59,43,16,0,0,0
2022-06-12 12:00,78,46,32,0,0,0
2022-06-12 12:15,72,53,19,0,0,0
2022-06-12 12:30,77,43,34,0,0,0
2022-06-12 12:45,77,44,33,0,0,0
2022-06-12 13:00,79,42,37,0,0,0
2022-06-12 13:15,80,33,47,0,0,0
2022-06-12 13:30,83,50,33,0,0,0
2022-06-12 13:45,87,50,37,0,0,0
2022-06-12 14:00,86,53,33,0,0,0
2022-06-12 14:15,106,50,56,0,0,0
2022-06-12 14:30,99,42,57,0,0,0
2022-06-12 14:45,107,72,35,0,0,0
2022-06-12 15:00,88,65,23,0,0,0
2022-06-12 15:15,129,94,35,0,0,0
2022-06-12 15:30,88,61,27,0,0,0
2022-06-12 15:45,113,88,25,0,0,0
2022-06-12 16:00,60,32,28,0,0,0
2022-06-12 16:15,100,66,34,0,0,0
2022-06-12 16:30,91,52,39,0,0,0
2022-06-12 16:45,108,68,40,0,0,0
2022-06-12 17:00,88,50,38,0,0,0
2022-06-12 17:15,111,73,38,0,0,0
2022-06-12 17:30,95,58,37,0,0,0
2022-06-12 17:45,104,65,39,0,0,0
2022-06-12 18:00,100,58,42,0,0,0
2022-06-12 18:15,92,56,36,0,0,0
2022-06-12 18:30,80,56,24,0,0,0
2022-06-12 18:45,83,51,32,0,0,0
2022-06-12 19:00,71,38,33,0,0,0
2022-06-12 19:15,50,24,26,0,0,0
2022-06-12 19:30,66,33,33,0,0,0
2022-06-12 19:45,61,37,24,0,0,0
2022-06-12 20:00,44,26,18,0,0,0
2022-06-12 20:15,46,31,15,0,0,0
2022-06-12 20:30,51,22,29,0,0,0
2022-06-12 20:45,44,19,25,0,0,0
2022-06-12 21:00,33,19,14,0,0,0
2022-06-12 21:15,44,21,23,0,0,0
2022-06-12 21:30,46,31,15,0,0,0
2022-06-12 21:45,34,13,21,0,0,0
2022-06-12 22:00,31,12,19,0,0,0
2022-06-12 22:15,35,25,10,0,0,0
2022-06-12 22:30,15,4,11,0,0,0
2022-06-12 22:45,5,3,2,0,0,0
2022-06-12 23:00,15,6,9,0,0,0
2022-06-12 23:15,12,7,5,0,0,0
2022-06-12 23:30,11,7,4,0,0,0
2022-06-12 23:45,6,2,4,0,0,0
2022-06-13 00:00,10,6,4,0,0,0
2022-06-13 00:15,3,2,1,0,0,0
2022-06-13 00:30,2,1,1,0,0,0
2022-06-13 00:45,2,1,1,0,0,0
2022-06-13 01:00,5,1,4,0,0,0
2022-06-13 01:15,0,0,0,0,0,0
2022-06-13 01:30,0,0,0,0,0,0
2022-06-13 01:45,1,1,0,0,0,0
2022-06-13 02:00,0,0,0,0,0,0
2022-06-13 02:15,4,1,3,0,0,0
2022-06-13 02:30,3,1,2,0,0,0
2022-06-13 02:45,0,0,0,0,0,0
2022-06-13 03:00,0,0,0,0,0,0
2022-06-13 03:15,1,1,0,0,0,0
2022-06-13 03:30,0,0,0,0,0,0
2022-06-13 03:45,0,0,0,0,0,0
2022-06-13 04:00,2,1,1,0,0,0
2022-06-13 04:15,1,1,0,0,0,0
2022-06-13 04:30,2,1,1,0,0,0
2022-06-13 04:45,5,3,2,0,0,0
2022-06-13 05:00,0,0,0,0,0,0
2022-06-13 05:15,6,4,2,0,0,0
2022-06-13 05:30,15,10,5,0,0,0
2022-06-13 05:45,11,7,4,0,0,0
2022-06-13 06:00,11,10,1,0,0,0
2022-06-13 06:15,24,18,6,0,0,0
2022-06-13 06:30,41,27,14,0,0,0
2022-06-13 06:45,69,51,18,0,0,0
2022-06-13 07:00,71,50,21,0,0,0
2022-06-13 07:15,138,110,28,0,0,0
2022-06-13 07:30,256,206,50,0,0,0
2022-06-13 07:45,206,152,54,0,0,0
2022-06-13 08:00,135,111,24,0,0,0
2022-06-13 08:15,147,114,33,0,0,0
2022-06-13 08:30,149,111,38,0,0,0
2022-06-13 08:45,172,133,39,0,0,0
2022-06-13 09:00,88,73,15,0,0,0
2022-06-13 09:15,83,70,13,0,0,0
2022-06-13 09:30,81,65,16,0,0,0
2022-06-13 09:45,133,110,23,0,0,0
2022-06-13 10:00,123,96,27,0,0,0
2022-06-13 10:15,95,78,17,0,0,0
2022-06-13 10:30,96,63,33,0,0,0
2022-06-13 10:45,122,88,34,0,0,0
2022-06-13 11:00,132,76,56,0,0,0
2022-06-13 11:15,101,64,37,0,0,0
2022-06-13 11:30,97,59,38,0,0,0
2022-06-13 11:45,131,83,48,0,0,0
2022-06-13 12:00,102,66,36,0,0,0
2022-06-13 12:15,117,63,54,0,0,0
2022-06-13 12:30,155,83,72,0,0,0
2022-06-13 12:45,110,72,38,0,0,0
2022-06-13 13:00,136,74,62,0,0,0
2022-06-13 13:15,119,60,59,0,0,0
2022-06-13 13:30,132,83,49,0,0,0
2022-06-13 13:45,161,86,75,0,0,0
2022-06-13 14:00,143,80,63,0,0,0
2022-06-13 14:15,123,62,61,0,0,0
2022-06-13 14:30,131,78,53,0,0,0
2022-06-13 14:45,136,83,53,0,0,0
2022-06-13 15:00,136,86,50,0,0,0
2022-06-13 15:15,138,84,54,0,0,0
2022-06-13 15:30,162,91,71,0,0,0
2022-06-13 15:45,202,121,81,0,0,0
2022-06-13 16:00,193,118,75,0,0,0
2022-06-13 16:15,173,92,81,0,0,0
2022-06-13 16:30,186,103,83,0,0,0
2022-06-13 16:45,189,96,93,0,0,0
2022-06-13 17:00,156,86,70,0,0,0
2022-06-13 17:15,148,89,59,0,0,0
2022-06-13 17:30,175,96,79,0,0,0
2022-06-13 17:45,212,117,95,0,0,0
2022-06-13 18:00,193,102,91,0,0,0
2022-06-13 18:15,178,85,93,0,0,0
2022-06-13 18:30,137,67,70,0,0,0
2022-06-13 18:45,145,75,70,0,0,0
2022-06-13 19:00,108,57,51,0,0,0
2022-06-13 19:15,126,66,60,0,0,0
2022-06-13 19:30,119,68,51,0,0,0
2022-06-13 19:45,111,58,53,0,0,0
2022-06-13 20:00,83,37,46,0,0,0
2022-06-13 20:15,56,23,33,0,0,0
2022-06-13 20:30,67,42,25,0,0,0
2022-06-13 20:45,40,15,25,0,0,0
2022-06-13 21:00,49,23,26,0,0,0
2022-06-13 21:15,48,20,28,0,0,0
2022-06-13 21:30,53,22,31,0,0,0
2022-06-13 21:45,60,27,33,0,0,0
2022-06-13 22:00,65,27,38,0,0,0
2022-06-13 22:15,55,13,42,0,0,0
2022-06-13 22:30,39,14,25,0,0,0
2022-06-13 22:45,27,5,22,0,0,0
2022-06-13 23:00,28,12,16,0,0,0
2022-06-13 23:15,32,11,21,0,0,0
2022-06-13 23:30,21,10,11,0,0,0
2022-06-13 23:45,16,11,5,0,0,0
2022-06-14 00:00,11,4,7,0,0,0
2022-06-14 00:15,8,4,4,0,0,0
2022-06-14 00:30,4,1,3,0,0,0
2022-06-14 00:45,13,4,9,0,0,0
2022-06-14 01:00,9,1,8,0,0,0
2022-06-14 01:15,2,0,2,0,0,0
2022-06-14 01:30,2,0,2,0,0,0
2022-06-14 01:45,4,2,2,0,0,0
2022-06-14 02:00,3,2,1,0,0,0
2022-06-14 02:15,2,0,2,0,0,0
2022-06-14 02:30,1,1,0,0,0,0
2022-06-14 02:45,0,0,0,0,0,0
2022-06-14 03:00,0,0,0,0,0,0
2022-06-14 03:15,1,0,1,0,0,0
2022-06-14 03:30,0,0,0,0,0,0
2022-06-14 03:45,4,3,1,0,0,0
2022-06-14 04:00,0,0,0,0,0,0
2022-06-14 04:15,3,2,1,0,0,0
2022-06-14 04:30,2,0,2,0,0,0
2022-06-14 04:45,1,1,0,0,0,0
2022-06-14 05:00,1,1,0,0,0,0
2022-06-14 05:15,6,5,1,0,0,0
2022-06-14 05:30,12,10,2,0,0,0
2022-06-14 05:45,27,12,15,0,0,0
2022-06-14 06:00,26,19,7,0,0,0
2022-06-14 06:15,37,27,10,0,0,0
2022-06-14 06:30,62,36,26,0,0,0
2022-06-14 06:45,82,54,28,0,0,0
2022-06-14 07:00,110,78,32,0,0,0
2022-06-14 07:15,161,113,48,0,0,0
2022-06-14 07:30,269,214,55,0,0,0
2022-06-14 07:45,233,161,72,0,0,0
2022-06-14 08:00,180,138,42,0,0,0
2022-06-14 08:15,168,127,41,0,0,0
2022-06-14 08:30,176,125,51,0,0,0
2022-06-14 08:45,170,136,34,0,0,0
2022-06-14 09:00,137,97,40,0,0,0
2022-06-14 09:15,123,87,36,0,0,0
2022-06-14 09:30,155,107,48,0,0,0
2022-06-14 09:45,153,120,33,0,0,0
2022-06-14 10:00,137,96,41,0,0,0
2022-06-14 10:15,115,73,42,0,0,0
2022-06-14 10:30,123,83,40,0,0,0
2022-06-14 10:45,104,73,31,0,0,0
2022-06-14 11:00,103,67,36,0,0,0
2022-06-14 11:15,103,67,36,0,0,0
2022-06-14 11:30,114,72,42,0,0,0
2022-06-14 11:45,117,76,41,0,0,0
2022-06-14 12:00,122,74,48,0,0,0
2022-06-14 12:15,118,72,46,0,0,0
2022-06-14 12:30,116,72,44,0,0,0
2022-06-14 12:45,140,87,53,0,0,0
2022-06-14 13:00,143,75,68,0,0,0
2022-06-14 13:15,141,87,54,0,0,0
2022-06-14 13:30,134,72,62,0,0,0
2022-06-14 13:45,154,83,71,0,0,0
2022-06-14 14:00,171,104,67,0,0,0
2022-06-14 14:15,155,90,65,0,0,0
2022-06-14 14:30,145,82,63,0,0,0
2022-06-14 14:45,161,102,59,0,0,0
2022-06-14 15:00,128,78,50,0,0,0
2022-06-14 15:15,155,105,50,0,0,0
2022-06-14 15:30,169,105,64,0,0,0
2022-06-14 15:45,206,123,83,0,0,0
2022-06-14 16:00,216,128,88,0,0,0
2022-06-14 16:15,197,108,89,0,0,0
2022-06-14 16:30,160,87,73,0,0,0
2022-06-14 16:45,200,115,85,0,0,0
2022-06-14 17:00,180,94,86,0,0,0
2022-06-14 17:15,186,112,74,0,0,0
2022-06-14 17:30,191,110,81,0,0,0
2022-06-14 17:45,202,96,106,0,0,0
2022-06-14 18:00,196,108,88,0,0,0
2022-06-14 18:15,164,93,71,0,0,0
2022-06-14 18:30,150,69,81,0,0,0
2022-06-14 18:45,185,101,84,0,0,0
2022-06-14 19:00,120,65,55,0,0,0
2022-06-14 19:15,147,92,55,0,0,0
2022-06-14 19:30,105,57,48,0,0,0
2022-06-14 19:45,115,63,52,0,0,0
2022-06-14 20:00,116,50,66,0,0,0
2022-06-14 20:15,82,42,40,0,0,0
2022-06-14 20:30,83,36,47,0,0,0
2022-06-14 20:45,57,21,36,0,0,0
2022-06-14 21:00,59,28,31,0,0,0
2022-06-14 21:15,67,36,31,0,0,0
2022-06-14 21:30,55,28,27,0,0,0
2022-06-14 21:45,67,24,43,0,0,0
2022-06-14 22:00,42,15,27,0,0,0
2022-06-14 22:15,70,27,43,0,0,0
2022-06-14 22:30,41,16,25,0,0,0
2022-06-14 22:45,48,23,25,0,0,0
2022-06-14 23:00,33,11,22,0,0,0
2022-06-14 23:15,35,18,17,0,0,0
2022-06-14 23:30,23,15,8,0,0,0
2022-06-14 23:45,21,9,12,0,0,0
2022-06-15 00:00,17,7,10,0,0,0
2022-06-15 00:15,9,1,8,0,0,0
2022-06-15 00:30,8,4,4,0,0,0
2022-06-15 00:45,7,1,6,0,0,0
2022-06-15 01:00,4,1,3,0,0,0
2022-06-15 01:15,2,1,1,0,0,0
2022-06-15 01:30,6,2,4,0,0,0
2022-06-15 01:45,4,4,0,0,0,0
2022-06-15 02:00,2,0,2,0,0,0
2022-06-15 02:15,0,0,0,0,0,0
2022-06-15 02:30,4,2,2,0,0,0
2022-06-15 02:45,4,3,1,0,0,0
2022-06-15 03:00,3,1,2,0,0,0
2022-06-15 03:15,3,0,3,0,0,0
2022-06-15 03:30,2,1,1,0,0,0
2022-06-15 03:45,1,0,1,0,0,0
2022-06-15 04:00,1,0,1,0,0,0
2022-06-15 04:15,4,2,2,0,0,0
2022-06-15 04:30,4,1,3,0,0,0
2022-06-15 04:45,3,1,2,0,0,0
2022-06-15 05:00,1,0,1,0,0,0
2022-06-15 05:15,3,2,1,0,0,0
2022-06-15 05:30,16,14,2,0,0,0
2022-06-15 05:45,29,10,19,0,0,0
2022-06-15 06:00,23,14,9,0,0,0
2022-06-15 06:15,25,16,9,0,0,0
2022-06-15 06:30,66,40,26,0,0,0
2022-06-15 06:45,84,57,27,0,0,0
2022-06-15 07:00,111,73,38,0,0,0
2022-06-15 07:15,180,129,51,0,0,0
2022-06-15 07:30,240,186,54,0,0,0
2022-06-15 07:45,227,164,63,0,0,0
2022-06-15 08:00,184,139,45,0,0,0
2022-06-15 08:15,176,120,56,0,0,0
2022-06-15 08:30,190,140,50,0,0,0
2022-06-15 08:45,185,140,45,0,0,0
2022-06-15 09:00,149,110,39,0,0,0
2022-06-15 09:15,156,120,36,0,0,0
2022-06-15 09:30,134,108,26,0,0,0
2022-06-15 09:45,190,140,50,0,0,0
2022-06-15 10:00,141,113,28,0,0,0
2022-06-15 10:15,153,109,44,0,0,0
2022-06-15 10:30,158,118,40,0,0,0
2022-06-15 10:45,159,114,45,0,0,0
2022-06-15 11:00,131,77,54,0,0,0
2022-06-15 11:15,136,100,36,0,0,0
2022-06-15 11:30,158,102,56,0,0,0
2022-06-15 11:45,194,125,69,0,0,0
2022-06-15 12:00,173,112,61,0,0,0
2022-06-15 12:15,145,86,59,0,0,0
2022-06-15 12:30,154,70,84,0,0,0
2022-06-15 12:45,156,89,67,0,0,0
2022-06-15 13:00,187,96,91,0,0,0
2022-06-15 13:15,190,94,96,0,0,0
2022-06-15 13:30,180,92,88,0,0,0
2022-06-15 13:45,184,92,92,0,0,0
2022-06-15 14:00,157,81,76,0,0,0
2022-06-15 14:15,160,86,74,0,0,0
2022-06-15 14:30,164,89,75,0,0,0
2022-06-15 14:45,156,85,71,0,0,0
2022-06-15 15:00,161,78,83,0,0,0
2022-06-15 15:15,194,110,84,0,0,0
2022-06-15 15:30,159,95,64,0,0,0
2022-06-15 15:45,179,94,85,0,0,0
2022-06-15 16:00,202,120,82,0,0,0
2022-06-15 16:15,188,119,69,0,0,0
2022-06-15 16:30,209,123,86,0,0,0
2022-06-15 16:45,165,84,81,0,0,0
2022-06-15 17:00,161,84,77,0,0,0
2022-06-15 17:15,198,112,86,0,0,0
2022-06-15 17:30,174,86,88,0,0,0
2022-06-15 17:45,244,127,117,0,0,0
2022-06-15 18:00,199,115,84,0,0,0
2022-06-15 18:15,202,102,100,0,0,0
2022-06-15 18:30,157,92,65,0,0,0
2022-06-15 18:45,156,83,73,0,0,0
2022-06-15 19:00,162,86,76,0,0,0
2022-06-15 19:15,144,91,53,0,0,0
2022-06-15 19:30,138,69,69,0,0,0
2022-06-15 19:45,152,88,64,0,0,0
2022-06-15 20:00,111,54,57,0,0,0
2022-06-15 20:15,102,51,51,0,0,0
2022-06-15 20:30,97,56,41,0,0,0
2022-06-15 20:45,69,39,30,0,0,0
2022-06-15 21:00,69,42,27,0,0,0
2022-06-15 21:15,74,40,34,0,0,0
2022-06-15 21:30,62,32,30,0,0,0
2022-06-15 21:45,77,44,33,0,0,0
2022-06-15 22:00,64,28,36,0,0,0
2022-06-15 22:15,79,38,41,0,0,0
2022-06-15 22:30,46,20,26,0,0,0
2022-06-15 22:45,50,25,25,0,0,0
2022-06-15 23:00,56,25,31,0,0,0
2022-06-15 23:15,57,23,34,0,0,0
2022-06-15 23:30,42,18,24,0,0,0
2022-06-15 23:45,56,29,27,0,0,0
2022-06-16 00:00,37,21,16,0,0,0
2022-06-16 00:15,39,8,31,0,0,0
2022-06-16 00:30,44,31,13,0,0,0
2022-06-16 00:45,38,24,14,0,0,0
2022-06-16 01:00,36,19,17,0,0,0
2022-06-16 01:15,18,7,11,0,0,0
2022-06-16 01:30,15,5,10,0,0,0
2022-06-16 01:45,24,16,8,0,0,0
2022-06-16 02:00,18,7,11,0,0,0
2022-06-16 02:15,15,5,10,0,0,0
2022-06-16 02:30,22,10,12,0,0,0
2022-06-16 02:45,13,10,3,0,0,0
2022-06-16 03:00,15,5,10,0,0,0
2022-06-16 03:15,10,5,5,0,0,0
2022-06-16 03:30,11,7,4,0,0,0
2022-06-16 03:45,10,4,6,0,0,0
2022-06-16 04:00,2,1,1,0,0,0
2022-06-16 04:15,2,0,2,0,0,0
2022-06-16 04:30,5,2,3,0,0,0
2022-06-16 04:45,5,3,2,0,0,0
2022-06-16 05:00,2,2,0,0,0,0
2022-06-16 05:15,3,1,2,0,0,0
2022-06-16 05:30,6,3,3,0,0,0
2022-06-16 05:45,6,3,3,0,0,0
2022-06-16 06:00,8,5,3,0,0,0
2022-06-16 06:15,7,4,3,0,0,0
2022-06-16 06:30,6,5,1,0,0,0
2022-06-16 06:45,4,2,2,0,0,0
2022-06-16 07:00,12,5,7,0,0,0
2022-06-16 07:15,12,8,4,0,0,0
2022-06-16 07:30,9,8,1,0,0,0
2022-06-16 07:45,25,13,12,0,0,0
2022-06-16 08:00,11,7,4,0,0,0
2022-06-16 08:15,19,13,6,0,0,0
2022-06-16 08:30,29,22,7,0,0,0
2022-06-16 08:45,27,11,16,0,0,0
2022-06-16 09:00,35,21,14,0,0,0
2022-06-16 09:15,51,35,16,0,0,0
2022-06-16 09:30,46,28,18,0,0,0
2022-06-16 09:45,74,55,19,0,0,0
2022-06-16 10:00,52,23,29,0,0,0
2022-06-16 10:15,47,32,15,0,0,0
2022-06-16 10:30,62,35,27,0,0,0
2022-06-16 10:45,88,65,23,0,0,0
2022-06-16 11:00,48,23,25,0,0,0
2022-06-16 11:15,51,31,20,0,0,0
2022-06-16 11:30,52,33,19,0,0,0
2022-06-16 11:45,56,26,30,0,0,0
2022-06-16 12:00,70,37,33,0,0,0
2022-06-16 12:15,70,36,34,0,0,0
2022-06-16 12:30,72,36,36,0,0,0
2022-06-16 12:45,85,40,45,0,0,0
2022-06-16 13:00,68,38,30,0,0,0
2022-06-16 13:15,74,43,31,0,0,0
2022-06-16 13:30,97,58,39,0,0,0
2022-06-16 13:45,86,60,26,0,0,0
2022-06-16 14:00,96,65,31,0,0,0
2022-06-16 14:15,103,62,41,0,0,0
2022-06-16 14:30,95,54,41,0,0,0
2022-06-16 14:45,95,62,33,0,0,0
2022-06-16 15:00,87,54,33,0,0,0
2022-06-16 15:15,95,56,39,0,0,0
2022-06-16 15:30,95,67,28,0,0,0
2022-06-16 15:45,78,55,23,0,0,0
2022-06-16 16:00,83,48,35,0,0,0
2022-06-16 16:15,101,67,34,0,0,0
2022-06-16 16:30,123,97,26,0,0,0
2022-06-16 16:45,85,55,30,0,0,0
2022-06-16 17:00,89,61,28,0,0,0
2022-06-16 17:15,111,69,42,0,0,0
2022-06-16 17:30,106,62,44,0,0,0
2022-06-16 17:45,101,73,28,0,0,0
2022-06-16 18:00,135,91,44,0,0,0
2022-06-16 18:15,110,61,49,0,0,0
2022-06-16 18:30,84,51,33,0,0,0
2022-06-16 18:45,109,75,34,0,0,0
2022-06-16 19:00,72,46,26,0,0,0
2022-06-16 19:15,79,60,19,0,0,0
2022-06-16 19:30,83,50,33,0,0,0
2022-06-16 19:45,65,48,17,0,0,0
2022-06-16 20:00,74,44,30,0,0,0
2022-06-16 20:15,72,36,36,0,0,0
2022-06-16 20:30,44,19,25,0,0,0
2022-06-16 20:45,45,32,13,0,0,0
2022-06-16 21:00,54,34,20,0,0,0
2022-06-16 21:15,60,30,30,0,0,0
2022-06-16 21:30,36,17,19,0,0,0
2022-06-16 21:45,34,15,19,0,0,0
2022-06-16 22:00,50,27,23,0,0,0
2022-06-16 22:15,28,11,17,0,0,0
2022-06-16 22:30,34,22,12,0,0,0
2022-06-16 22:45,26,9,17,0,0,0
2022-06-16 23:00,22,11,11,0,0,0
2022-06-16 23:15,35,22,13,0,0,0
2022-06-16 23:30,15,8,7,0,0,0
2022-06-16 23:45,25,15,10,0,0,0
2022-06-17 00:00,9,7,2,0,0,0
2022-06-17 00:15,17,6,11,0,0,0
2022-06-17 00:30,8,5,3,0,0,0
2022-06-17 00:45,16,10,6,0,0,0
2022-06-17 01:00,8,6,2,0,0,0
2022-06-17 01:15,5,1,4,0,0,0
2022-06-17 01:30,2,0,2,0,0,0
2022-06-17 01:45,8,1,7,0,0,0
2022-06-17 02:00,3,2,1,0,0,0
2022-06-17 02:15,6,3,3,0,0,0
2022-06-17 02:30,0,0,0,0,0,0
2022-06-17 02:45,6,2,4,0,0,0
2022-06-17 03:00,3,1,2,0,0,0
2022-06-17 03:15,2,0,2,0,0,0
2022-06-17 03:30,1,0,1,0,0,0
2022-06-17 03:45,1,0,1,0,0,0
2022-06-17 04:00,1,0,1,0,0,0
2022-06-17 04:15,3,3,0,0,0,0
2022-06-17 04:30,0,0,0,0,0,0
2022-06-17 04:45,1,1,0,0,0,0
2022-06-17 05:00,1,1,0,0,0,0
2022-06-17 05:15,1,1,0,0,0,0
2022-06-17 05:30,6,4,2,0,0,0
2022-06-17 05:45,15,8,7,0,0,0
2022-06-17 06:00,20,14,6,0,0,0
2022-06-17 06:15,29,15,14,0,0,0
2022-06-17 06:30,29,21,8,0,0,0
2022-06-17 06:45,43,30,13,0,0,0
2022-06-17 07:00,60,47,13,0,0,0
2022-06-17 07:15,139,115,24,0,0,0
2022-06-17 07:30,205,176,29,0,0,0
2022-06-17 07:45,174,138,36,0,0,0
2022-06-17 08:00,109,83,26,0,0,0
2022-06-17 08:15,101,76,25,0,0,0
2022-06-17 08:30,94,69,25,0,0,0
2022-06-17 08:45,119,98,21,0,0,0
2022-06-17 09:00,85,66,19,0,0,0
2022-06-17 09:15,95,67,28,0,0,0
2022-06-17 09:30,126,95,31,0,0,0
2022-06-17 09:45,159,127,32,0,0,0
2022-06-17 10:00,123,93,30,0,0,0
2022-06-17 10:15,112,76,36,0,0,0
2022-06-17 10:30,114,80,34,0,0,0
2022-06-17 10:45,120,78,42,0,0,0
2022-06-17 11:00,116,83,33,0,0,0
2022-06-17 11:15,146,86,60,0,0,0
2022-06-17 11:30,167,105,62,0,0,0
2022-06-17 11:45,158,109,49,0,0,0
2022-06-17 12:00,154,83,71,0,0,0
2022-06-17 12:15,136,76,60,0,0,0
2022-06-17 12:30,179,109,70,0,0,0
2022-06-17 12:45,146,71,75,0,0,0
2022-06-17 13:00,149,70,79,0,0,0
2022-06-17 13:15,127,70,57,0,0,0
2022-06-17 13:30,173,85,88,0,0,0
2022-06-17 13:45,175,88,87,0,0,0
2022-06-17 14:00,178,95,83,0,0,0
2022-06-17 14:15,160,94,66,0,0,0
2022-06-17 14:30,144,81,63,0,0,0
2022-06-17 14:45,179,116,63,0,0,0
2022-06-17 15:00,164,90,74,0,0,0
2022-06-17 15:15,149,75,74,0,0,0
2022-06-17 15:30,139,81,58,0,0,0
2022-06-17 15:45,221,137,84,0,0,0
2022-06-17 16:00,149,76,73,0,0,0
2022-06-17 16:15,152,83,69,0,0,0
2022-06-17 16:30,159,65,94,0,0,0
2022-06-17 16:45,137,75,62,0,0,0
2022-06-17 17:00,135,77,58,0,0,0
2022-06-17 17:15,180,88,92,0,0,0
2022-06-17 17:30,177,112,65,0,0,0
2022-06-17 17:45,139,83,56,0,0,0
2022-06-17 18:00,154,96,58,0,0,0
2022-06-17 18:15,148,88,60,0,0,0
2022-06-17 18:30,169,105,64,0,0,0
2022-06-17 18:45,151,88,63,0,0,0
2022-06-17 19:00,157,93,64,0,0,0
2022-06-17 19:15,138,85,53,0,0,0
2022-06-17 19:30,137,83,54,0,0,0
2022-06-17 19:45,130,77,53,0,0,0
2022-06-17 20:00,124,91,33,0,0,0
2022-06-17 20:15,105,65,40,0,0,0
2022-06-17 20:30,85,50,35,0,0,0
2022-06-17 20:45,77,50,27,0,0,0
2022-06-17 21:00,80,41,39,0,0,0
2022-06-17 21:15,98,48,50,0,0,0
2022-06-17 21:30,59,28,31,0,0,0
2022-06-17 21:45,70,25,45,0,0,0
2022-06-17 22:00,85,34,51,0,0,0
2022-06-17 22:15,58,21,37,0,0,0
2022-06-17 22:30,66,20,46,0,0,0
2022-06-17 22:45,65,26,39,0,0,0
2022-06-17 23:00,59,16,43,0,0,0
2022-06-17 23:15,69,28,41,0,0,0
2022-06-17 23:30,44,19,25,0,0,0
2022-06-17 23:45,46,14,32,0,0,0
2022-06-18 00:00,56,26,30,0,0,0
2022-06-18 00:15,28,13,15,0,0,0
2022-06-18 00:30,39,7,32,0,0,0
2022-06-18 00:45,20,9,11,0,0,0
2022-06-18 01:00,23,10,13,0,0,0
2022-06-18 01:15,32,11,21,0,0,0
2022-06-18 01:30,14,6,8,0,0,0
2022-06-18 01:45,12,4,8,0,0,0
2022-06-18 02:00,24,6,18,0,0,0
2022-06-18 02:15,20,6,14,0,0,0
2022-06-18 02:30,12,3,9,0,0,0
2022-06-18 02:45,10,7,3,0,0,0
2022-06-18 03:00,10,1,9,0,0,0
2022-06-18 03:15,8,3,5,0,0,0
2022-06-18 03:30,9,2,7,0,0,0
2022-06-18 03:45,2,0,2,0,0,0
2022-06-18 04:00,3,3,0,0,0,0
2022-06-18 04:15,6,3,3,0,0,0
2022-06-18 04:30,6,3,3,0,0,0
2022-06-18 04:45,1,1,0,0,0,0
2022-06-18 05:00,4,4,0,0,0,0
2022-06-18 05:15,1,0,1,0,0,0
2022-06-18 05:30,9,7,2,0,0,0
2022-06-18 05:45,8,4,4,0,0,0
2022-06-18 06:00,8,4,4,0,0,0
2022-06-18 06:15,8,2,6,0,0,0
2022-06-18 06:30,13,10,3,0,0,0
2022-06-18 06:45,19,14,5,0,0,0
2022-06-18 07:00,18,17,1,0,0,0
2022-06-18 07:15,29,24,5,0,0,0
2022-06-18 07:30,39,23,16,0,0,0
2022-06-18 07:45,47,30,17,0,0,0
2022-06-18 08:00,45,29,16,0,0,0
2022-06-18 08:15,57,48,9,0,0,0
2022-06-18 08:30,75,59,16,0,0,0
2022-06-18 08:45,77,59,18,0,0,0
2022-06-18 09:00,94,68,26,0,0,0
2022-06-18 09:15,116,89,27,0,0,0
2022-06-18 09:30,119,98,21,0,0,0
2022-06-18 09:45,182,143,39,0,0,0
2022-06-18 10:00,141,111,30,0,0,0
2022-06-18 10:15,162,112,50,0,0,0
2022-06-18 10:30,128,78,50,0,0,0
2022-06-18 10:45,149,103,46,0,0,0
2022-06-18 11:00,152,94,58,0,0,0
2022-06-18 11:15,151,92,59,0,0,0
2022-06-18 11:30,142,89,53,0,0,0
2022-06-18 11:45,160,106,54,0,0,0
2022-06-18 12:00,127,71,56,0,0,0
2022-06-18 12:15,137,75,62,0,0,0
2022-06-18 12:30,148,97,51,0,0,0
2022-06-18 12:45,147,88,59,0,0,0
2022-06-18 13:00,142,64,78,0,0,0
2022-06-18 13:15,181,88,93,0,0,0
2022-06-18 13:30,163,75,88,0,0,0
2022-06-18 13:45,138,51,87,0,0,0
2022-06-18 14:00,137,48,89,0,0,0
2022-06-18 14:15,125,48,77,0,0,0
2022-06-18 14:30,136,72,64,0,0,0
2022-06-18 14:45,126,62,64,0,0,0
2022-06-18 15:00,112,47,65,0,0,0
2022-06-18 15:15,114,52,62,0,0,0
2022-06-18 15:30,127,59,68,0,0,0
2022-06-18 15:45,113,44,69,0,0,0
2022-06-18 16:00,82,37,45,0,0,0
2022-06-18 16:15,117,59,58,0,0,0
2022-06-18 16:30,100,52,48,0,0,0
2022-06-18 16:45,93,51,42,0,0,0
2022-06-18 17:00,115,66,49,0,0,0
2022-06-18 17:15,121,73,48,0,0,0
2022-06-18 17:30,130,94,36,0,0,0
2022-06-18 17:45,163,108,55,0,0,0
2022-06-18 18:00,110,77,33,0,0,0
2022-06-18 18:15,128,89,39,0,0,0
2022-06-18 18:30,99,63,36,0,0,0
2022-06-18 18:45,111,65,46,0,0,0
2022-06-18 19:00,121,90,31,0,0,0
2022-06-18 19:15,119,82,37,0,0,0
2022-06-18 19:30,114,84,30,0,0,0
2022-06-18 19:45,112,73,39,0,0,0
2022-06-18 20:00,68,43,25,0,0,0
2022-06-18 20:15,93,65,28,0,0,0
2022-06-18 20:30,61,39,22,0,0,0
2022-06-18 20:45,71,49,22,0,0,0
2022-06-18 21:00,60,40,20,0,0,0
2022-06-18 21:15,58,29,29,0,0,0
2022-06-18 21:30,60,28,32,0,0,0
2022-06-18 21:45,48,26,22,0,0,0
2022-06-18 22:00,75,41,34,0,0,0
2022-06-18 22:15,57,30,27,0,0,0
2022-06-18 22:30,41,21,20,0,0,0
2022-06-18 22:45,54,34,20,0,0,0
2022-06-18 23:00,46,25,21,0,0,0
2022-06-18 23:15,45,13,32,0,0,0
2022-06-18 23:30,47,26,21,0,0,0
2022-06-18 23:45,34,19,15,0,0,0
2022-06-19 00:00,39,15,24,0,0,0
2022-06-19 00:15,25,7,18,0,0,0
2022-06-19 00:30,43,25,18,0,0,0
2022-06-19 00:45,27,12,15,0,0,0
2022-06-19 01:00,31,18,13,0,0,0
2022-06-19 01:15,17,7,10,0,0,0
2022-06-19 01:30,7,3,4,0,0,0
2022-06-19 01:45,16,8,8,0,0,0
2022-06-19 02:00,14,7,7,0,0,0
2022-06-19 02:15,4,0,4,0,0,0
2022-06-19 02:30,10,2,8,0,0,0
2022-06-19 02:45,5,0,5,0,0,0
2022-06-19 03:00,7,0,7,0,0,0
2022-06-19 03:15,19,5,14,0,0,0
2022-06-19 03:30,8,1,7,0,0,0
2022-06-19 03:45,11,0,11,0,0,0
2022-06-19 04:00,12,10,2,0,0,0
2022-06-19 04:15,9,3,6,0,0,0
2022-06-19 04:30,6,1,5,0,0,0
2022-06-19 04:45,4,3,1,0,0,0
2022-06-19 05:00,3,2,1,0,0,0
2022-06-19 05:15,3,2,1,0,0,0
2022-06-19 05:30,4,1,3,0,0,0
2022-06-19 05:45,3,2,1,0,0,0
2022-06-19 06:00,6,5,1,0,0,0
2022-06-19 06:15,6,3,3,0,0,0
2022-06-19 06:30,7,5,2,0,0,0
2022-06-19 06:45,7,2,5,0,0,0
2022-06-19 07:00,0,0,0,0,0,0
2022-06-19 07:15,4,1,3,0,0,0
2022-06-19 07:30,14,10,4,0,0,0
2022-06-19 07:45,14,9,5,0,0,0
2022-06-19 08:00,13,11,2,0,0,0
2022-06-19 08:15,14,9,5,0,0,0
2022-06-19 08:30,21,15,6,0,0,0
2022-06-19 08:45,24,16,8,0,0,0
2022-06-19 09:00,17,10,7,0,0,0
2022-06-19 09:15,35,17,18,0,0,0
2022-06-19 09:30,25,16,9,0,0,0
2022-06-19 09:45,54,41,13,0,0,0
2022-06-19 10:00,47,33,14,0,0,0
2022-06-19 10:15,68,38,30,0,0,0
2022-06-19 10:30,43,34,9,0,0,0
2022-06-19 10:45,59,37,22,0,0,0
2022-06-19 11:00,44,24,20,0,0,0
2022-06-19 11:15,49,34,15,0,0,0
2022-06-19 11:30,58,36,22,0,0,0
2022-06-19 11:45,78,52,26,0,0,0
2022-06-19 12:00,59,48,11,0,0,0
2022-06-19 12:15,70,44,26,0,0,0
2022-06-19 12:30,55,36,19,0,0,0
2022-06-19 12:45,55,27,28,0,0,0
2022-06-19 13:00,57,35,22,0,0,0
2022-06-19 13:15,71,45,26,0,0,0
2022-06-19 13:30,87,47,40,0,0,0
2022-06-19 13:45,77,45,32,0,0,0
2022-06-19 14:00,86,50,36,0,0,0
2022-06-19 14:15,64,39,25,0,0,0
2022-06-19 14:30,88,65,23,0,0,0
2022-06-19 14:45,114,73,41,0,0,0
2022-06-19 15:00,116,80,36,0,0,0
2022-06-19 15:15,81,56,25,0,0,0
2022-06-19 15:30,102,70,32,0,0,0
2022-06-19 15:45,82,55,27,0,0,0
2022-06-19 16:00,96,65,31,0,0,0
2022-06-19 16:15,81,44,37,0,0,0
2022-06-19 16:30,71,44,27,0,0,0
2022-06-19 16:45,65,39,26,0,0,0
2022-06-19 17:00,78,46,32,0,0,0
2022-06-19 17:15,91,57,34,0,0,0
2022-06-19 17:30,86,61,25,0,0,0
2022-06-19 17:45,89,58,31,0,0,0
2022-06-19 18:00,62,37,25,0,0,0
2022-06-19 18:15,54,34,20,0,0,0
2022-06-19 18:30,68,47,21,0,0,0
2022-06-19 18:45,88,57,31,0,0,0
2022-06-19 19:00,38,27,11,0,0,0
2022-06-19 19:15,59,31,28,0,0,0
2022-06-19 19:30,44,21,23,0,0,0
2022-06-19 19:45,45,23,22,0,0,0
2022-06-19 20:00,46,30,16,0,0,0
2022-06-19 20:15,29,13,16,0,0,0
2022-06-19 20:30,39,22,17,0,0,0
2022-06-19 20:45,25,10,15,0,0,0
2022-06-19 21:00,34,19,15,0,0,0
2022-06-19 21:15,32,11,21,0,0,0
2022-06-19 21:30,33,14,19,0,0,0
2022-06-19 21:45,21,15,6,0,0,0
2022-06-19 22:00,30,19,11,0,0,0
2022-06-19 22:15,15,8,7,0,0,0
2022-06-19 22:30,28,20,8,0,0,0
2022-06-19 22:45,15,10,5,0,0,0
2022-06-19 23:00,9,4,5,0,0,0
2022-06-19 23:15,9,7,2,0,0,0
2022-06-19 23:30,2,1,1,0,0,0
2022-06-19 23:45,2,1,1,0,0,0
2022-06-20 00:00,2,2,0,0,0,0
2022-06-20 00:15,3,1,2,0,0,0
2022-06-20 00:30,4,2,2,0,0,0
2022-06-20 00:45,9,2,7,0,0,0
2022-06-20 01:00,4,3,1,0,0,0
2022-06-20 01:15,1,1,0,0,0,0
2022-06-20 01:30,2,1,1,0,0,0
2022-06-20 01:45,5,3,2,0,0,0
2022-06-20 02:00,0,0,0,0,0,0
2022-06-20 02:15,1,1,0,0,0,0
2022-06-20 02:30,0,0,0,0,0,0
2022-06-20 02:45,0,0,0,0,0,0
2022-06-20 03:00,0,0,0,0,0,0
2022-06-20 03:15,0,0,0,0,0,0
2022-06-20 03:30,0,0,0,0,0,0
2022-06-20 03:45,1,1,0,0,0,0
2022-06-20 04:00,0,0,0,0,0,0
2022-06-20 04:15,4,2,2,0,0,0
2022-06-20 04:30,1,1,0,0,0,0
2022-06-20 04:45,3,2,1,0,0,0
2022-06-20 05:00,2,1,1,0,0,0
2022-06-20 05:15,2,1,1,0,0,0
2022-06-20 05:30,13,9,4,0,0,0
2022-06-20 05:45,14,8,6,0,0,0
2022-06-20 06:00,19,14,5,0,0,0
2022-06-20 06:15,27,18,9,0,0,0
2022-06-20 06:30,50,33,17,0,0,0
2022-06-20 06:45,62,39,23,0,0,0
2022-06-20 07:00,86,62,24,0,0,0
2022-06-20 07:15,161,115,46,0,0,0
2022-06-20 07:30,303,240,63,0,0,0
2022-06-20 07:45,211,164,47,0,0,0
2022-06-20 08:00,161,116,45,0,0,0
2022-06-20 08:15,162,134,28,0,0,0
2022-06-20 08:30,173,112,61,0,0,0
2022-06-20 08:45,140,114,26,0,0,0
2022-06-20 09:00,134,100,34,0,0,0
2022-06-20 09:15,85,63,22,0,0,0
2022-06-20 09:30,108,76,32,0,0,0
2022-06-20 09:45,137,105,32,0,0,0
2022-06-20 10:00,116,89,27,0,0,0
2022-06-20 10:15,111,83,28,0,0,0
2022-06-20 10:30,118,85,33,0,0,0
2022-06-20 10:45,116,73,43,0,0,0
2022-06-20 11:00,101,79,22,0,0,0
2022-06-20 11:15,77,50,27,0,0,0
2022-06-20 11:30,101,71,30,0,0,0
2022-06-20 11:45,144,102,42,0,0,0
2022-06-20 12:00,125,86,39,0,0,0
2022-06-20 12:15,98,51,47,0,0,0
2022-06-20 12:30,128,57,71,0,0,0
2022-06-20 12:45,123,64,59,0,0,0
2022-06-20 13:00,110,69,41,0,0,0
2022-06-20 13:15,129,65,64,0,0,0
2022-06-20 13:30,121,78,43,0,0,0
2022-06-20 13:45,105,63,42,0,0,0
2022-06-20 14:00,129,78,51,0,0,0
2022-06-20 14:15,95,57,38,0,0,0
2022-06-20 14:30,140,86,54,0,0,0
2022-06-20 14:45,115,74,41,0,0,0
2022-06-20 15:00,137,83,54,0,0,0
2022-06-20 15:15,127,76,51,0,0,0
2022-06-20 15:30,137,89,48,0,0,0
2022-06-20 15:45,211,137,74,0,0,0
2022-06-20 16:00,211,133,78,0,0,0
2022-06-20 16:15,182,103,79,0,0,0
2022-06-20 16:30,157,92,65,0,0,0
2022-06-20 16:45,176,109,67,0,0,0
2022-06-20 17:00,150,82,68,0,0,0
2022-06-20 17:15,168,86,82,0,0,0
2022-06-20 17:30,181,104,77,0,0,0
2022-06-20 17:45,173,84,89,0,0,0
2022-06-20 18:00,180,85,95,0,0,0
2022-06-20 18:15,159,72,87,0,0,0
2022-06-20 18:30,120,61,59,0,0,0
2022-06-20 18:45,133,81,52,0,0,0
2022-06-20 19:00,116,53,63,0,0,0
2022-06-20 19:15,95,54,41,0,0,0
2022-06-20 19:30,74,44,30,0,0,0
2022-06-20 19:45,103,52,51,0,0,0
2022-06-20 20:00,74,35,39,0,0,0
2022-06-20 20:15,58,33,25,0,0,0
2022-06-20 20:30,63,31,32,0,0,0
2022-06-20 20:45,50,23,27,0,0,0
2022-06-20 21:00,57,23,34,0,0,0
2022-06-20 21:15,52,29,23,0,0,0
2022-06-20 21:30,54,31,23,0,0,0
2022-06-20 21:45,50,19,31,0,0,0
2022-06-20 22:00,59,26,33,0,0,0
2022-06-20 22:15,37,8,29,0,0,0
2022-06-20 22:30,34,9,25,0,0,0
2022-06-20 22:45,38,21,17,0,0,0
2022-06-20 23:00,28,12,16,0,0,0
2022-06-20 23:15,18,8,10,0,0,0
2022-06-20 23:30,17,11,6,0,0,0
2022-06-20 23:45,10,2,8,0,0,0
2022-06-21 00:00,12,7,5,0,0,0
2022-06-21 00:15,7,3,4,0,0,0
2022-06-21 00:30,0,0,0,0,0,0
2022-06-21 00:45,8,5,3,0,0,0
2022-06-21 01:00,2,1,1,0,0,0
2022-06-21 01:15,4,2,2,0,0,0
2022-06-21 01:30,3,1,2,0,0,0
2022-06-21 01:45,3,1,2,0,0,0
2022-06-21 02:00,6,2,4,0,0,0
2022-06-21 02:15,2,0,2,0,0,0
2022-06-21 02:30,2,1,1,0,0,0
2022-06-21 02:45,2,1,1,0,0,0
2022-06-21 03:00,1,0,1,0,0,0
2022-06-21 03:15,1,0,1,0,0,0
2022-06-21 03:30,0,0,0,0,0,0
2022-06-21 03:45,0,0,0,0,0,0
2022-06-21 04:00,2,1,1,0,0,0
2022-06-21 04:15,3,2,1,0,0,0
2022-06-21 04:30,3,2,1,0,0,0
2022-06-21 04:45,1,1,0,0,0,0
2022-06-21 05:00,2,2,0,0,0,0
2022-06-21 05:15,1,0,1,0,0,0
2022-06-21 05:30,14,10,4,0,0,0
2022-06-21 05:45,22,8,14,0,0,0
2022-06-21 06:00,28,17,11,0,0,0
2022-06-21 06:15,39,23,16,0,0,0
2022-06-21 06:30,69,45,24,0,0,0
2022-06-21 06:45,76,58,18,0,0,0
2022-06-21 07:00,105,72,33,0,0,0
2022-06-21 07:15,163,113,50,0,0,0
2022-06-21 07:30,265,203,62,0,0,0
2022-06-21 07:45,272,208,64,0,0,0
2022-06-21 08:00,195,154,41,0,0,0
2022-06-21 08:15,175,124,51,0,0,0
2022-06-21 08:30,196,144,52,0,0,0
2022-06-21 08:45,186,131,55,0,0,0
2022-06-21 09:00,129,90,39,0,0,0
2022-06-21 09:15,116,77,39,0,0,0
2022-06-21 09:30,124,102,22,0,0,0
2022-06-21 09:45,146,121,25,0,0,0
2022-06-21 10:00,124,94,30,0,0,0
2022-06-21 10:15,115,83,32,0,0,0
2022-06-21 10:30,121,96,25,0,0,0
2022-06-21 10:45,105,74,31,0,0,0
2022-06-21 11:00,121,81,40,0,0,0
2022-06-21 11:15,117,76,41,0,0,0
2022-06-21 11:30,113,69,44,0,0,0
2022-06-21 11:45,149,96,53,0,0,0
2022-06-21 12:00,127,74,53,0,0,0
2022-06-21 12:15,114,71,43,0,0,0
2022-06-21 12:30,139,82,57,0,0,0
2022-06-21 12:45,137,83,54,0,0,0
2022-06-21 13:00,148,76,72,0,0,0
2022-06-21 13:15,147,78,69,0,0,0
2022-06-21 13:30,137,64,73,0,0,0
2022-06-21 13:45,132,78,54,0,0,0
2022-06-21 14:00,138,81,57,0,0,0
2022-06-21 14:15,140,70,70,0,0,0
2022-06-21 14:30,138,89,49,0,0,0
2022-06-21 14:45,168,97,71,0,0,0
2022-06-21 15:00,168,100,68,0,0,0
2022-06-21 15:15,136,85,51,0,0,0
2022-06-21 15:30,183,104,79,0,0,0
2022-06-21 15:45,210,124,86,0,0,0
2022-06-21 16:00,176,97,79,0,0,0
2022-06-21 16:15,188,103,85,0,0,0
2022-06-21 16:30,190,106,84,0,0,0
2022-06-21 16:45,183,102,81,0,0,0
2022-06-21 17:00,184,100,84,0,0,0
2022-06-21 17:15,193,108,85,0,0,0
2022-06-21 17:30,187,107,80,0,0,0
2022-06-21 17:45,209,104,105,0,0,0
2022-06-21 18:00,183,91,92,0,0,0
2022-06-21 18:15,174,89,85,0,0,0
2022-06-21 18:30,158,82,76,0,0,0
2022-06-21 18:45,166,83,83,0,0,0
2022-06-21 19:00,140,72,68,0,0,0
2022-06-21 19:15,140,74,66,0,0,0
2022-06-21 19:30,118,66,52,0,0,0
2022-06-21 19:45,106,48,58,0,0,0
2022-06-21 20:00,88,48,40,0,0,0
2022-06-21 20:15,67,44,23,0,0,0
2022-06-21 20:30,63,28,35,0,0,0
2022-06-21 20:45,87,44,43,0,0,0
2022-06-21 21:00,73,27,46,0,0,0
2022-06-21 21:15,52,22,30,0,0,0
2022-06-21 21:30,69,30,39,0,0,0
2022-06-21 21:45,79,33,46,0,0,0
2022-06-21 22:00,64,23,41,0,0,0
2022-06-21 22:15,60,30,30,0,0,0
2022-06-21 22:30,51,16,35,0,0,0
2022-06-21 22:45,49,25,24,0,0,0
2022-06-21 23:00,40,19,21,0,0,0
2022-06-21 23:15,31,13,18,0,0,0
2022-06-21 23:30,26,15,11,0,0,0
2022-06-21 23:45,33,13,20,0,0,0
2022-06-22 00:00,12,2,10,0,0,0
2022-06-22 00:15,17,12,5,0,0,0
2022-06-22 00:30,5,1,4,0,0,0
2022-06-22 00:45,10,6,4,0,0,0
2022-06-22 01:00,6,2,4,0,0,0
2022-06-22 01:15,3,2,1,0,0,0
2022-06-22 01:30,3,2,1,0,0,0
2022-06-22 01:45,2,2,0,0,0,0
2022-06-22 02:00,1,0,1,0,0,0
2022-06-22 02:15,2,1,1,0,0,0
2022-06-22 02:30,2,2,0,0,0,0
2022-06-22 02:45,3,0,3,0,0,0
2022-06-22 03:00,0,0,0,0,0,0
2022-06-22 03:15,0,0,0,0,0,0
2022-06-22 03:30,0,0,0,0,0,0
2022-06-22 03:45,1,0,1,0,0,0
2022-06-22 04:00,2,2,0,0,0,0
2022-06-22 04:15,3,2,1,0,0,0
2022-06-22 04:30,1,1,0,0,0,0
2022-06-22 04:45,2,0,2,0,0,0
2022-06-22 05:00,1,1,0,0,0,0
2022-06-22 05:15,4,2,2,0,0,0
2022-06-22 05:30,13,10,3,0,0,0
2022-06-22 05:45,23,10,13,0,0,0
2022-06-22 06:00,27,22,5,0,0,0
2022-06-22 06:15,35,24,11,0,0,0
2022-06-22 06:30,59,34,25,0,0,0
2022-06-22 06:45,80,58,22,0,0,0
2022-06-22 07:00,93,68,25,0,0,0
2022-06-22 07:15,164,122,42,0,0,0
2022-06-22 07:30,265,221,44,0,0,0
2022-06-22 07:45,210,160,50,0,0,0
2022-06-22 08:00,192,150,42,0,0,0
2022-06-22 08:15,216,167,49,0,0,0
2022-06-22 08:30,192,143,49,0,0,0
2022-06-22 08:45,211,154,57,0,0,0
2022-06-22 09:00,139,111,28,0,0,0
2022-06-22 09:15,139,109,30,0,0,0
2022-06-22 09:30,147,123,24,0,0,0
2022-06-22 09:45,203,157,46,0,0,0
2022-06-22 10:00,145,109,36,0,0,0
2022-06-22 10:15,153,115,38,0,0,0
2022-06-22 10:30,119,81,38,0,0,0
2022-06-22 10:45,173,129,44,0,0,0
2022-06-22 11:00,109,77,32,0,0,0
2022-06-22 11:15,155,104,51,0,0,0
2022-06-22 11:30,138,83,55,0,0,0
2022-06-22 11:45,158,106,52,0,0,0
2022-06-22 12:00,153,102,51,0,0,0
2022-06-22 12:15,174,106,68,0,0,0
2022-06-22 12:30,158,76,82,0,0,0
2022-06-22 12:45,200,110,90,0,0,0
2022-06-22 13:00,177,86,91,0,0,0
2022-06-22 13:15,136,69,67,0,0,0
2022-06-22 13:30,159,91,68,0,0,0
2022-06-22 13:45,212,137,75,0,0,0
2022-06-22 14:00,149,74,75,0,0,0
2022-06-22 14:15,170,99,71,0,0,0
2022-06-22 14:30,147,80,67,0,0,0
2022-06-22 14:45,173,98,75,0,0,0
2022-06-22 15:00,156,83,73,0,0,0
2022-06-22 15:15,159,92,67,0,0,0
2022-06-22 15:30,147,87,60,0,0,0
2022-06-22 15:45,170,106,64,0,0,0
2022-06-22 16:00,163,94,69,0,0,0
2022-06-22 16:15,187,100,87,0,0,0
2022-06-22 16:30,181,98,83,0,0,0
2022-06-22 16:45,200,114,86,0,0,0
2022-06-22 17:00,181,100,81,0,0,0
2022-06-22 17:15,182,106,76,0,0,0
2022-06-22 17:30,175,97,78,0,0,0
2022-06-22 17:45,218,121,97,0,0,0
2022-06-22 18:00,186,84,102,0,0,0
2022-06-22 18:15,184,93,91,0,0,0
2022-06-22 18:30,124,73,51,0,0,0
2022-06-22 18:45,156,81,75,0,0,0
2022-06-22 19:00,151,79,72,0,0,0
2022-06-22 19:15,135,82,53,0,0,0
2022-06-22 19:30,121,60,61,0,0,0
2022-06-22 19:45,131,73,58,0,0,0
2022-06-22 20:00,124,66,58,0,0,0
2022-06-22 20:15,83,49,34,0,0,0
2022-06-22 20:30,79,35,44,0,0,0
2022-06-22 20:45,74,35,39,0,0,0
2022-06-22 21:00,79,48,31,0,0,0
2022-06-22 21:15,66,40,26,0,0,0
2022-06-22 21:30,87,49,38,0,0,0
2022-06-22 21:45,81,49,32,0,0,0
2022-06-22 22:00,65,22,43,0,0,0
2022-06-22 22:15,73,28,45,0,0,0
2022-06-22 22:30,49,17,32,0,0,0
2022-06-22 22:45,39,20,19,0,0,0
2022-06-22 23:00,64,34,30,0,0,0
2022-06-22 23:15,49,23,26,0,0,0
2022-06-22 23:30,50,14,36,0,0,0
2022-06-22 23:45,20,11,9,0,0,0
2022-06-23 00:00,26,9,17,0,0,0
2022-06-23 00:15,21,10,11,0,0,0
2022-06-23 00:30,22,4,18,0,0,0
2022-06-23 00:45,37,28,9,0,0,0
2022-06-23 01:00,11,4,7,0,0,0
2022-06-23 01:15,9,5,4,0,0,0
2022-06-23 01:30,8,0,8,0,0,0
2022-06-23 01:45,5,1,4,0,0,0
2022-06-23 02:00,2,0,2,0,0,0
2022-06-23 02:15,7,2,5,0,0,0
2022-06-23 02:30,6,4,2,0,0,0
2022-06-23 02:45,2,0,2,0,0,0
2022-06-23 03:00,1,0,1,0,0,0
2022-06-23 03:15,5,0,5,0,0,0
2022-06-23 03:30,0,0,0,0,0,0
2022-06-23 03:45,4,3,1,0,0,0
2022-06-23 04:00,0,0,0,0,0,0
2022-06-23 04:15,6,2,4,0,0,0
2022-06-23 04:30,1,0,1,0,0,0
2022-06-23 04:45,1,0,1,0,0,0
2022-06-23 05:00,5,4,1,0,0,0
2022-06-23 05:15,4,3,1,0,0,0
2022-06-23 05:30,19,11,8,0,0,0
2022-06-23 05:45,15,8,7,0,0,0
2022-06-23 06:00,23,15,8,0,0,0
2022-06-23 06:15,47,28,19,0,0,0
2022-06-23 06:30,67,48,19,0,0,0
2022-06-23 06:45,68,51,17,0,0,0
2022-06-23 07:00,86,59,27,0,0,0
2022-06-23 07:15,126,85,41,0,0,0
2022-06-23 07:30,242,197,45,0,0,0
2022-06-23 07:45,208,171,37,0,0,0
2022-06-23 08:00,192,157,35,0,0,0
2022-06-23 08:15,153,117,36,0,0,0
2022-06-23 08:30,201,154,47,0,0,0
2022-06-23 08:45,197,156,41,0,0,0
2022-06-23 09:00,137,110,27,0,0,0
2022-06-23 09:15,126,97,29,0,0,0
2022-06-23 09:30,132,99,33,0,0,0
2022-06-23 09:45,189,150,39,0,0,0
2022-06-23 10:00,131,92,39,0,0,0
2022-06-23 10:15,80,53,27,0,0,0
2022-06-23 10:30,102,71,31,0,0,0
2022-06-23 10:45,119,79,40,0,0,0
2022-06-23 11:00,98,51,47,0,0,0
2022-06-23 11:15,133,75,58,0,0,0
2022-06-23 11:30,129,75,54,0,0,0
2022-06-23 11:45,157,100,57,0,0,0
2022-06-23 12:00,145,82,63,0,0,0
2022-06-23 12:15,144,83,61,0,0,0
2022-06-23 12:30,164,98,66,0,0,0
2022-06-23 12:45,145,72,73,0,0,0
2022-06-23 13:00,149,65,84,0,0,0
2022-06-23 13:15,147,79,68,0,0,0
2022-06-23 13:30,129,61,68,0,0,0
2022-06-23 13:45,148,83,65,0,0,0
2022-06-23 14:00,136,73,63,0,0,0
2022-06-23 14:15,157,77,80,0,0,0
2022-06-23 14:30,131,62,69,0,0,0
2022-06-23 14:45,183,87,96,0,0,0
2022-06-23 15:00,151,78,73,0,0,0
2022-06-23 15:15,170,102,68,0,0,0
2022-06-23 15:30,161,85,76,0,0,0
2022-06-23 15:45,195,112,83,0,0,0
2022-06-23 16:00,216,104,112,0,0,0
2022-06-23 16:15,205,101,104,0,0,0
2022-06-23 16:30,184,82,102,0,0,0
2022-06-23 16:45,202,114,88,0,0,0
2022-06-23 17:00,187,86,101,0,0,0
2022-06-23 17:15,173,89,84,0,0,0
2022-06-23 17:30,194,98,96,0,0,0
2022-06-23 17:45,215,113,102,0,0,0
2022-06-23 18:00,192,100,92,0,0,0
2022-06-23 18:15,215,109,106,0,0,0
2022-06-23 18:30,179,98,81,0,0,0
2022-06-23 18:45,184,111,73,0,0,0
2022-06-23 19:00,156,95,61,0,0,0
2022-06-23 19:15,152,87,65,0,0,0
2022-06-23 19:30,135,92,43,0,0,0
2022-06-23 19:45,130,80,50,0,0,0
2022-06-23 20:00,103,52,51,0,0,0
2022-06-23 20:15,111,68,43,0,0,0
2022-06-23 20:30,79,42,37,0,0,0
2022-06-23 20:45,90,52,38,0,0,0
2022-06-23 21:00,98,60,38,0,0,0
2022-06-23 21:15,57,34,23,0,0,0
2022-06-23 21:30,84,47,37,0,0,0
2022-06-23 21:45,76,38,38,0,0,0
2022-06-23 22:00,74,38,36,0,0,0
2022-06-23 22:15,92,50,42,0,0,0
2022-06-23 22:30,78,40,38,0,0,0
2022-06-23 22:45,76,44,32,0,0,0
2022-06-23 23:00,66,38,28,0,0,0
2022-06-23 23:15,50,21,29,0,0,0
2022-06-23 23:30,40,20,20,0,0,0
2022-06-23 23:45,23,12,11,0,0,0
2022-06-24 00:00,25,12,13,0,0,0
2022-06-24 00:15,36,14,22,0,0,0
2022-06-24 00:30,17,7,10,0,0,0
2022-06-24 00:45,21,6,15,0,0,0
2022-06-24 01:00,14,4,10,0,0,0
2022-06-24 01:15,10,3,7,0,0,0
2022-06-24 01:30,8,3,5,0,0,0
2022-06-24 01:45,6,2,4,0,0,0
2022-06-24 02:00,13,4,9,0,0,0
2022-06-24 02:15,7,3,4,0,0,0
2022-06-24 02:30,2,2,0,0,0,0
2022-06-24 02:45,3,1,2,0,0,0
2022-06-24 03:00,0,0,0,0,0,0
2022-06-24 03:15,2,1,1,0,0,0
2022-06-24 03:30,0,0,0,0,0,0
2022-06-24 03:45,3,1,2,0,0,0
2022-06-24 04:00,1,0,1,0,0,0
2022-06-24 04:15,3,3,0,0,0,0
2022-06-24 04:30,1,0,1,0,0,0
2022-06-24 04:45,2,0,2,0,0,0
2022-06-24 05:00,3,2,1,0,0,0
2022-06-24 05:15,7,3,4,0,0,0
2022-06-24 05:30,14,10,4,0,0,0
2022-06-24 05:45,16,6,10,0,0,0
2022-06-24 06:00,18,16,2,0,0,0
2022-06-24 06:15,30,20,10,0,0,0
2022-06-24 06:30,36,21,15,0,0,0
2022-06-24 06:45,42,32,10,0,0,0
2022-06-24 07:00,63,41,22,0,0,0
2022-06-24 07:15,111,86,25,0,0,0
2022-06-24 07:30,207,180,27,0,0,0
2022-06-24 07:45,161,117,44,0,0,0
2022-06-24 08:00,77,57,20,0,0,0
2022-06-24 08:15,94,72,22,0,0,0
2022-06-24 08:30,87,66,21,0,0,0
2022-06-24 08:45,95,74,21,0,0,0
2022-06-24 09:00,71,53,18,0,0,0
2022-06-24 09:15,56,41,15,0,0,0
2022-06-24 09:30,84,68,16,0,0,0
2022-06-24 09:45,98,82,16,0,0,0
2022-06-24 10:00,98,64,34,0,0,0
2022-06-24 10:15,105,58,47,0,0,0
2022-06-24 10:30,83,36,47,0,0,0
2022-06-24 10:45,115,66,49,0,0,0
2022-06-24 11:00,92,60,32,0,0,0
2022-06-24 11:15,104,69,35,0,0,0
2022-06-24 11:30,118,68,50,0,0,0
2022-06-24 11:45,120,69,51,0,0,0
2022-06-24 12:00,129,85,44,0,0,0
2022-06-24 12:15,117,81,36,0,0,0
2022-06-24 12:30,113,61,52,0,0,0
2022-06-24 12:45,111,57,54,0,0,0
2022-06-24 13:00,123,64,59,0,0,0
2022-06-24 13:15,110,63,47,0,0,0
2022-06-24 13:30,101,64,37,0,0,0
2022-06-24 13:45,110,71,39,0,0,0
2022-06-24 14:00,122,75,47,0,0,0
2022-06-24 14:15,133,79,54,0,0,0
2022-06-24 14:30,131,78,53,0,0,0
2022-06-24 14:45,143,84,59,0,0,0
2022-06-24 15:00,131,76,55,0,0,0
2022-06-24 15:15,148,82,66,0,0,0
2022-06-24 15:30,118,73,45,0,0,0
2022-06-24 15:45,118,67,51,0,0,0
2022-06-24 16:00,114,67,47,0,0,0
2022-06-24 16:15,149,99,50,0,0,0
2022-06-24 16:30,114,65,49,0,0,0
2022-06-24 16:45,139,91,48,0,0,0
2022-06-24 17:00,121,62,59,0,0,0
2022-06-24 17:15,137,87,50,0,0,0
2022-06-24 17:30,101,55,46,0,0,0
2022-06-24 17:45,128,71,57,0,0,0
2022-06-24 18:00,126,67,59,0,0,0
2022-06-24 18:15,130,64,66,0,0,0
2022-06-24 18:30,126,80,46,0,0,0
2022-06-24 18:45,124,77,47,0,0,0
2022-06-24 19:00,112,50,62,0,0,0
2022-06-24 19:15,100,56,44,0,0,0
2022-06-24 19:30,93,64,29,0,0,0
2022-06-24 19:45,95,55,40,0,0,0
2022-06-24 20:00,66,35,31,0,0,0
2022-06-24 20:15,92,36,56,0,0,0
2022-06-24 20:30,73,33,40,0,0,0
2022-06-24 20:45,42,18,24,0,0,0
2022-06-24 21:00,68,35,33,0,0,0
2022-06-24 21:15,50,20,30,0,0,0
2022-06-24 21:30,47,27,20,0,0,0
2022-06-24 21:45,42,25,17,0,0,0
2022-06-24 22:00,36,8,28,0,0,0
2022-06-24 22:15,43,8,35,0,0,0
2022-06-24 22:30,46,21,25,0,0,0
2022-06-24 22:45,36,15,21,0,0,0
2022-06-24 23:00,41,11,30,0,0,0
2022-06-24 23:15,27,15,12,0,0,0
2022-06-24 23:30,35,20,15,0,0,0
2022-06-24 23:45,31,12,19,0,0,0
2022-06-25 00:00,27,12,15,0,0,0
2022-06-25 00:15,38,21,17,0,0,0
2022-06-25 00:30,25,12,13,0,0,0
2022-06-25 00:45,24,11,13,0,0,0
2022-06-25 01:00,19,7,12,0,0,0
2022-06-25 01:15,22,12,10,0,0,0
2022-06-25 01:30,13,2,11,0,0,0
2022-06-25 01:45,8,1,7,0,0,0
2022-06-25 02:00,17,2,15,0,0,0
2022-06-25 02:15,16,5,11,0,0,0
2022-06-25 02:30,7,2,5,0,0,0
2022-06-25 02:45,9,3,6,0,0,0
2022-06-25 03:00,9,3,6,0,0,0
2022-06-25 03:15,18,9,9,0,0,0
2022-06-25 03:30,6,1,5,0,0,0
2022-06-25 03:45,8,3,5,0,0,0
2022-06-25 04:00,2,0,2,0,0,0
2022-06-25 04:15,4,1,3,0,0,0
2022-06-25 04:30,1,1,0,0,0,0
2022-06-25 04:45,0,0,0,0,0,0
2022-06-25 05:00,2,1,1,0,0,0
2022-06-25 05:15,4,1,3,0,0,0
2022-06-25 05:30,6,4,2,0,0,0
2022-06-25 05:45,15,8,7,0,0,0
2022-06-25 06:00,8,6,2,0,0,0
2022-06-25 06:15,6,6,0,0,0,0
2022-06-25 06:30,16,12,4,0,0,0
2022-06-25 06:45,17,13,4,0,0,0
2022-06-25 07:00,17,15,2,0,0,0
2022-06-25 07:15,19,14,5,0,0,0
2022-06-25 07:30,29,20,9,0,0,0
2022-06-25 07:45,34,25,9,0,0,0
2022-06-25 08:00,44,34,10,0,0,0
2022-06-25 08:15,47,31,16,0,0,0
2022-06-25 08:30,47,33,14,0,0,0
2022-06-25 08:45,71,50,21,0,0,0
2022-06-25 09:00,61,52,9,0,0,0
2022-06-25 09:15,96,77,19,0,0,0
2022-06-25 09:30,112,82,30,0,0,0
2022-06-25 09:45,127,109,18,0,0,0
2022-06-25 10:00,142,106,36,0,0,0
2022-06-25 10:15,156,120,36,0,0,0
2022-06-25 10:30,135,106,29,0,0,0
2022-06-25 10:45,137,106,31,0,0,0
2022-06-25 11:00,122,94,28,0,0,0
2022-06-25 11:15,178,116,62,0,0,0
2022-06-25 11:30,122,85,37,0,0,0
2022-06-25 11:45,181,121,60,0,0,0
2022-06-25 12:00,140,104,36,0,0,0
2022-06-25 12:15,155,93,62,0,0,0
2022-06-25 12:30,168,93,75,0,0,0
2022-06-25 12:45,166,78,88,0,0,0
2022-06-25 13:00,185,102,83,0,0,0
2022-06-25 13:15,150,74,76,0,0,0
2022-06-25 13:30,158,91,67,0,0,0
2022-06-25 13:45,129,86,43,0,0,0
2022-06-25 14:00,165,84,81,0,0,0
2022-06-25 14:15,157,88,69,0,0,0
2022-06-25 14:30,143,70,73,0,0,0
2022-06-25 14:45,157,71,86,0,0,0
2022-06-25 15:00,141,78,63,0,0,0
2022-06-25 15:15,128,68,60,0,0,0
2022-06-25 15:30,111,58,53,0,0,0
2022-06-25 15:45,138,73,65,0,0,0
2022-06-25 16:00,107,47,60,0,0,0
2022-06-25 16:15,134,61,73,0,0,0
2022-06-25 16:30,120,56,64,0,0,0
2022-06-25 16:45,97,54,43,0,0,0
2022-06-25 17:00,128,63,65,0,0,0
2022-06-25 17:15,102,53,49,0,0,0
2022-06-25 17:30,91,45,46,0,0,0
2022-06-25 17:45,115,72,43,0,0,0
2022-06-25 18:00,105,68,37,0,0,0
2022-06-25 18:15,117,68,49,0,0,0
2022-06-25 18:30,105,58,47,0,0,0
2022-06-25 18:45,134,87,47,0,0,0
2022-06-25 19:00,135,82,53,0,0,0
2022-06-25 19:15,97,60,37,0,0,0
2022-06-25 19:30,87,52,35,0,0,0
2022-06-25 19:45,101,60,41,0,0,0
2022-06-25 20:00,77,42,35,0,0,0
2022-06-25 20:15,71,49,22,0,0,0
2022-06-25 20:30,82,47,35,0,0,0
2022-06-25 20:45,52,25,27,0,0,0
2022-06-25 21:00,69,36,33,0,0,0
2022-06-25 21:15,54,37,17,0,0,0
2022-06-25 21:30,45,26,19,0,0,0
2022-06-25 21:45,46,26,20,0,0,0
2022-06-25 22:00,44,25,19,0,0,0
2022-06-25 22:15,45,25,20,0,0,0
2022-06-25 22:30,38,25,13,0,0,0
2022-06-25 22:45,35,19,16,0,0,0
2022-06-25 23:00,36,18,18,0,0,0
2022-06-25 23:15,56,33,23,0,0,0
2022-06-25 23:30,79,34,45,0,0,0
2022-06-25 23:45,27,21,6,0,0,0
2022-06-26 00:00,37,17,20,0,0,0
2022-06-26 00:15,37,17,20,0,0,0
2022-06-26 00:30,28,11,17,0,0,0
2022-06-26 00:45,32,22,10,0,0,0
2022-06-26 01:00,30,14,16,0,0,0
2022-06-26 01:15,16,7,9,0,0,0
2022-06-26 01:30,13,4,9,0,0,0
2022-06-26 01:45,15,4,11,0,0,0
2022-06-26 02:00,20,9,11,0,0,0
2022-06-26 02:15,8,3,5,0,0,0
2022-06-26 02:30,11,4,7,0,0,0
2022-06-26 02:45,7,2,5,0,0,0
2022-06-26 03:00,3,0,3,0,0,0
2022-06-26 03:15,8,3,5,0,0,0
2022-06-26 03:30,4,0,4,0,0,0
2022-06-26 03:45,9,4,5,0,0,0
2022-06-26 04:00,8,2,6,0,0,0
2022-06-26 04:15,6,1,5,0,0,0
2022-06-26 04:30,4,0,4,0,0,0
2022-06-26 04:45,2,1,1,0,0,0
2022-06-26 05:00,1,0,1,0,0,0
2022-06-26 05:15,2,0,2,0,0,0
2022-06-26 05:30,4,3,1,0,0,0
2022-06-26 05:45,9,5,4,0,0,0
2022-06-26 06:00,7,4,3,0,0,0
2022-06-26 06:15,12,6,6,0,0,0
2022-06-26 06:30,11,7,4,0,0,0
2022-06-26 06:45,7,4,3,0,0,0
2022-06-26 07:00,5,3,2,0,0,0
2022-06-26 07:15,12,7,5,0,0,0
2022-06-26 07:30,7,5,2,0,0,0
2022-06-26 07:45,23,12,11,0,0,0
2022-06-26 08:00,14,9,5,0,0,0
2022-06-26 08:15,15,7,8,0,0,0
2022-06-26 08:30,19,14,5,0,0,0
2022-06-26 08:45,19,12,7,0,0,0
2022-06-26 09:00,24,12,12,0,0,0
2022-06-26 09:15,28,23,5,0,0,0
2022-06-26 09:30,45,32,13,0,0,0
2022-06-26 09:45,73,48,25,0,0,0
2022-06-26 10:00,52,41,11,0,0,0
2022-06-26 10:15,58,34,24,0,0,0
2022-06-26 10:30,55,41,14,0,0,0
2022-06-26 10:45,42,29,13,0,0,0
2022-06-26 11:00,55,38,17,0,0,0
2022-06-26 11:15,76,47,29,0,0,0
2022-06-26 11:30,57,32,25,0,0,0
2022-06-26 11:45,74,44,30,0,0,0
2022-06-26 12:00,53,32,21,0,0,0
2022-06-26 12:15,50,36,14,0,0,0
2022-06-26 12:30,68,42,26,0,0,0
2022-06-26 12:45,67,39,28,0,0,0
2022-06-26 13:00,67,32,35,0,0,0
2022-06-26 13:15,61,44,17,0,0,0
2022-06-26 13:30,87,59,28,0,0,0
2022-06-26 13:45,64,44,20,0,0,0
2022-06-26 14:00,62,38,24,0,0,0
2022-06-26 14:15,65,43,22,0,0,0
2022-06-26 14:30,76,39,37,0,0,0
2022-06-26 14:45,79,50,29,0,0,0
2022-06-26 15:00,105,63,42,0,0,0
2022-06-26 15:15,85,57,28,0,0,0
2022-06-26 15:30,84,53,31,0,0,0
2022-06-26 15:45,82,53,29,0,0,0
2022-06-26 16:00,55,31,24,0,0,0
2022-06-26 16:15,81,50,31,0,0,0
2022-06-26 16:30,68,36,32,0,0,0
2022-06-26 16:45,71,49,22,0,0,0
2022-06-26 17:00,72,50,22,0,0,0
2022-06-26 17:15,72,47,25,0,0,0
2022-06-26 17:30,82,58,24,0,0,0
2022-06-26 17:45,110,64,46,0,0,0
2022-06-26 18:00,84,43,41,0,0,0
2022-06-26 18:15,60,33,27,0,0,0
2022-06-26 18:30,60,27,33,0,0,0
2022-06-26 18:45,63,36,27,0,0,0
2022-06-26 19:00,72,41,31,0,0,0
2022-06-26 19:15,53,31,22,0,0,0
2022-06-26 19:30,53,30,23,0,0,0
2022-06-26 19:45,43,25,18,0,0,0
2022-06-26 20:00,53,25,28,0,0,0
2022-06-26 20:15,46,22,24,0,0,0
2022-06-26 20:30,44,27,17,0,0,0
2022-06-26 20:45,40,19,21,0,0,0
2022-06-26 21:00,47,23,24,0,0,0
2022-06-26 21:15,29,20,9,0,0,0
2022-06-26 21:30,29,15,14,0,0,0
2022-06-26 21:45,15,6,9,0,0,0
2022-06-26 22:00,25,10,15,0,0,0
2022-06-26 22:15,15,4,11,0,0,0
2022-06-26 22:30,15,7,8,0,0,0
2022-06-26 22:45,19,7,12,0,0,0
2022-06-26 23:00,10,6,4,0,0,0
2022-06-26 23:15,11,3,8,0,0,0
2022-06-26 23:30,16,10,6,0,0,0
2022-06-26 23:45,11,5,6,0,0,0
2022-06-27 00:00,8,1,7,0,0,0
2022-06-27 00:15,3,1,2,0,0,0
2022-06-27 00:30,6,3,3,0,0,0
2022-06-27 00:45,7,6,1,0,0,0
2022-06-27 01:00,3,1,2,0,0,0
2022-06-27 01:15,5,1,4,0,0,0
2022-06-27 01:30,0,0,0,0,0,0
2022-06-27 01:45,2,2,0,0,0,0
2022-06-27 02:00,0,0,0,0,0,0
2022-06-27 02:15,2,0,2,0,0,0
2022-06-27 02:30,1,0,1,0,0,0
2022-06-27 02:45,2,1,1,0,0,0
2022-06-27 03:00,1,0,1,0,0,0
2022-06-27 03:15,0,0,0,0,0,0
2022-06-27 03:30,1,0,1,0,0,0
2022-06-27 03:45,2,1,1,0,0,0
2022-06-27 04:00,0,0,0,0,0,0
2022-06-27 04:15,4,2,2,0,0,0
2022-06-27 04:30,3,2,1,0,0,0
2022-06-27 04:45,0,0,0,0,0,0
2022-06-27 05:00,1,0,1,0,0,0
2022-06-27 05:15,0,0,0,0,0,0
2022-06-27 05:30,6,4,2,0,0,0
2022-06-27 05:45,19,10,9,0,0,0
2022-06-27 06:00,19,15,4,0,0,0
2022-06-27 06:15,32,22,10,0,0,0
2022-06-27 06:30,35,22,13,0,0,0
2022-06-27 06:45,56,39,17,0,0,0
2022-06-27 07:00,83,55,28,0,0,0
2022-06-27 07:15,89,63,26,0,0,0
2022-06-27 07:30,136,107,29,0,0,0
2022-06-27 07:45,173,128,45,0,0,0
2022-06-27 08:00,143,110,33,0,0,0
2022-06-27 08:15,149,101,48,0,0,0
2022-06-27 08:30,132,102,30,0,0,0
2022-06-27 08:45,170,128,42,0,0,0
2022-06-27 09:00,120,95,25,0,0,0
2022-06-27 09:15,90,74,16,0,0,0
2022-06-27 09:30,98,78,20,0,0,0
2022-06-27 09:45,131,102,29,0,0,0
2022-06-27 10:00,130,97,33,0,0,0
2022-06-27 10:15,99,77,22,0,0,0
2022-06-27 10:30,105,70,35,0,0,0
2022-06-27 10:45,104,84,20,0,0,0
2022-06-27 11:00,81,59,22,0,0,0
2022-06-27 11:15,82,58,24,0,0,0
2022-06-27 11:30,93,64,29,0,0,0
2022-06-27 11:45,119,87,32,0,0,0
2022-06-27 12:00,103,66,37,0,0,0
2022-06-27 12:15,95,64,31,0,0,0
2022-06-27 12:30,105,68,37,0,0,0
2022-06-27 12:45,100,65,35,0,0,0
2022-06-27 13:00,97,47,50,0,0,0
2022-06-27 13:15,94,61,33,0,0,0
2022-06-27 13:30,100,59,41,0,0,0
2022-06-27 13:45,123,77,46,0,0,0
2022-06-27 14:00,116,58,58,0,0,0
2022-06-27 14:15,108,67,41,0,0,0
2022-06-27 14:30,129,76,53,0,0,0
2022-06-27 14:45,132,84,48,0,0,0
2022-06-27 15:00,112,66,46,0,0,0
2022-06-27 15:15,124,70,54,0,0,0
2022-06-27 15:30,144,92,52,0,0,0
2022-06-27 15:45,171,104,67,0,0,0
2022-06-27 16:00,167,100,67,0,0,0
2022-06-27 16:15,181,107,74,0,0,0
2022-06-27 16:30,145,82,63,0,0,0
2022-06-27 16:45,146,66,80,0,0,0
2022-06-27 17:00,156,73,83,0,0,0
2022-06-27 17:15,171,96,75,0,0,0
2022-06-27 17:30,154,80,74,0,0,0
2022-06-27 17:45,196,105,91,0,0,0
2022-06-27 18:00,141,75,66,0,0,0
2022-06-27 18:15,132,74,58,0,0,0
2022-06-27 18:30,55,28,27,0,0,0
2022-06-27 18:45,108,45,63,0,0,0
2022-06-27 19:00,118,53,65,0,0,0
2022-06-27 19:15,94,46,48,0,0,0
2022-06-27 19:30,95,50,45,0,0,0
2022-06-27 19:45,85,36,49,0,0,0
2022-06-27 20:00,70,29,41,0,0,0
2022-06-27 20:15,55,26,29,0,0,0
2022-06-27 20:30,49,21,28,0,0,0
2022-06-27 20:45,57,29,28,0,0,0
2022-06-27 21:00,54,27,27,0,0,0
2022-06-27 21:15,41,17,24,0,0,0
2022-06-27 21:30,49,17,32,0,0,0
2022-06-27 21:45,34,15,19,0,0,0
2022-06-27 22:00,40,20,20,0,0,0
2022-06-27 22:15,33,22,11,0,0,0
2022-06-27 22:30,37,19,18,0,0,0
2022-06-27 22:45,22,10,12,0,0,0
2022-06-27 23:00,44,26,18,0,0,0
2022-06-27 23:15,18,8,10,0,0,0
2022-06-27 23:30,17,13,4,0,0,0
2022-06-27 23:45,16,5,11,0,0,0
2022-06-28 00:00,12,5,7,0,0,0
2022-06-28 00:15,8,5,3,0,0,0
2022-06-28 00:30,6,1,5,0,0,0
2022-06-28 00:45,2,0,2,0,0,0
2022-06-28 01:00,1,0,1,0,0,0
2022-06-28 01:15,9,1,8,0,0,0
2022-06-28 01:30,8,0,8,0,0,0
2022-06-28 01:45,1,1,0,0,0,0
2022-06-28 02:00,0,0,0,0,0,0
2022-06-28 02:15,3,0,3,0,0,0
2022-06-28 02:30,2,2,0,0,0,0
2022-06-28 02:45,0,0,0,0,0,0
2022-06-28 03:00,0,0,0,0,0,0
2022-06-28 03:15,1,0,1,0,0,0
2022-06-28 03:30,0,0,0,0,0,0
2022-06-28 03:45,1,1,0,0,0,0
2022-06-28 04:00,0,0,0,0,0,0
2022-06-28 04:15,4,2,2,0,0,0
2022-06-28 04:30,1,0,1,0,0,0
2022-06-28 04:45,2,2,0,0,0,0
2022-06-28 05:00,2,2,0,0,0,0
2022-06-28 05:15,6,4,2,0,0,0
2022-06-28 05:30,13,8,5,0,0,0
2022-06-28 05:45,13,8,5,0,0,0
2022-06-28 06:00,18,13,5,0,0,0
2022-06-28 06:15,35,27,8,0,0,0
2022-06-28 06:30,44,30,14,0,0,0
2022-06-28 06:45,65,47,18,0,0,0
2022-06-28 07:00,84,58,26,0,0,0
2022-06-28 07:15,107,79,28,0,0,0
2022-06-28 07:30,128,94,34,0,0,0
2022-06-28 07:45,182,134,48,0,0,0
2022-06-28 08:00,151,124,27,0,0,0
2022-06-28 08:15,163,131,32,0,0,0
2022-06-28 08:30,133,97,36,0,0,0
2022-06-28 08:45,181,139,42,0,0,0
2022-06-28 09:00,115,95,20,0,0,0
2022-06-28 09:15,128,97,31,0,0,0
2022-06-28 09:30,112,89,23,0,0,0
2022-06-28 09:45,160,122,38,0,0,0
2022-06-28 10:00,147,118,29,0,0,0
2022-06-28 10:15,132,93,39,0,0,0
2022-06-28 10:30,122,88,34,0,0,0
2022-06-28 10:45,139,101,38,0,0,0
2022-06-28 11:00,96,66,30,0,0,0
2022-06-28 11:15,115,82,33,0,0,0
2022-06-28 11:30,121,76,45,0,0,0
2022-06-28 11:45,125,81,44,0,0,0
2022-06-28 12:00,124,70,54,0,0,0
2022-06-28 12:15,117,76,41,0,0,0
2022-06-28 12:30,121,68,53,0,0,0
2022-06-28 12:45,138,81,57,0,0,0
2022-06-28 13:00,114,68,46,0,0,0
2022-06-28 13:15,128,82,46,0,0,0
2022-06-28 13:30,144,95,49,0,0,0
2022-06-28 13:45,151,85,66,0,0,0
2022-06-28 14:00,148,93,55,0,0,0
2022-06-28 14:15,133,72,61,0,0,0
2022-06-28 14:30,120,77,43,0,0,0
2022-06-28 14:45,165,85,80,0,0,0
2022-06-28 15:00,163,97,66,0,0,0
2022-06-28 15:15,148,80,68,0,0,0
2022-06-28 15:30,158,95,63,0,0,0
2022-06-28 15:45,194,104,90,0,0,0
2022-06-28 16:00,177,100,77,0,0,0
2022-06-28 16:15,182,90,92,0,0,0
2022-06-28 16:30,201,110,91,0,0,0
2022-06-28 16:45,189,94,95,0,0,0
2022-06-28 17:00,159,103,56,0,0,0
2022-06-28 17:15,206,95,111,0,0,0
2022-06-28 17:30,175,82,93,0,0,0
2022-06-28 17:45,220,116,104,0,0,0
2022-06-28 18:00,178,90,88,0,0,0
2022-06-28 18:15,170,85,85,0,0,0
2022-06-28 18:30,143,63,80,0,0,0
2022-06-28 18:45,161,75,86,0,0,0
2022-06-28 19:00,121,68,53,0,0,0
2022-06-28 19:15,129,59,70,0,0,0
2022-06-28 19:30,103,52,51,0,0,0
2022-06-28 19:45,123,52,71,0,0,0
2022-06-28 20:00,77,38,39,0,0,0
2022-06-28 20:15,85,39,46,0,0,0
2022-06-28 20:30,70,30,40,0,0,0
2022-06-28 20:45,74,29,45,0,0,0
2022-06-28 21:00,65,28,37,0,0,0
2022-06-28 21:15,52,28,24,0,0,0
2022-06-28 21:30,66,38,28,0,0,0
2022-06-28 21:45,41,20,21,0,0,0
2022-06-28 22:00,64,28,36,0,0,0
2022-06-28 22:15,60,30,30,0,0,0
2022-06-28 22:30,67,30,37,0,0,0
2022-06-28 22:45,39,23,16,0,0,0
2022-06-28 23:00,45,21,24,0,0,0
2022-06-28 23:15,30,9,21,0,0,0
2022-06-28 23:30,28,18,10,0,0,0
2022-06-28 23:45,25,14,11,0,0,0
2022-06-29 00:00,15,9,6,0,0,0
2022-06-29 00:15,11,2,9,0,0,0
2022-06-29 00:30,15,2,13,0,0,0
2022-06-29 00:45,9,6,3,0,0,0
2022-06-29 01:00,9,5,4,0,0,0
2022-06-29 01:15,13,8,5,0,0,0
2022-06-29 01:30,2,1,1,0,0,0
2022-06-29 01:45,5,1,4,0,0,0
2022-06-29 02:00,1,0,1,0,0,0
2022-06-29 02:15,1,1,0,0,0,0
2022-06-29 02:30,1,0,1,0,0,0
2022-06-29 02:45,5,2,3,0,0,0
2022-06-29 03:00,1,0,1,0,0,0
2022-06-29 03:15,1,0,1,0,0,0
2022-06-29 03:30,1,1,0,0,0,0
2022-06-29 03:45,3,2,1,0,0,0
2022-06-29 04:00,4,2,2,0,0,0
2022-06-29 04:15,2,1,1,0,0,0
2022-06-29 04:30,1,1,0,0,0,0
2022-06-29 04:45,0,0,0,0,0,0
2022-06-29 05:00,0,0,0,0,0,0
2022-06-29 05:15,10,8,2,0,0,0
2022-06-29 05:30,13,8,5,0,0,0
2022-06-29 05:45,24,16,8,0,0,0
2022-06-29 06:00,21,14,7,0,0,0
2022-06-29 06:15,32,20,12,0,0,0
2022-06-29 06:30,56,40,16,0,0,0
2022-06-29 06:45,66,53,13,0,0,0
2022-06-29 07:00,101,68,33,0,0,0
2022-06-29 07:15,135,93,42,0,0,0
2022-06-29 07:30,134,99,35,0,0,0
2022-06-29 07:45,186,145,41,0,0,0
2022-06-29 08:00,151,123,28,0,0,0
2022-06-29 08:15,194,147,47,0,0,0
2022-06-29 08:30,143,110,33,0,0,0
2022-06-29 08:45,181,138,43,0,0,0
2022-06-29 09:00,147,109,38,0,0,0
2022-06-29 09:15,114,99,15,0,0,0
2022-06-29 09:30,147,124,23,0,0,0
2022-06-29 09:45,187,151,36,0,0,0
2022-06-29 10:00,152,130,22,0,0,0
2022-06-29 10:15,128,88,40,0,0,0
2022-06-29 10:30,123,84,39,0,0,0
2022-06-29 10:45,131,88,43,0,0,0
2022-06-29 11:00,133,92,41,0,0,0
2022-06-29 11:15,122,77,45,0,0,0
2022-06-29 11:30,125,86,39,0,0,0
2022-06-29 11:45,145,100,45,0,0,0
2022-06-29 12:00,135,83,52,0,0,0
2022-06-29 12:15,137,74,63,0,0,0
2022-06-29 12:30,144,87,57,0,0,0
2022-06-29 12:45,146,82,64,0,0,0
2022-06-29 13:00,145,75,70,0,0,0
2022-06-29 13:15,142,78,64,0,0,0
2022-06-29 13:30,150,103,47,0,0,0
2022-06-29 13:45,201,110,91,0,0,0
2022-06-29 14:00,138,69,69,0,0,0
2022-06-29 14:15,159,86,73,0,0,0
2022-06-29 14:30,156,95,61,0,0,0
2022-06-29 14:45,143,94,49,0,0,0
2022-06-29 15:00,119,75,44,0,0,0
2022-06-29 15:15,152,83,69,0,0,0
2022-06-29 15:30,135,66,69,0,0,0
2022-06-29 15:45,174,95,79,0,0,0
2022-06-29 16:00,174,94,80,0,0,0
2022-06-29 16:15,165,84,81,0,0,0
2022-06-29 16:30,167,89,78,0,0,0
2022-06-29 16:45,159,78,81,0,0,0
2022-06-29 17:00,169,93,76,0,0,0
2022-06-29 17:15,180,87,93,0,0,0
2022-06-29 17:30,175,90,85,0,0,0
2022-06-29 17:45,182,91,91,0,0,0
2022-06-29 18:00,170,86,84,0,0,0
2022-06-29 18:15,146,80,66,0,0,0
2022-06-29 18:30,152,62,90,0,0,0
2022-06-29 18:45,138,80,58,0,0,0
2022-06-29 19:00,152,80,72,0,0,0
2022-06-29 19:15,108,60,48,0,0,0
2022-06-29 19:30,99,40,59,0,0,0
2022-06-29 19:45,107,47,60,0,0,0
2022-06-29 20:00,80,38,42,0,0,0
2022-06-29 20:15,76,41,35,0,0,0
2022-06-29 20:30,65,29,36,0,0,0
2022-06-29 20:45,59,25,34,0,0,0
2022-06-29 21:00,60,28,32,0,0,0
2022-06-29 21:15,76,44,32,0,0,0
2022-06-29 21:30,49,25,24,0,0,0
2022-06-29 21:45,54,26,28,0,0,0
2022-06-29 22:00,55,21,34,0,0,0
2022-06-29 22:15,57,26,31,0,0,0
2022-06-29 22:30,57,21,36,0,0,0
2022-06-29 22:45,52,24,28,0,0,0
2022-06-29 23:00,39,18,21,0,0,0
2022-06-29 23:15,43,17,26,0,0,0
2022-06-29 23:30,34,21,13,0,0,0
2022-06-29 23:45,12,8,4,0,0,0
