Datetime,100034983 (Warendorfer Straße),101034983 (Warendorfer Straße stadteinwärts),102034983 (Warendorfer Straße stadtauswärts),100034983-status,101034983-status,102034983-status
2022-02-01 00:00,3,1,2,0,0,0
2022-02-01 00:15,2,2,0,0,0,0
2022-02-01 00:30,3,2,1,0,0,0
2022-02-01 00:45,3,0,3,0,0,0
2022-02-01 01:00,1,0,1,0,0,0
2022-02-01 01:15,3,1,2,0,0,0
2022-02-01 01:30,1,0,1,0,0,0
2022-02-01 01:45,0,0,0,0,0,0
2022-02-01 02:00,3,2,1,0,0,0
2022-02-01 02:15,0,0,0,0,0,0
2022-02-01 02:30,1,1,0,0,0,0
2022-02-01 02:45,0,0,0,0,0,0
2022-02-01 03:00,0,0,0,0,0,0
2022-02-01 03:15,0,0,0,0,0,0
2022-02-01 03:30,1,1,0,0,0,0
2022-02-01 03:45,0,0,0,0,0,0
2022-02-01 04:00,0,0,0,0,0,0
2022-02-01 04:15,3,2,1,0,0,0
2022-02-01 04:30,0,0,0,0,0,0
2022-02-01 04:45,2,1,1,0,0,0
2022-02-01 05:00,3,1,2,0,0,0
2022-02-01 05:15,3,3,0,0,0,0
2022-02-01 05:30,15,9,6,0,0,0
2022-02-01 05:45,14,7,7,0,0,0
2022-02-01 06:00,15,9,6,0,0,0
2022-02-01 06:15,24,16,8,0,0,0
2022-02-01 06:30,37,19,18,0,0,0
2022-02-01 06:45,51,31,20,0,0,0
2022-02-01 07:00,72,48,24,0,0,0
2022-02-01 07:15,138,102,36,0,0,0
2022-02-01 07:30,298,252,46,0,0,0
2022-02-01 07:45,182,120,62,0,0,0
2022-02-01 08:00,108,80,28,0,0,0
2022-02-01 08:15,124,83,41,0,0,0
2022-02-01 08:30,121,90,31,0,0,0
2022-02-01 08:45,136,105,31,0,0,0
2022-02-01 09:00,82,59,23,0,0,0
2022-02-01 09:15,93,68,25,0,0,0
2022-02-01 09:30,89,60,29,0,0,0
2022-02-01 09:45,76,58,18,0,0,0
2022-02-01 10:00,64,38,26,0,0,0
2022-02-01 10:15,73,48,25,0,0,0
2022-02-01 10:30,54,42,12,0,0,0
2022-02-01 10:45,80,45,35,0,0,0
2022-02-01 11:00,55,28,27,0,0,0
2022-02-01 11:15,66,40,26,0,0,0
2022-02-01 11:30,71,47,24,0,0,0
2022-02-01 11:45,60,36,24,0,0,0
2022-02-01 12:00,73,30,43,0,0,0
2022-02-01 12:15,70,34,36,0,0,0
2022-02-01 12:30,85,46,39,0,0,0
2022-02-01 12:45,87,51,36,0,0,0
2022-02-01 13:00,94,38,56,0,0,0
2022-02-01 13:15,116,59,57,0,0,0
2022-02-01 13:30,74,29,45,0,0,0
2022-02-01 13:45,101,54,47,0,0,0
2022-02-01 14:00,101,37,64,0,0,0
2022-02-01 14:15,77,43,34,0,0,0
2022-02-01 14:30,90,54,36,0,0,0
2022-02-01 14:45,105,48,57,0,0,0
2022-02-01 15:00,93,42,51,0,0,0
2022-02-01 15:15,96,41,55,0,0,0
2022-02-01 15:30,113,59,54,0,0,0
2022-02-01 15:45,113,61,52,0,0,0
2022-02-01 16:00,102,49,53,0,0,0
2022-02-01 16:15,127,62,65,0,0,0
2022-02-01 16:30,134,66,68,0,0,0
2022-02-01 16:45,105,63,42,0,0,0
2022-02-01 17:00,121,51,70,0,0,0
2022-02-01 17:15,104,48,56,0,0,0
2022-02-01 17:30,100,44,56,0,0,0
2022-02-01 17:45,119,54,65,0,0,0
2022-02-01 18:00,134,62,72,0,0,0
2022-02-01 18:15,111,47,64,0,0,0
2022-02-01 18:30,83,34,49,0,0,0
2022-02-01 18:45,106,51,55,0,0,0
2022-02-01 19:00,96,44,52,0,0,0
2022-02-01 19:15,79,34,45,0,0,0
2022-02-01 19:30,57,18,39,0,0,0
2022-02-01 19:45,60,20,40,0,0,0
2022-02-01 20:00,67,25,42,0,0,0
2022-02-01 20:15,52,23,29,0,0,0
2022-02-01 20:30,41,16,25,0,0,0
2022-02-01 20:45,25,10,15,0,0,0
2022-02-01 21:00,33,12,21,0,0,0
2022-02-01 21:15,32,12,20,0,0,0
2022-02-01 21:30,28,12,16,0,0,0
2022-02-01 21:45,42,17,25,0,0,0
2022-02-01 22:00,26,11,15,0,0,0
2022-02-01 22:15,47,22,25,0,0,0
2022-02-01 22:30,19,11,8,0,0,0
2022-02-01 22:45,29,7,22,0,0,0
2022-02-01 23:00,19,13,6,0,0,0
2022-02-01 23:15,18,11,7,0,0,0
2022-02-01 23:30,14,8,6,0,0,0
2022-02-01 23:45,8,6,2,0,0,0
2022-02-02 00:00,2,0,2,0,0,0
2022-02-02 00:15,7,3,4,0,0,0
2022-02-02 00:30,3,2,1,0,0,0
2022-02-02 00:45,4,1,3,0,0,0
2022-02-02 01:00,0,0,0,0,0,0
2022-02-02 01:15,0,0,0,0,0,0
2022-02-02 01:30,3,2,1,0,0,0
2022-02-02 01:45,1,0,1,0,0,0
2022-02-02 02:00,2,0,2,0,0,0
2022-02-02 02:15,2,0,2,0,0,0
2022-02-02 02:30,2,1,1,0,0,0
2022-02-02 02:45,0,0,0,0,0,0
2022-02-02 03:00,0,0,0,0,0,0
2022-02-02 03:15,0,0,0,0,0,0
2022-02-02 03:30,0,0,0,0,0,0
2022-02-02 03:45,0,0,0,0,0,0
2022-02-02 04:00,0,0,0,0,0,0
2022-02-02 04:15,3,3,0,0,0,0
2022-02-02 04:30,0,0,0,0,0,0
2022-02-02 04:45,1,0,1,0,0,0
2022-02-02 05:00,0,0,0,0,0,0
2022-02-02 05:15,7,7,0,0,0,0
2022-02-02 05:30,9,4,5,0,0,0
2022-02-02 05:45,13,7,6,0,0,0
2022-02-02 06:00,10,9,1,0,0,0
2022-02-02 06:15,24,11,13,0,0,0
2022-02-02 06:30,41,20,21,0,0,0
2022-02-02 06:45,56,36,20,0,0,0
2022-02-02 07:00,82,51,31,0,0,0
2022-02-02 07:15,159,115,44,0,0,0
2022-02-02 07:30,270,229,41,0,0,0
2022-02-02 07:45,197,127,70,0,0,0
2022-02-02 08:00,117,88,29,0,0,0
2022-02-02 08:15,138,96,42,0,0,0
2022-02-02 08:30,130,101,29,0,0,0
2022-02-02 08:45,162,119,43,0,0,0
2022-02-02 09:00,106,81,25,0,0,0
2022-02-02 09:15,108,84,24,0,0,0
2022-02-02 09:30,127,98,29,0,0,0
2022-02-02 09:45,106,75,31,0,0,0
2022-02-02 10:00,99,70,29,0,0,0
2022-02-02 10:15,110,75,35,0,0,0
2022-02-02 10:30,101,67,34,0,0,0
2022-02-02 10:45,123,81,42,0,0,0
2022-02-02 11:00,104,73,31,0,0,0
2022-02-02 11:15,122,78,44,0,0,0
2022-02-02 11:30,105,63,42,0,0,0
2022-02-02 11:45,138,84,54,0,0,0
2022-02-02 12:00,128,65,63,0,0,0
2022-02-02 12:15,128,76,52,0,0,0
2022-02-02 12:30,151,71,80,0,0,0
2022-02-02 12:45,132,65,67,0,0,0
2022-02-02 13:00,156,71,85,0,0,0
2022-02-02 13:15,127,60,67,0,0,0
2022-02-02 13:30,128,67,61,0,0,0
2022-02-02 13:45,134,55,79,0,0,0
2022-02-02 14:00,137,63,74,0,0,0
2022-02-02 14:15,104,49,55,0,0,0
2022-02-02 14:30,127,60,67,0,0,0
2022-02-02 14:45,139,70,69,0,0,0
2022-02-02 15:00,138,63,75,0,0,0
2022-02-02 15:15,124,62,62,0,0,0
2022-02-02 15:30,135,77,58,0,0,0
2022-02-02 15:45,122,61,61,0,0,0
2022-02-02 16:00,139,73,66,0,0,0
2022-02-02 16:15,147,70,77,0,0,0
2022-02-02 16:30,167,83,84,0,0,0
2022-02-02 16:45,159,82,77,0,0,0
2022-02-02 17:00,160,78,82,0,0,0
2022-02-02 17:15,161,69,92,0,0,0
2022-02-02 17:30,141,59,82,0,0,0
2022-02-02 17:45,140,59,81,0,0,0
2022-02-02 18:00,148,70,78,0,0,0
2022-02-02 18:15,108,46,62,0,0,0
2022-02-02 18:30,111,53,58,0,0,0
2022-02-02 18:45,102,44,58,0,0,0
2022-02-02 19:00,106,30,76,0,0,0
2022-02-02 19:15,105,52,53,0,0,0
2022-02-02 19:30,65,26,39,0,0,0
2022-02-02 19:45,63,32,31,0,0,0
2022-02-02 20:00,74,37,37,0,0,0
2022-02-02 20:15,34,20,14,0,0,0
2022-02-02 20:30,30,11,19,0,0,0
2022-02-02 20:45,29,15,14,0,0,0
2022-02-02 21:00,36,11,25,0,0,0
2022-02-02 21:15,37,16,21,0,0,0
2022-02-02 21:30,42,21,21,0,0,0
2022-02-02 21:45,43,21,22,0,0,0
2022-02-02 22:00,45,17,28,0,0,0
2022-02-02 22:15,19,6,13,0,0,0
2022-02-02 22:30,27,15,12,0,0,0
2022-02-02 22:45,31,13,18,0,0,0
2022-02-02 23:00,6,3,3,0,0,0
2022-02-02 23:15,12,6,6,0,0,0
2022-02-02 23:30,17,7,10,0,0,0
2022-02-02 23:45,10,4,6,0,0,0
2022-02-03 00:00,11,9,2,0,0,0
2022-02-03 00:15,14,7,7,0,0,0
2022-02-03 00:30,7,3,4,0,0,0
2022-02-03 00:45,29,26,3,0,0,0
2022-02-03 01:00,1,1,0,0,0,0
2022-02-03 01:15,5,4,1,0,0,0
2022-02-03 01:30,1,0,1,0,0,0
2022-02-03 01:45,4,0,4,0,0,0
2022-02-03 02:00,3,0,3,0,0,0
2022-02-03 02:15,3,1,2,0,0,0
2022-02-03 02:30,4,1,3,0,0,0
2022-02-03 02:45,0,0,0,0,0,0
2022-02-03 03:00,0,0,0,0,0,0
2022-02-03 03:15,0,0,0,0,0,0
2022-02-03 03:30,2,2,0,0,0,0
2022-02-03 03:45,0,0,0,0,0,0
2022-02-03 04:00,0,0,0,0,0,0
2022-02-03 04:15,2,1,1,0,0,0
2022-02-03 04:30,1,1,0,0,0,0
2022-02-03 04:45,1,0,1,0,0,0
2022-02-03 05:00,1,0,1,0,0,0
2022-02-03 05:15,8,8,0,0,0,0
2022-02-03 05:30,6,4,2,0,0,0
2022-02-03 05:45,10,7,3,0,0,0
2022-02-03 06:00,8,3,5,0,0,0
2022-02-03 06:15,27,16,11,0,0,0
2022-02-03 06:30,38,18,20,0,0,0
2022-02-03 06:45,38,23,15,0,0,0
2022-02-03 07:00,77,55,22,0,0,0
2022-02-03 07:15,130,90,40,0,0,0
2022-02-03 07:30,299,243,56,0,0,0
2022-02-03 07:45,186,120,66,0,0,0
2022-02-03 08:00,103,71,32,0,0,0
2022-02-03 08:15,139,91,48,0,0,0
2022-02-03 08:30,143,106,37,0,0,0
2022-02-03 08:45,111,84,27,0,0,0
2022-02-03 09:00,87,62,25,0,0,0
2022-02-03 09:15,93,68,25,0,0,0
2022-02-03 09:30,85,59,26,0,0,0
2022-02-03 09:45,109,75,34,0,0,0
2022-02-03 10:00,76,52,24,0,0,0
2022-02-03 10:15,84,52,32,0,0,0
2022-02-03 10:30,77,54,23,0,0,0
2022-02-03 10:45,63,46,17,0,0,0
2022-02-03 11:00,72,43,29,0,0,0
2022-02-03 11:15,89,49,40,0,0,0
2022-02-03 11:30,93,58,35,0,0,0
2022-02-03 11:45,71,37,34,0,0,0
2022-02-03 12:00,75,46,29,0,0,0
2022-02-03 12:15,93,53,40,0,0,0
2022-02-03 12:30,105,56,49,0,0,0
2022-02-03 12:45,84,45,39,0,0,0
2022-02-03 13:00,88,44,44,0,0,0
2022-02-03 13:15,106,52,54,0,0,0
2022-02-03 13:30,72,36,36,0,0,0
2022-02-03 13:45,121,63,58,0,0,0
2022-02-03 14:00,133,58,75,0,0,0
2022-02-03 14:15,112,58,54,0,0,0
2022-02-03 14:30,114,60,54,0,0,0
2022-02-03 14:45,124,65,59,0,0,0
2022-02-03 15:00,115,54,61,0,0,0
2022-02-03 15:15,106,55,51,0,0,0
2022-02-03 15:30,137,61,76,0,0,0
2022-02-03 15:45,137,81,56,0,0,0
2022-02-03 16:00,141,76,65,0,0,0
2022-02-03 16:15,152,77,75,0,0,0
2022-02-03 16:30,160,85,75,0,0,0
2022-02-03 16:45,150,61,89,0,0,0
2022-02-03 17:00,140,60,80,0,0,0
2022-02-03 17:15,142,69,73,0,0,0
2022-02-03 17:30,139,67,72,0,0,0
2022-02-03 17:45,151,70,81,0,0,0
2022-02-03 18:00,125,51,74,0,0,0
2022-02-03 18:15,112,62,50,0,0,0
2022-02-03 18:30,97,32,65,0,0,0
2022-02-03 18:45,94,37,57,0,0,0
2022-02-03 19:00,90,43,47,0,0,0
2022-02-03 19:15,82,31,51,0,0,0
2022-02-03 19:30,73,28,45,0,0,0
2022-02-03 19:45,77,31,46,0,0,0
2022-02-03 20:00,53,19,34,0,0,0
2022-02-03 20:15,45,16,29,0,0,0
2022-02-03 20:30,27,8,19,0,0,0
2022-02-03 20:45,33,14,19,0,0,0
2022-02-03 21:00,36,18,18,0,0,0
2022-02-03 21:15,28,6,22,0,0,0
2022-02-03 21:30,38,19,19,0,0,0
2022-02-03 21:45,34,11,23,0,0,0
2022-02-03 22:00,36,23,13,0,0,0
2022-02-03 22:15,31,9,22,0,0,0
2022-02-03 22:30,26,14,12,0,0,0
2022-02-03 22:45,29,20,9,0,0,0
2022-02-03 23:00,17,5,12,0,0,0
2022-02-03 23:15,20,9,11,0,0,0
2022-02-03 23:30,13,10,3,0,0,0
2022-02-03 23:45,13,8,5,0,0,0
2022-02-04 00:00,10,2,8,0,0,0
2022-02-04 00:15,13,6,7,0,0,0
2022-02-04 00:30,1,1,0,0,0,0
2022-02-04 00:45,4,3,1,0,0,0
2022-02-04 01:00,6,3,3,0,0,0
2022-02-04 01:15,3,1,2,0,0,0
2022-02-04 01:30,2,0,2,0,0,0
2022-02-04 01:45,3,0,3,0,0,0
2022-02-04 02:00,1,0,1,0,0,0
2022-02-04 02:15,4,1,3,0,0,0
2022-02-04 02:30,4,4,0,0,0,0
2022-02-04 02:45,1,0,1,0,0,0
2022-02-04 03:00,3,2,1,0,0,0
2022-02-04 03:15,0,0,0,0,0,0
2022-02-04 03:30,4,4,0,0,0,0
2022-02-04 03:45,0,0,0,0,0,0
2022-02-04 04:00,1,0,1,0,0,0
2022-02-04 04:15,4,2,2,0,0,0
2022-02-04 04:30,1,0,1,0,0,0
2022-02-04 04:45,2,0,2,0,0,0
2022-02-04 05:00,2,1,1,0,0,0
2022-02-04 05:15,2,1,1,0,0,0
2022-02-04 05:30,11,5,6,0,0,0
2022-02-04 05:45,12,6,6,0,0,0
2022-02-04 06:00,8,3,5,0,0,0
2022-02-04 06:15,23,10,13,0,0,0
2022-02-04 06:30,30,19,11,0,0,0
2022-02-04 06:45,54,33,21,0,0,0
2022-02-04 07:00,62,40,22,0,0,0
2022-02-04 07:15,118,80,38,0,0,0
2022-02-04 07:30,296,244,52,0,0,0
2022-02-04 07:45,168,117,51,0,0,0
2022-02-04 08:00,82,58,24,0,0,0
2022-02-04 08:15,114,81,33,0,0,0
2022-02-04 08:30,140,105,35,0,0,0
2022-02-04 08:45,121,91,30,0,0,0
2022-02-04 09:00,83,64,19,0,0,0
2022-02-04 09:15,83,59,24,0,0,0
2022-02-04 09:30,91,69,22,0,0,0
2022-02-04 09:45,91,62,29,0,0,0
2022-02-04 10:00,76,50,26,0,0,0
2022-02-04 10:15,78,48,30,0,0,0
2022-02-04 10:30,70,48,22,0,0,0
2022-02-04 10:45,89,55,34,0,0,0
2022-02-04 11:00,102,58,44,0,0,0
2022-02-04 11:15,90,50,40,0,0,0
2022-02-04 11:30,83,50,33,0,0,0
2022-02-04 11:45,73,55,18,0,0,0
2022-02-04 12:00,96,63,33,0,0,0
2022-02-04 12:15,106,56,50,0,0,0
2022-02-04 12:30,98,50,48,0,0,0
2022-02-04 12:45,124,62,62,0,0,0
2022-02-04 13:00,124,43,81,0,0,0
2022-02-04 13:15,125,52,73,0,0,0
2022-02-04 13:30,94,48,46,0,0,0
2022-02-04 13:45,138,75,63,0,0,0
2022-02-04 14:00,157,61,96,0,0,0
2022-02-04 14:15,101,46,55,0,0,0
2022-02-04 14:30,101,53,48,0,0,0
2022-02-04 14:45,113,61,52,0,0,0
2022-02-04 15:00,91,46,45,0,0,0
2022-02-04 15:15,114,61,53,0,0,0
2022-02-04 15:30,119,53,66,0,0,0
2022-02-04 15:45,98,54,44,0,0,0
2022-02-04 16:00,80,47,33,0,0,0
2022-02-04 16:15,82,33,49,0,0,0
2022-02-04 16:30,94,44,50,0,0,0
2022-02-04 16:45,76,42,34,0,0,0
2022-02-04 17:00,72,32,40,0,0,0
2022-02-04 17:15,80,43,37,0,0,0
2022-02-04 17:30,67,21,46,0,0,0
2022-02-04 17:45,60,29,31,0,0,0
2022-02-04 18:00,80,27,53,0,0,0
2022-02-04 18:15,83,38,45,0,0,0
2022-02-04 18:30,62,23,39,0,0,0
2022-02-04 18:45,64,35,29,0,0,0
2022-02-04 19:00,69,40,29,0,0,0
2022-02-04 19:15,76,37,39,0,0,0
2022-02-04 19:30,60,27,33,0,0,0
2022-02-04 19:45,58,26,32,0,0,0
2022-02-04 20:00,59,33,26,0,0,0
2022-02-04 20:15,35,22,13,0,0,0
2022-02-04 20:30,32,15,17,0,0,0
2022-02-04 20:45,31,16,15,0,0,0
2022-02-04 21:00,24,13,11,0,0,0
2022-02-04 21:15,32,22,10,0,0,0
2022-02-04 21:30,34,17,17,0,0,0
2022-02-04 21:45,18,9,9,0,0,0
2022-02-04 22:00,29,16,13,0,0,0
2022-02-04 22:15,28,16,12,0,0,0
2022-02-04 22:30,21,10,11,0,0,0
2022-02-04 22:45,17,4,13,0,0,0
2022-02-04 23:00,26,15,11,0,0,0
2022-02-04 23:15,27,15,12,0,0,0
2022-02-04 23:30,20,11,9,0,0,0
2022-02-04 23:45,27,16,11,0,0,0
2022-02-05 00:00,29,13,16,0,0,0
2022-02-05 00:15,17,4,13,0,0,0
2022-02-05 00:30,6,3,3,0,0,0
2022-02-05 00:45,17,7,10,0,0,0
2022-02-05 01:00,21,11,10,0,0,0
2022-02-05 01:15,9,1,8,0,0,0
2022-02-05 01:30,9,3,6,0,0,0
2022-02-05 01:45,4,1,3,0,0,0
2022-02-05 02:00,11,3,8,0,0,0
2022-02-05 02:15,7,0,7,0,0,0
2022-02-05 02:30,8,2,6,0,0,0
2022-02-05 02:45,5,0,5,0,0,0
2022-02-05 03:00,8,5,3,0,0,0
2022-02-05 03:15,6,3,3,0,0,0
2022-02-05 03:30,10,5,5,0,0,0
2022-02-05 03:45,1,1,0,0,0,0
2022-02-05 04:00,11,7,4,0,0,0
2022-02-05 04:15,1,1,0,0,0,0
2022-02-05 04:30,6,2,4,0,0,0
2022-02-05 04:45,3,0,3,0,0,0
2022-02-05 05:00,3,2,1,0,0,0
2022-02-05 05:15,4,4,0,0,0,0
2022-02-05 05:30,4,2,2,0,0,0
2022-02-05 05:45,10,6,4,0,0,0
2022-02-05 06:00,8,5,3,0,0,0
2022-02-05 06:15,4,2,2,0,0,0
2022-02-05 06:30,10,9,1,0,0,0
2022-02-05 06:45,10,8,2,0,0,0
2022-02-05 07:00,9,5,4,0,0,0
2022-02-05 07:15,10,7,3,0,0,0
2022-02-05 07:30,13,9,4,0,0,0
2022-02-05 07:45,25,15,10,0,0,0
2022-02-05 08:00,24,12,12,0,0,0
2022-02-05 08:15,21,19,2,0,0,0
2022-02-05 08:30,35,23,12,0,0,0
2022-02-05 08:45,33,23,10,0,0,0
2022-02-05 09:00,54,39,15,0,0,0
2022-02-05 09:15,48,38,10,0,0,0
2022-02-05 09:30,86,63,23,0,0,0
2022-02-05 09:45,98,78,20,0,0,0
2022-02-05 10:00,92,62,30,0,0,0
2022-02-05 10:15,113,85,28,0,0,0
2022-02-05 10:30,124,92,32,0,0,0
2022-02-05 10:45,133,92,41,0,0,0
2022-02-05 11:00,146,110,36,0,0,0
2022-02-05 11:15,142,101,41,0,0,0
2022-02-05 11:30,135,92,43,0,0,0
2022-02-05 11:45,140,92,48,0,0,0
2022-02-05 12:00,178,119,59,0,0,0
2022-02-05 12:15,162,92,70,0,0,0
2022-02-05 12:30,138,89,49,0,0,0
2022-02-05 12:45,150,86,64,0,0,0
2022-02-05 13:00,137,60,77,0,0,0
2022-02-05 13:15,155,80,75,0,0,0
2022-02-05 13:30,121,59,62,0,0,0
2022-02-05 13:45,159,80,79,0,0,0
2022-02-05 14:00,134,67,67,0,0,0
2022-02-05 14:15,117,51,66,0,0,0
2022-02-05 14:30,98,43,55,0,0,0
2022-02-05 14:45,114,57,57,0,0,0
2022-02-05 15:00,92,37,55,0,0,0
2022-02-05 15:15,84,37,47,0,0,0
2022-02-05 15:30,118,71,47,0,0,0
2022-02-05 15:45,93,51,42,0,0,0
2022-02-05 16:00,90,42,48,0,0,0
2022-02-05 16:15,79,26,53,0,0,0
2022-02-05 16:30,88,46,42,0,0,0
2022-02-05 16:45,81,41,40,0,0,0
2022-02-05 17:00,67,31,36,0,0,0
2022-02-05 17:15,67,29,38,0,0,0
2022-02-05 17:30,73,30,43,0,0,0
2022-02-05 17:45,92,34,58,0,0,0
2022-02-05 18:00,65,27,38,0,0,0
2022-02-05 18:15,79,29,50,0,0,0
2022-02-05 18:30,72,32,40,0,0,0
2022-02-05 18:45,86,46,40,0,0,0
2022-02-05 19:00,66,41,25,0,0,0
2022-02-05 19:15,75,50,25,0,0,0
2022-02-05 19:30,45,25,20,0,0,0
2022-02-05 19:45,63,29,34,0,0,0
2022-02-05 20:00,44,19,25,0,0,0
2022-02-05 20:15,42,25,17,0,0,0
2022-02-05 20:30,35,27,8,0,0,0
2022-02-05 20:45,37,20,17,0,0,0
2022-02-05 21:00,21,11,10,0,0,0
2022-02-05 21:15,22,8,14,0,0,0
2022-02-05 21:30,30,10,20,0,0,0
2022-02-05 21:45,22,3,19,0,0,0
2022-02-05 22:00,30,9,21,0,0,0
2022-02-05 22:15,30,14,16,0,0,0
2022-02-05 22:30,22,7,15,0,0,0
2022-02-05 22:45,33,17,16,0,0,0
2022-02-05 23:00,19,11,8,0,0,0
2022-02-05 23:15,38,22,16,0,0,0
2022-02-05 23:30,27,12,15,0,0,0
2022-02-05 23:45,25,13,12,0,0,0
2022-02-06 00:00,21,10,11,0,0,0
2022-02-06 00:15,17,10,7,0,0,0
2022-02-06 00:30,12,0,12,0,0,0
2022-02-06 00:45,21,11,10,0,0,0
2022-02-06 01:00,24,6,18,0,0,0
2022-02-06 01:15,14,5,9,0,0,0
2022-02-06 01:30,13,5,8,0,0,0
2022-02-06 01:45,9,0,9,0,0,0
2022-02-06 02:00,14,7,7,0,0,0
2022-02-06 02:15,10,5,5,0,0,0
2022-02-06 02:30,5,0,5,0,0,0
2022-02-06 02:45,6,6,0,0,0,0
2022-02-06 03:00,4,2,2,0,0,0
2022-02-06 03:15,6,1,5,0,0,0
2022-02-06 03:30,5,0,5,0,0,0
2022-02-06 03:45,8,2,6,0,0,0
2022-02-06 04:00,2,1,1,0,0,0
2022-02-06 04:15,3,2,1,0,0,0
2022-02-06 04:30,2,0,2,0,0,0
2022-02-06 04:45,0,0,0,0,0,0
2022-02-06 05:00,3,2,1,0,0,0
2022-02-06 05:15,0,0,0,0,0,0
2022-02-06 05:30,5,2,3,0,0,0
2022-02-06 05:45,5,0,5,0,0,0
2022-02-06 06:00,4,3,1,0,0,0
2022-02-06 06:15,3,3,0,0,0,0
2022-02-06 06:30,2,2,0,0,0,0
2022-02-06 06:45,5,3,2,0,0,0
2022-02-06 07:00,4,1,3,0,0,0
2022-02-06 07:15,2,2,0,0,0,0
2022-02-06 07:30,9,6,3,0,0,0
2022-02-06 07:45,7,5,2,0,0,0
2022-02-06 08:00,7,3,4,0,0,0
2022-02-06 08:15,1,1,0,0,0,0
2022-02-06 08:30,11,9,2,0,0,0
2022-02-06 08:45,15,9,6,0,0,0
2022-02-06 09:00,10,6,4,0,0,0
2022-02-06 09:15,12,8,4,0,0,0
2022-02-06 09:30,10,10,0,0,0,0
2022-02-06 09:45,13,12,1,0,0,0
2022-02-06 10:00,10,6,4,0,0,0
2022-02-06 10:15,14,9,5,0,0,0
2022-02-06 10:30,15,11,4,0,0,0
2022-02-06 10:45,12,11,1,0,0,0
2022-02-06 11:00,12,7,5,0,0,0
2022-02-06 11:15,18,15,3,0,0,0
2022-02-06 11:30,16,7,9,0,0,0
2022-02-06 11:45,14,7,7,0,0,0
2022-02-06 12:00,14,9,5,0,0,0
2022-02-06 12:15,19,13,6,0,0,0
2022-02-06 12:30,16,8,8,0,0,0
2022-02-06 12:45,11,4,7,0,0,0
2022-02-06 13:00,19,10,9,0,0,0
2022-02-06 13:15,16,6,10,0,0,0
2022-02-06 13:30,11,3,8,0,0,0
2022-02-06 13:45,23,12,11,0,0,0
2022-02-06 14:00,12,5,7,0,0,0
2022-02-06 14:15,23,13,10,0,0,0
2022-02-06 14:30,16,8,8,0,0,0
2022-02-06 14:45,14,9,5,0,0,0
2022-02-06 15:00,23,17,6,0,0,0
2022-02-06 15:15,25,16,9,0,0,0
2022-02-06 15:30,24,17,7,0,0,0
2022-02-06 15:45,21,14,7,0,0,0
2022-02-06 16:00,28,10,18,0,0,0
2022-02-06 16:15,22,10,12,0,0,0
2022-02-06 16:30,25,13,12,0,0,0
2022-02-06 16:45,27,12,15,0,0,0
2022-02-06 17:00,25,15,10,0,0,0
2022-02-06 17:15,20,10,10,0,0,0
2022-02-06 17:30,37,23,14,0,0,0
2022-02-06 17:45,31,20,11,0,0,0
2022-02-06 18:00,27,10,17,0,0,0
2022-02-06 18:15,15,3,12,0,0,0
2022-02-06 18:30,13,7,6,0,0,0
2022-02-06 18:45,12,6,6,0,0,0
2022-02-06 19:00,32,19,13,0,0,0
2022-02-06 19:15,27,10,17,0,0,0
2022-02-06 19:30,18,8,10,0,0,0
2022-02-06 19:45,16,5,11,0,0,0
2022-02-06 20:00,8,3,5,0,0,0
2022-02-06 20:15,31,22,9,0,0,0
2022-02-06 20:30,21,11,10,0,0,0
2022-02-06 20:45,16,8,8,0,0,0
2022-02-06 21:00,15,5,10,0,0,0
2022-02-06 21:15,9,4,5,0,0,0
2022-02-06 21:30,9,6,3,0,0,0
2022-02-06 21:45,12,6,6,0,0,0
2022-02-06 22:00,6,2,4,0,0,0
2022-02-06 22:15,5,2,3,0,0,0
2022-02-06 22:30,10,9,1,0,0,0
2022-02-06 22:45,9,4,5,0,0,0
2022-02-06 23:00,7,4,3,0,0,0
2022-02-06 23:15,2,0,2,0,0,0
2022-02-06 23:30,1,0,1,0,0,0
2022-02-06 23:45,4,4,0,0,0,0
2022-02-07 00:00,4,4,0,0,0,0
2022-02-07 00:15,2,0,2,0,0,0
2022-02-07 00:30,2,1,1,0,0,0
2022-02-07 00:45,3,1,2,0,0,0
2022-02-07 01:00,1,0,1,0,0,0
2022-02-07 01:15,1,0,1,0,0,0
2022-02-07 01:30,3,2,1,0,0,0
2022-02-07 01:45,0,0,0,0,0,0
2022-02-07 02:00,0,0,0,0,0,0
2022-02-07 02:15,0,0,0,0,0,0
2022-02-07 02:30,2,1,1,0,0,0
2022-02-07 02:45,1,0,1,0,0,0
2022-02-07 03:00,0,0,0,0,0,0
2022-02-07 03:15,0,0,0,0,0,0
2022-02-07 03:30,0,0,0,0,0,0
2022-02-07 03:45,0,0,0,0,0,0
2022-02-07 04:00,1,1,0,0,0,0
2022-02-07 04:15,2,1,1,0,0,0
2022-02-07 04:30,2,2,0,0,0,0
2022-02-07 04:45,1,0,1,0,0,0
2022-02-07 05:00,1,0,1,0,0,0
2022-02-07 05:15,0,0,0,0,0,0
2022-02-07 05:30,15,8,7,0,0,0
2022-02-07 05:45,16,7,9,0,0,0
2022-02-07 06:00,16,12,4,0,0,0
2022-02-07 06:15,24,15,9,0,0,0
2022-02-07 06:30,43,26,17,0,0,0
2022-02-07 06:45,36,18,18,0,0,0
2022-02-07 07:00,67,48,19,0,0,0
2022-02-07 07:15,142,101,41,0,0,0
2022-02-07 07:30,284,239,45,0,0,0
2022-02-07 07:45,172,110,62,0,0,0
2022-02-07 08:00,104,82,22,0,0,0
2022-02-07 08:15,122,77,45,0,0,0
2022-02-07 08:30,128,97,31,0,0,0
2022-02-07 08:45,133,89,44,0,0,0
2022-02-07 09:00,99,71,28,0,0,0
2022-02-07 09:15,88,59,29,0,0,0
2022-02-07 09:30,70,52,18,0,0,0
2022-02-07 09:45,83,57,26,0,0,0
2022-02-07 10:00,75,49,26,0,0,0
2022-02-07 10:15,79,56,23,0,0,0
2022-02-07 10:30,83,58,25,0,0,0
2022-02-07 10:45,72,46,26,0,0,0
2022-02-07 11:00,81,52,29,0,0,0
2022-02-07 11:15,87,56,31,0,0,0
2022-02-07 11:30,82,46,36,0,0,0
2022-02-07 11:45,89,40,49,0,0,0
2022-02-07 12:00,79,50,29,0,0,0
2022-02-07 12:15,93,47,46,0,0,0
2022-02-07 12:30,130,66,64,0,0,0
2022-02-07 12:45,101,59,42,0,0,0
2022-02-07 13:00,122,52,70,0,0,0
2022-02-07 13:15,96,52,44,0,0,0
2022-02-07 13:30,81,46,35,0,0,0
2022-02-07 13:45,99,59,40,0,0,0
2022-02-07 14:00,94,53,41,0,0,0
2022-02-07 14:15,107,53,54,0,0,0
2022-02-07 14:30,118,58,60,0,0,0
2022-02-07 14:45,134,71,63,0,0,0
2022-02-07 15:00,130,66,64,0,0,0
2022-02-07 15:15,112,59,53,0,0,0
2022-02-07 15:30,120,66,54,0,0,0
2022-02-07 15:45,145,81,64,0,0,0
2022-02-07 16:00,154,90,64,0,0,0
2022-02-07 16:15,154,70,84,0,0,0
2022-02-07 16:30,135,74,61,0,0,0
2022-02-07 16:45,171,92,79,0,0,0
2022-02-07 17:00,134,59,75,0,0,0
2022-02-07 17:15,127,60,67,0,0,0
2022-02-07 17:30,131,72,59,0,0,0
2022-02-07 17:45,150,74,76,0,0,0
2022-02-07 18:00,144,64,80,0,0,0
2022-02-07 18:15,126,41,85,0,0,0
2022-02-07 18:30,103,47,56,0,0,0
2022-02-07 18:45,100,45,55,0,0,0
2022-02-07 19:00,74,32,42,0,0,0
2022-02-07 19:15,71,27,44,0,0,0
2022-02-07 19:30,44,18,26,0,0,0
2022-02-07 19:45,65,31,34,0,0,0
2022-02-07 20:00,47,16,31,0,0,0
2022-02-07 20:15,66,21,45,0,0,0
2022-02-07 20:30,44,16,28,0,0,0
2022-02-07 20:45,34,12,22,0,0,0
2022-02-07 21:00,20,6,14,0,0,0
2022-02-07 21:15,26,10,16,0,0,0
2022-02-07 21:30,42,24,18,0,0,0
2022-02-07 21:45,32,12,20,0,0,0
2022-02-07 22:00,25,10,15,0,0,0
2022-02-07 22:15,26,8,18,0,0,0
2022-02-07 22:30,19,15,4,0,0,0
2022-02-07 22:45,20,8,12,0,0,0
2022-02-07 23:00,9,3,6,0,0,0
2022-02-07 23:15,13,5,8,0,0,0
2022-02-07 23:30,10,4,6,0,0,0
2022-02-07 23:45,8,2,6,0,0,0
2022-02-08 00:00,8,3,5,0,0,0
2022-02-08 00:15,8,3,5,0,0,0
2022-02-08 00:30,3,2,1,0,0,0
2022-02-08 00:45,0,0,0,0,0,0
2022-02-08 01:00,3,2,1,0,0,0
2022-02-08 01:15,1,1,0,0,0,0
2022-02-08 01:30,5,2,3,0,0,0
2022-02-08 01:45,2,0,2,0,0,0
2022-02-08 02:00,3,0,3,0,0,0
2022-02-08 02:15,1,1,0,0,0,0
2022-02-08 02:30,2,1,1,0,0,0
2022-02-08 02:45,2,2,0,0,0,0
2022-02-08 03:00,0,0,0,0,0,0
2022-02-08 03:15,1,0,1,0,0,0
2022-02-08 03:30,0,0,0,0,0,0
2022-02-08 03:45,1,0,1,0,0,0
2022-02-08 04:00,0,0,0,0,0,0
2022-02-08 04:15,5,4,1,0,0,0
2022-02-08 04:30,0,0,0,0,0,0
2022-02-08 04:45,5,2,3,0,0,0
2022-02-08 05:00,1,1,0,0,0,0
2022-02-08 05:15,1,1,0,0,0,0
2022-02-08 05:30,12,9,3,0,0,0
2022-02-08 05:45,18,7,11,0,0,0
2022-02-08 06:00,14,9,5,0,0,0
2022-02-08 06:15,22,11,11,0,0,0
2022-02-08 06:30,40,18,22,0,0,0
2022-02-08 06:45,62,43,19,0,0,0
2022-02-08 07:00,61,37,24,0,0,0
2022-02-08 07:15,143,99,44,0,0,0
2022-02-08 07:30,322,264,58,0,0,0
2022-02-08 07:45,185,123,62,0,0,0
2022-02-08 08:00,118,87,31,0,0,0
2022-02-08 08:15,126,89,37,0,0,0
2022-02-08 08:30,114,87,27,0,0,0
2022-02-08 08:45,145,115,30,0,0,0
2022-02-08 09:00,92,74,18,0,0,0
2022-02-08 09:15,91,61,30,0,0,0
2022-02-08 09:30,105,73,32,0,0,0
2022-02-08 09:45,103,66,37,0,0,0
2022-02-08 10:00,63,43,20,0,0,0
2022-02-08 10:15,77,57,20,0,0,0
2022-02-08 10:30,76,52,24,0,0,0
2022-02-08 10:45,79,48,31,0,0,0
2022-02-08 11:00,77,55,22,0,0,0
2022-02-08 11:15,88,52,36,0,0,0
2022-02-08 11:30,74,47,27,0,0,0
2022-02-08 11:45,109,63,46,0,0,0
2022-02-08 12:00,92,52,40,0,0,0
2022-02-08 12:15,88,47,41,0,0,0
2022-02-08 12:30,110,54,56,0,0,0
2022-02-08 12:45,107,62,45,0,0,0
2022-02-08 13:00,123,59,64,0,0,0
2022-02-08 13:15,142,75,67,0,0,0
2022-02-08 13:30,78,34,44,0,0,0
2022-02-08 13:45,124,66,58,0,0,0
2022-02-08 14:00,124,58,66,0,0,0
2022-02-08 14:15,117,57,60,0,0,0
2022-02-08 14:30,110,61,49,0,0,0
2022-02-08 14:45,133,72,61,0,0,0
2022-02-08 15:00,129,75,54,0,0,0
2022-02-08 15:15,133,61,72,0,0,0
2022-02-08 15:30,113,55,58,0,0,0
2022-02-08 15:45,149,91,58,0,0,0
2022-02-08 16:00,152,72,80,0,0,0
2022-02-08 16:15,165,84,81,0,0,0
2022-02-08 16:30,145,81,64,0,0,0
2022-02-08 16:45,177,93,84,0,0,0
2022-02-08 17:00,159,64,95,0,0,0
2022-02-08 17:15,144,57,87,0,0,0
2022-02-08 17:30,141,64,77,0,0,0
2022-02-08 17:45,136,61,75,0,0,0
2022-02-08 18:00,130,60,70,0,0,0
2022-02-08 18:15,103,47,56,0,0,0
2022-02-08 18:30,91,38,53,0,0,0
2022-02-08 18:45,106,44,62,0,0,0
2022-02-08 19:00,80,29,51,0,0,0
2022-02-08 19:15,81,43,38,0,0,0
2022-02-08 19:30,75,41,34,0,0,0
2022-02-08 19:45,57,18,39,0,0,0
2022-02-08 20:00,61,22,39,0,0,0
2022-02-08 20:15,41,22,19,0,0,0
2022-02-08 20:30,32,10,22,0,0,0
2022-02-08 20:45,46,21,25,0,0,0
2022-02-08 21:00,45,20,25,0,0,0
2022-02-08 21:15,32,10,22,0,0,0
2022-02-08 21:30,29,9,20,0,0,0
2022-02-08 21:45,28,17,11,0,0,0
2022-02-08 22:00,30,12,18,0,0,0
2022-02-08 22:15,42,19,23,0,0,0
2022-02-08 22:30,38,28,10,0,0,0
2022-02-08 22:45,27,19,8,0,0,0
2022-02-08 23:00,11,3,8,0,0,0
2022-02-08 23:15,17,12,5,0,0,0
2022-02-08 23:30,12,3,9,0,0,0
2022-02-08 23:45,6,2,4,0,0,0
2022-02-09 00:00,3,1,2,0,0,0
2022-02-09 00:15,5,2,3,0,0,0
2022-02-09 00:30,6,2,4,0,0,0
2022-02-09 00:45,5,0,5,0,0,0
2022-02-09 01:00,2,0,2,0,0,0
2022-02-09 01:15,1,0,1,0,0,0
2022-02-09 01:30,1,1,0,0,0,0
2022-02-09 01:45,2,0,2,0,0,0
2022-02-09 02:00,2,0,2,0,0,0
2022-02-09 02:15,0,0,0,0,0,0
2022-02-09 02:30,1,1,0,0,0,0
2022-02-09 02:45,0,0,0,0,0,0
2022-02-09 03:00,3,1,2,0,0,0
2022-02-09 03:15,2,2,0,0,0,0
2022-02-09 03:30,0,0,0,0,0,0
2022-02-09 03:45,1,1,0,0,0,0
2022-02-09 04:00,0,0,0,0,0,0
2022-02-09 04:15,2,2,0,0,0,0
2022-02-09 04:30,2,1,1,0,0,0
2022-02-09 04:45,3,2,1,0,0,0
2022-02-09 05:00,3,1,2,0,0,0
2022-02-09 05:15,2,2,0,0,0,0
2022-02-09 05:30,11,8,3,0,0,0
2022-02-09 05:45,15,7,8,0,0,0
2022-02-09 06:00,11,7,4,0,0,0
2022-02-09 06:15,22,12,10,0,0,0
2022-02-09 06:30,43,23,20,0,0,0
2022-02-09 06:45,44,27,17,0,0,0
2022-02-09 07:00,83,56,27,0,0,0
2022-02-09 07:15,140,101,39,0,0,0
2022-02-09 07:30,316,252,64,0,0,0
2022-02-09 07:45,207,142,65,0,0,0
2022-02-09 08:00,131,93,38,0,0,0
2022-02-09 08:15,140,104,36,0,0,0
2022-02-09 08:30,139,96,43,0,0,0
2022-02-09 08:45,121,88,33,0,0,0
2022-02-09 09:00,85,65,20,0,0,0
2022-02-09 09:15,97,71,26,0,0,0
2022-02-09 09:30,104,72,32,0,0,0
2022-02-09 09:45,103,79,24,0,0,0
2022-02-09 10:00,63,46,17,0,0,0
2022-02-09 10:15,97,60,37,0,0,0
2022-02-09 10:30,93,57,36,0,0,0
2022-02-09 10:45,109,82,27,0,0,0
2022-02-09 11:00,96,59,37,0,0,0
2022-02-09 11:15,106,62,44,0,0,0
2022-02-09 11:30,103,65,38,0,0,0
2022-02-09 11:45,105,68,37,0,0,0
2022-02-09 12:00,107,47,60,0,0,0
2022-02-09 12:15,105,58,47,0,0,0
2022-02-09 12:30,129,60,69,0,0,0
2022-02-09 12:45,145,74,71,0,0,0
2022-02-09 13:00,133,59,74,0,0,0
2022-02-09 13:15,118,56,62,0,0,0
2022-02-09 13:30,107,47,60,0,0,0
2022-02-09 13:45,112,57,55,0,0,0
2022-02-09 14:00,140,52,88,0,0,0
2022-02-09 14:15,105,68,37,0,0,0
2022-02-09 14:30,96,40,56,0,0,0
2022-02-09 14:45,135,75,60,0,0,0
2022-02-09 15:00,119,54,65,0,0,0
2022-02-09 15:15,121,75,46,0,0,0
2022-02-09 15:30,121,70,51,0,0,0
2022-02-09 15:45,122,67,55,0,0,0
2022-02-09 16:00,123,71,52,0,0,0
2022-02-09 16:15,115,69,46,0,0,0
2022-02-09 16:30,151,70,81,0,0,0
2022-02-09 16:45,129,69,60,0,0,0
2022-02-09 17:00,126,60,66,0,0,0
2022-02-09 17:15,151,75,76,0,0,0
2022-02-09 17:30,130,65,65,0,0,0
2022-02-09 17:45,135,75,60,0,0,0
2022-02-09 18:00,137,56,81,0,0,0
2022-02-09 18:15,113,45,68,0,0,0
2022-02-09 18:30,92,39,53,0,0,0
2022-02-09 18:45,128,65,63,0,0,0
2022-02-09 19:00,85,41,44,0,0,0
2022-02-09 19:15,91,45,46,0,0,0
2022-02-09 19:30,66,25,41,0,0,0
2022-02-09 19:45,57,27,30,0,0,0
2022-02-09 20:00,64,20,44,0,0,0
2022-02-09 20:15,58,31,27,0,0,0
2022-02-09 20:30,36,22,14,0,0,0
2022-02-09 20:45,36,14,22,0,0,0
2022-02-09 21:00,38,20,18,0,0,0
2022-02-09 21:15,40,14,26,0,0,0
2022-02-09 21:30,34,18,16,0,0,0
2022-02-09 21:45,42,27,15,0,0,0
2022-02-09 22:00,32,18,14,0,0,0
2022-02-09 22:15,37,12,25,0,0,0
2022-02-09 22:30,28,19,9,0,0,0
2022-02-09 22:45,28,15,13,0,0,0
2022-02-09 23:00,20,4,16,0,0,0
2022-02-09 23:15,13,4,9,0,0,0
2022-02-09 23:30,16,6,10,0,0,0
2022-02-09 23:45,14,4,10,0,0,0
2022-02-10 00:00,16,10,6,0,0,0
2022-02-10 00:15,6,3,3,0,0,0
2022-02-10 00:30,5,3,2,0,0,0
2022-02-10 00:45,1,1,0,0,0,0
2022-02-10 01:00,4,0,4,0,0,0
2022-02-10 01:15,4,0,4,0,0,0
2022-02-10 01:30,6,3,3,0,0,0
2022-02-10 01:45,2,1,1,0,0,0
2022-02-10 02:00,11,3,8,0,0,0
2022-02-10 02:15,5,1,4,0,0,0
2022-02-10 02:30,3,3,0,0,0,0
2022-02-10 02:45,4,1,3,0,0,0
2022-02-10 03:00,5,0,5,0,0,0
2022-02-10 03:15,0,0,0,0,0,0
2022-02-10 03:30,2,2,0,0,0,0
2022-02-10 03:45,5,3,2,0,0,0
2022-02-10 04:00,0,0,0,0,0,0
2022-02-10 04:15,3,2,1,0,0,0
2022-02-10 04:30,4,2,2,0,0,0
2022-02-10 04:45,0,0,0,0,0,0
2022-02-10 05:00,1,0,1,0,0,0
2022-02-10 05:15,1,1,0,0,0,0
2022-02-10 05:30,7,5,2,0,0,0
2022-02-10 05:45,14,6,8,0,0,0
2022-02-10 06:00,17,9,8,0,0,0
2022-02-10 06:15,19,13,6,0,0,0
2022-02-10 06:30,44,26,18,0,0,0
2022-02-10 06:45,47,28,19,0,0,0
2022-02-10 07:00,76,49,27,0,0,0
2022-02-10 07:15,134,89,45,0,0,0
2022-02-10 07:30,338,284,54,0,0,0
2022-02-10 07:45,190,114,76,0,0,0
2022-02-10 08:00,134,100,34,0,0,0
2022-02-10 08:15,123,83,40,0,0,0
2022-02-10 08:30,113,89,24,0,0,0
2022-02-10 08:45,115,86,29,0,0,0
2022-02-10 09:00,90,60,30,0,0,0
2022-02-10 09:15,97,71,26,0,0,0
2022-02-10 09:30,82,50,32,0,0,0
2022-02-10 09:45,109,69,40,0,0,0
2022-02-10 10:00,54,37,17,0,0,0
2022-02-10 10:15,61,39,22,0,0,0
2022-02-10 10:30,73,40,33,0,0,0
2022-02-10 10:45,69,50,19,0,0,0
2022-02-10 11:00,55,26,29,0,0,0
2022-02-10 11:15,79,49,30,0,0,0
2022-02-10 11:30,73,47,26,0,0,0
2022-02-10 11:45,66,28,38,0,0,0
2022-02-10 12:00,62,32,30,0,0,0
2022-02-10 12:15,94,58,36,0,0,0
2022-02-10 12:30,80,44,36,0,0,0
2022-02-10 12:45,82,40,42,0,0,0
2022-02-10 13:00,108,50,58,0,0,0
2022-02-10 13:15,94,46,48,0,0,0
2022-02-10 13:30,70,34,36,0,0,0
2022-02-10 13:45,137,87,50,0,0,0
2022-02-10 14:00,92,34,58,0,0,0
2022-02-10 14:15,126,74,52,0,0,0
2022-02-10 14:30,120,64,56,0,0,0
2022-02-10 14:45,136,73,63,0,0,0
2022-02-10 15:00,109,49,60,0,0,0
2022-02-10 15:15,99,59,40,0,0,0
2022-02-10 15:30,112,64,48,0,0,0
2022-02-10 15:45,123,70,53,0,0,0
2022-02-10 16:00,142,73,69,0,0,0
2022-02-10 16:15,124,69,55,0,0,0
2022-02-10 16:30,151,78,73,0,0,0
2022-02-10 16:45,173,88,85,0,0,0
2022-02-10 17:00,147,79,68,0,0,0
2022-02-10 17:15,118,50,68,0,0,0
2022-02-10 17:30,125,58,67,0,0,0
2022-02-10 17:45,125,48,77,0,0,0
2022-02-10 18:00,129,65,64,0,0,0
2022-02-10 18:15,83,33,50,0,0,0
2022-02-10 18:30,88,34,54,0,0,0
2022-02-10 18:45,110,48,62,0,0,0
2022-02-10 19:00,88,38,50,0,0,0
2022-02-10 19:15,87,42,45,0,0,0
2022-02-10 19:30,95,40,55,0,0,0
2022-02-10 19:45,71,33,38,0,0,0
2022-02-10 20:00,58,22,36,0,0,0
2022-02-10 20:15,39,16,23,0,0,0
2022-02-10 20:30,47,24,23,0,0,0
2022-02-10 20:45,29,9,20,0,0,0
2022-02-10 21:00,34,19,15,0,0,0
2022-02-10 21:15,24,8,16,0,0,0
2022-02-10 21:30,23,10,13,0,0,0
2022-02-10 21:45,27,5,22,0,0,0
2022-02-10 22:00,28,16,12,0,0,0
2022-02-10 22:15,38,19,19,0,0,0
2022-02-10 22:30,27,12,15,0,0,0
2022-02-10 22:45,30,16,14,0,0,0
2022-02-10 23:00,31,13,18,0,0,0
2022-02-10 23:15,27,9,18,0,0,0
2022-02-10 23:30,18,2,16,0,0,0
2022-02-10 23:45,11,5,6,0,0,0
2022-02-11 00:00,10,3,7,0,0,0
2022-02-11 00:15,6,3,3,0,0,0
2022-02-11 00:30,6,3,3,0,0,0
2022-02-11 00:45,7,1,6,0,0,0
2022-02-11 01:00,7,4,3,0,0,0
2022-02-11 01:15,7,5,2,0,0,0
2022-02-11 01:30,8,3,5,0,0,0
2022-02-11 01:45,3,0,3,0,0,0
2022-02-11 02:00,3,0,3,0,0,0
2022-02-11 02:15,2,0,2,0,0,0
2022-02-11 02:30,1,1,0,0,0,0
2022-02-11 02:45,3,0,3,0,0,0
2022-02-11 03:00,3,2,1,0,0,0
2022-02-11 03:15,2,0,2,0,0,0
2022-02-11 03:30,4,0,4,0,0,0
2022-02-11 03:45,1,0,1,0,0,0
2022-02-11 04:00,0,0,0,0,0,0
2022-02-11 04:15,1,1,0,0,0,0
2022-02-11 04:30,0,0,0,0,0,0
2022-02-11 04:45,1,0,1,0,0,0
2022-02-11 05:00,0,0,0,0,0,0
2022-02-11 05:15,2,2,0,0,0,0
2022-02-11 05:30,12,8,4,0,0,0
2022-02-11 05:45,9,1,8,0,0,0
2022-02-11 06:00,11,7,4,0,0,0
2022-02-11 06:15,28,16,12,0,0,0
2022-02-11 06:30,29,16,13,0,0,0
2022-02-11 06:45,48,31,17,0,0,0
2022-02-11 07:00,62,45,17,0,0,0
2022-02-11 07:15,124,78,46,0,0,0
2022-02-11 07:30,303,244,59,0,0,0
2022-02-11 07:45,158,107,51,0,0,0
2022-02-11 08:00,90,65,25,0,0,0
2022-02-11 08:15,122,88,34,0,0,0
2022-02-11 08:30,105,74,31,0,0,0
2022-02-11 08:45,111,86,25,0,0,0
2022-02-11 09:00,80,57,23,0,0,0
2022-02-11 09:15,88,62,26,0,0,0
2022-02-11 09:30,103,75,28,0,0,0
2022-02-11 09:45,79,54,25,0,0,0
2022-02-11 10:00,66,35,31,0,0,0
2022-02-11 10:15,74,53,21,0,0,0
2022-02-11 10:30,61,40,21,0,0,0
2022-02-11 10:45,76,40,36,0,0,0
2022-02-11 11:00,81,51,30,0,0,0
2022-02-11 11:15,93,62,31,0,0,0
2022-02-11 11:30,78,51,27,0,0,0
2022-02-11 11:45,89,49,40,0,0,0
2022-02-11 12:00,79,55,24,0,0,0
2022-02-11 12:15,94,60,34,0,0,0
2022-02-11 12:30,102,46,56,0,0,0
2022-02-11 12:45,115,58,57,0,0,0
2022-02-11 13:00,135,54,81,0,0,0
2022-02-11 13:15,126,47,79,0,0,0
2022-02-11 13:30,70,41,29,0,0,0
2022-02-11 13:45,129,66,63,0,0,0
2022-02-11 14:00,148,58,90,0,0,0
2022-02-11 14:15,102,64,38,0,0,0
2022-02-11 14:30,136,76,60,0,0,0
2022-02-11 14:45,151,76,75,0,0,0
2022-02-11 15:00,128,69,59,0,0,0
2022-02-11 15:15,96,59,37,0,0,0
2022-02-11 15:30,112,73,39,0,0,0
2022-02-11 15:45,142,72,70,0,0,0
2022-02-11 16:00,125,69,56,0,0,0
2022-02-11 16:15,94,59,35,0,0,0
2022-02-11 16:30,103,57,46,0,0,0
2022-02-11 16:45,119,55,64,0,0,0
2022-02-11 17:00,119,58,61,0,0,0
2022-02-11 17:15,108,66,42,0,0,0
2022-02-11 17:30,93,40,53,0,0,0
2022-02-11 17:45,118,53,65,0,0,0
2022-02-11 18:00,103,51,52,0,0,0
2022-02-11 18:15,106,44,62,0,0,0
2022-02-11 18:30,92,45,47,0,0,0
2022-02-11 18:45,127,67,60,0,0,0
2022-02-11 19:00,99,58,41,0,0,0
2022-02-11 19:15,85,42,43,0,0,0
2022-02-11 19:30,81,31,50,0,0,0
2022-02-11 19:45,72,44,28,0,0,0
2022-02-11 20:00,70,31,39,0,0,0
2022-02-11 20:15,54,26,28,0,0,0
2022-02-11 20:30,38,14,24,0,0,0
2022-02-11 20:45,36,20,16,0,0,0
2022-02-11 21:00,43,18,25,0,0,0
2022-02-11 21:15,36,22,14,0,0,0
2022-02-11 21:30,31,15,16,0,0,0
2022-02-11 21:45,22,10,12,0,0,0
2022-02-11 22:00,36,16,20,0,0,0
2022-02-11 22:15,25,7,18,0,0,0
2022-02-11 22:30,38,17,21,0,0,0
2022-02-11 22:45,35,14,21,0,0,0
2022-02-11 23:00,23,5,18,0,0,0
2022-02-11 23:15,24,9,15,0,0,0
2022-02-11 23:30,27,14,13,0,0,0
2022-02-11 23:45,29,12,17,0,0,0
2022-02-12 00:00,31,14,17,0,0,0
2022-02-12 00:15,26,19,7,0,0,0
2022-02-12 00:30,30,15,15,0,0,0
2022-02-12 00:45,25,17,8,0,0,0
2022-02-12 01:00,21,11,10,0,0,0
2022-02-12 01:15,19,5,14,0,0,0
2022-02-12 01:30,6,2,4,0,0,0
2022-02-12 01:45,18,7,11,0,0,0
2022-02-12 02:00,8,2,6,0,0,0
2022-02-12 02:15,12,4,8,0,0,0
2022-02-12 02:30,8,4,4,0,0,0
2022-02-12 02:45,13,1,12,0,0,0
2022-02-12 03:00,7,3,4,0,0,0
2022-02-12 03:15,3,2,1,0,0,0
2022-02-12 03:30,5,3,2,0,0,0
2022-02-12 03:45,9,5,4,0,0,0
2022-02-12 04:00,5,3,2,0,0,0
2022-02-12 04:15,3,0,3,0,0,0
2022-02-12 04:30,2,1,1,0,0,0
2022-02-12 04:45,1,0,1,0,0,0
2022-02-12 05:00,3,2,1,0,0,0
2022-02-12 05:15,6,4,2,0,0,0
2022-02-12 05:30,7,3,4,0,0,0
2022-02-12 05:45,10,2,8,0,0,0
2022-02-12 06:00,9,7,2,0,0,0
2022-02-12 06:15,6,3,3,0,0,0
2022-02-12 06:30,4,2,2,0,0,0
2022-02-12 06:45,9,6,3,0,0,0
2022-02-12 07:00,5,2,3,0,0,0
2022-02-12 07:15,15,13,2,0,0,0
2022-02-12 07:30,16,9,7,0,0,0
2022-02-12 07:45,25,19,6,0,0,0
2022-02-12 08:00,19,15,4,0,0,0
2022-02-12 08:15,30,22,8,0,0,0
2022-02-12 08:30,27,18,9,0,0,0
2022-02-12 08:45,49,29,20,0,0,0
2022-02-12 09:00,43,38,5,0,0,0
2022-02-12 09:15,65,57,8,0,0,0
2022-02-12 09:30,64,50,14,0,0,0
2022-02-12 09:45,111,88,23,0,0,0
2022-02-12 10:00,109,80,29,0,0,0
2022-02-12 10:15,98,78,20,0,0,0
2022-02-12 10:30,98,68,30,0,0,0
2022-02-12 10:45,124,82,42,0,0,0
2022-02-12 11:00,119,90,29,0,0,0
2022-02-12 11:15,107,66,41,0,0,0
2022-02-12 11:30,140,111,29,0,0,0
2022-02-12 11:45,170,108,62,0,0,0
2022-02-12 12:00,130,84,46,0,0,0
2022-02-12 12:15,171,108,63,0,0,0
2022-02-12 12:30,138,85,53,0,0,0
2022-02-12 12:45,139,95,44,0,0,0
2022-02-12 13:00,114,56,58,0,0,0
2022-02-12 13:15,171,106,65,0,0,0
2022-02-12 13:30,164,91,73,0,0,0
2022-02-12 13:45,123,63,60,0,0,0
2022-02-12 14:00,122,70,52,0,0,0
2022-02-12 14:15,118,56,62,0,0,0
2022-02-12 14:30,116,56,60,0,0,0
2022-02-12 14:45,138,57,81,0,0,0
2022-02-12 15:00,120,63,57,0,0,0
2022-02-12 15:15,102,51,51,0,0,0
2022-02-12 15:30,120,71,49,0,0,0
2022-02-12 15:45,87,42,45,0,0,0
2022-02-12 16:00,78,35,43,0,0,0
2022-02-12 16:15,96,41,55,0,0,0
2022-02-12 16:30,110,48,62,0,0,0
2022-02-12 16:45,81,33,48,0,0,0
2022-02-12 17:00,68,31,37,0,0,0
2022-02-12 17:15,74,40,34,0,0,0
2022-02-12 17:30,78,38,40,0,0,0
2022-02-12 17:45,92,38,54,0,0,0
2022-02-12 18:00,81,40,41,0,0,0
2022-02-12 18:15,76,40,36,0,0,0
2022-02-12 18:30,75,34,41,0,0,0
2022-02-12 18:45,87,48,39,0,0,0
2022-02-12 19:00,79,48,31,0,0,0
2022-02-12 19:15,72,42,30,0,0,0
2022-02-12 19:30,54,30,24,0,0,0
2022-02-12 19:45,45,29,16,0,0,0
2022-02-12 20:00,66,26,40,0,0,0
2022-02-12 20:15,45,24,21,0,0,0
2022-02-12 20:30,25,16,9,0,0,0
2022-02-12 20:45,40,23,17,0,0,0
2022-02-12 21:00,30,15,15,0,0,0
2022-02-12 21:15,27,15,12,0,0,0
2022-02-12 21:30,15,4,11,0,0,0
2022-02-12 21:45,20,6,14,0,0,0
2022-02-12 22:00,32,11,21,0,0,0
2022-02-12 22:15,29,12,17,0,0,0
2022-02-12 22:30,25,12,13,0,0,0
2022-02-12 22:45,33,17,16,0,0,0
2022-02-12 23:00,14,8,6,0,0,0
2022-02-12 23:15,26,6,20,0,0,0
2022-02-12 23:30,22,7,15,0,0,0
2022-02-12 23:45,26,13,13,0,0,0
2022-02-13 00:00,19,7,12,0,0,0
2022-02-13 00:15,28,8,20,0,0,0
2022-02-13 00:30,19,1,18,0,0,0
2022-02-13 00:45,19,6,13,0,0,0
2022-02-13 01:00,34,22,12,0,0,0
2022-02-13 01:15,15,5,10,0,0,0
2022-02-13 01:30,20,7,13,0,0,0
2022-02-13 01:45,9,1,8,0,0,0
2022-02-13 02:00,12,3,9,0,0,0
2022-02-13 02:15,6,0,6,0,0,0
2022-02-13 02:30,9,2,7,0,0,0
2022-02-13 02:45,4,2,2,0,0,0
2022-02-13 03:00,10,4,6,0,0,0
2022-02-13 03:15,9,0,9,0,0,0
2022-02-13 03:30,1,0,1,0,0,0
2022-02-13 03:45,1,0,1,0,0,0
2022-02-13 04:00,4,2,2,0,0,0
2022-02-13 04:15,5,1,4,0,0,0
2022-02-13 04:30,1,1,0,0,0,0
2022-02-13 04:45,1,0,1,0,0,0
2022-02-13 05:00,1,0,1,0,0,0
2022-02-13 05:15,3,1,2,0,0,0
2022-02-13 05:30,7,4,3,0,0,0
2022-02-13 05:45,3,0,3,0,0,0
2022-02-13 06:00,2,0,2,0,0,0
2022-02-13 06:15,3,2,1,0,0,0
2022-02-13 06:30,0,0,0,0,0,0
2022-02-13 06:45,6,2,4,0,0,0
2022-02-13 07:00,2,1,1,0,0,0
2022-02-13 07:15,2,0,2,0,0,0
2022-02-13 07:30,7,4,3,0,0,0
2022-02-13 07:45,7,6,1,0,0,0
2022-02-13 08:00,7,5,2,0,0,0
2022-02-13 08:15,8,6,2,0,0,0
2022-02-13 08:30,9,7,2,0,0,0
2022-02-13 08:45,16,14,2,0,0,0
2022-02-13 09:00,24,17,7,0,0,0
2022-02-13 09:15,21,17,4,0,0,0
2022-02-13 09:30,36,25,11,0,0,0
2022-02-13 09:45,30,19,11,0,0,0
2022-02-13 10:00,29,20,9,0,0,0
2022-02-13 10:15,35,20,15,0,0,0
2022-02-13 10:30,18,11,7,0,0,0
2022-02-13 10:45,43,27,16,0,0,0
2022-02-13 11:00,52,27,25,0,0,0
2022-02-13 11:15,50,28,22,0,0,0
2022-02-13 11:30,31,19,12,0,0,0
2022-02-13 11:45,52,25,27,0,0,0
2022-02-13 12:00,64,43,21,0,0,0
2022-02-13 12:15,53,29,24,0,0,0
2022-02-13 12:30,60,36,24,0,0,0
2022-02-13 12:45,56,27,29,0,0,0
2022-02-13 13:00,74,36,38,0,0,0
2022-02-13 13:15,55,28,27,0,0,0
2022-02-13 13:30,64,33,31,0,0,0
2022-02-13 13:45,75,58,17,0,0,0
2022-02-13 14:00,62,40,22,0,0,0
2022-02-13 14:15,73,50,23,0,0,0
2022-02-13 14:30,56,28,28,0,0,0
2022-02-13 14:45,95,59,36,0,0,0
2022-02-13 15:00,79,37,42,0,0,0
2022-02-13 15:15,73,50,23,0,0,0
2022-02-13 15:30,104,70,34,0,0,0
2022-02-13 15:45,90,45,45,0,0,0
2022-02-13 16:00,66,41,25,0,0,0
2022-02-13 16:15,80,45,35,0,0,0
2022-02-13 16:30,62,40,22,0,0,0
2022-02-13 16:45,65,45,20,0,0,0
2022-02-13 17:00,62,36,26,0,0,0
2022-02-13 17:15,55,29,26,0,0,0
2022-02-13 17:30,66,40,26,0,0,0
2022-02-13 17:45,80,44,36,0,0,0
2022-02-13 18:00,54,32,22,0,0,0
2022-02-13 18:15,38,13,25,0,0,0
2022-02-13 18:30,42,21,21,0,0,0
2022-02-13 18:45,47,25,22,0,0,0
2022-02-13 19:00,38,18,20,0,0,0
2022-02-13 19:15,41,19,22,0,0,0
2022-02-13 19:30,50,21,29,0,0,0
2022-02-13 19:45,48,11,37,0,0,0
2022-02-13 20:00,46,26,20,0,0,0
2022-02-13 20:15,33,15,18,0,0,0
2022-02-13 20:30,19,12,7,0,0,0
2022-02-13 20:45,28,18,10,0,0,0
2022-02-13 21:00,24,12,12,0,0,0
2022-02-13 21:15,18,8,10,0,0,0
2022-02-13 21:30,19,8,11,0,0,0
2022-02-13 21:45,14,11,3,0,0,0
2022-02-13 22:00,23,8,15,0,0,0
2022-02-13 22:15,26,19,7,0,0,0
2022-02-13 22:30,19,8,11,0,0,0
2022-02-13 22:45,16,10,6,0,0,0
2022-02-13 23:00,11,7,4,0,0,0
2022-02-13 23:15,4,3,1,0,0,0
2022-02-13 23:30,8,4,4,0,0,0
2022-02-13 23:45,4,2,2,0,0,0
2022-02-14 00:00,3,2,1,0,0,0
2022-02-14 00:15,4,1,3,0,0,0
2022-02-14 00:30,0,0,0,0,0,0
2022-02-14 00:45,2,1,1,0,0,0
2022-02-14 01:00,0,0,0,0,0,0
2022-02-14 01:15,1,0,1,0,0,0
2022-02-14 01:30,2,1,1,0,0,0
2022-02-14 01:45,2,1,1,0,0,0
2022-02-14 02:00,0,0,0,0,0,0
2022-02-14 02:15,2,0,2,0,0,0
2022-02-14 02:30,4,4,0,0,0,0
2022-02-14 02:45,1,0,1,0,0,0
2022-02-14 03:00,2,2,0,0,0,0
2022-02-14 03:15,0,0,0,0,0,0
2022-02-14 03:30,1,1,0,0,0,0
2022-02-14 03:45,1,0,1,0,0,0
2022-02-14 04:00,1,0,1,0,0,0
2022-02-14 04:15,18,12,6,0,0,0
2022-02-14 04:30,8,1,7,0,0,0
2022-02-14 04:45,2,0,2,0,0,0
2022-02-14 05:00,1,0,1,0,0,0
2022-02-14 05:15,2,2,0,0,0,0
2022-02-14 05:30,16,12,4,0,0,0
2022-02-14 05:45,15,6,9,0,0,0
2022-02-14 06:00,17,9,8,0,0,0
2022-02-14 06:15,27,16,11,0,0,0
2022-02-14 06:30,36,19,17,0,0,0
2022-02-14 06:45,48,31,17,0,0,0
2022-02-14 07:00,69,48,21,0,0,0
2022-02-14 07:15,139,106,33,0,0,0
2022-02-14 07:30,319,257,62,0,0,0
2022-02-14 07:45,183,127,56,0,0,0
2022-02-14 08:00,119,84,35,0,0,0
2022-02-14 08:15,126,94,32,0,0,0
2022-02-14 08:30,143,105,38,0,0,0
2022-02-14 08:45,119,91,28,0,0,0
2022-02-14 09:00,88,57,31,0,0,0
2022-02-14 09:15,67,44,23,0,0,0
2022-02-14 09:30,86,64,22,0,0,0
2022-02-14 09:45,91,63,28,0,0,0
2022-02-14 10:00,69,52,17,0,0,0
2022-02-14 10:15,66,42,24,0,0,0
2022-02-14 10:30,68,45,23,0,0,0
2022-02-14 10:45,75,51,24,0,0,0
2022-02-14 11:00,63,49,14,0,0,0
2022-02-14 11:15,90,42,48,0,0,0
2022-02-14 11:30,77,47,30,0,0,0
2022-02-14 11:45,83,50,33,0,0,0
2022-02-14 12:00,77,46,31,0,0,0
2022-02-14 12:15,97,55,42,0,0,0
2022-02-14 12:30,122,51,71,0,0,0
2022-02-14 12:45,105,55,50,0,0,0
2022-02-14 13:00,113,43,70,0,0,0
2022-02-14 13:15,90,43,47,0,0,0
2022-02-14 13:30,101,37,64,0,0,0
2022-02-14 13:45,88,50,38,0,0,0
2022-02-14 14:00,125,58,67,0,0,0
2022-02-14 14:15,102,52,50,0,0,0
2022-02-14 14:30,92,49,43,0,0,0
2022-02-14 14:45,135,67,68,0,0,0
2022-02-14 15:00,120,59,61,0,0,0
2022-02-14 15:15,100,49,51,0,0,0
2022-02-14 15:30,138,76,62,0,0,0
2022-02-14 15:45,132,67,65,0,0,0
2022-02-14 16:00,173,106,67,0,0,0
2022-02-14 16:15,157,94,63,0,0,0
2022-02-14 16:30,151,70,81,0,0,0
2022-02-14 16:45,149,77,72,0,0,0
2022-02-14 17:00,143,74,69,0,0,0
2022-02-14 17:15,137,59,78,0,0,0
2022-02-14 17:30,145,62,83,0,0,0
2022-02-14 17:45,171,96,75,0,0,0
2022-02-14 18:00,141,53,88,0,0,0
2022-02-14 18:15,131,68,63,0,0,0
2022-02-14 18:30,109,50,59,0,0,0
2022-02-14 18:45,87,43,44,0,0,0
2022-02-14 19:00,83,39,44,0,0,0
2022-02-14 19:15,79,39,40,0,0,0
2022-02-14 19:30,88,39,49,0,0,0
2022-02-14 19:45,83,37,46,0,0,0
2022-02-14 20:00,63,24,39,0,0,0
2022-02-14 20:15,41,20,21,0,0,0
2022-02-14 20:30,40,15,25,0,0,0
2022-02-14 20:45,36,12,24,0,0,0
2022-02-14 21:00,40,19,21,0,0,0
2022-02-14 21:15,41,15,26,0,0,0
2022-02-14 21:30,30,11,19,0,0,0
2022-02-14 21:45,34,13,21,0,0,0
2022-02-14 22:00,43,20,23,0,0,0
2022-02-14 22:15,32,15,17,0,0,0
2022-02-14 22:30,26,19,7,0,0,0
2022-02-14 22:45,19,5,14,0,0,0
2022-02-14 23:00,11,4,7,0,0,0
2022-02-14 23:15,15,4,11,0,0,0
2022-02-14 23:30,5,1,4,0,0,0
2022-02-14 23:45,8,5,3,0,0,0
2022-02-15 00:00,16,9,7,0,0,0
2022-02-15 00:15,6,4,2,0,0,0
2022-02-15 00:30,7,1,6,0,0,0
2022-02-15 00:45,0,0,0,0,0,0
2022-02-15 01:00,5,0,5,0,0,0
2022-02-15 01:15,5,3,2,0,0,0
2022-02-15 01:30,2,2,0,0,0,0
2022-02-15 01:45,1,1,0,0,0,0
2022-02-15 02:00,2,0,2,0,0,0
2022-02-15 02:15,0,0,0,0,0,0
2022-02-15 02:30,4,2,2,0,0,0
2022-02-15 02:45,0,0,0,0,0,0
2022-02-15 03:00,1,0,1,0,0,0
2022-02-15 03:15,2,2,0,0,0,0
2022-02-15 03:30,0,0,0,0,0,0
2022-02-15 03:45,1,0,1,0,0,0
2022-02-15 04:00,2,1,1,0,0,0
2022-02-15 04:15,3,1,2,0,0,0
2022-02-15 04:30,0,0,0,0,0,0
2022-02-15 04:45,3,0,3,0,0,0
2022-02-15 05:00,0,0,0,0,0,0
2022-02-15 05:15,5,2,3,0,0,0
2022-02-15 05:30,17,12,5,0,0,0
2022-02-15 05:45,11,4,7,0,0,0
2022-02-15 06:00,21,9,12,0,0,0
2022-02-15 06:15,28,13,15,0,0,0
2022-02-15 06:30,41,21,20,0,0,0
2022-02-15 06:45,44,30,14,0,0,0
2022-02-15 07:00,86,58,28,0,0,0
2022-02-15 07:15,147,110,37,0,0,0
2022-02-15 07:30,326,281,45,0,0,0
2022-02-15 07:45,168,112,56,0,0,0
2022-02-15 08:00,109,80,29,0,0,0
2022-02-15 08:15,144,104,40,0,0,0
2022-02-15 08:30,123,97,26,0,0,0
2022-02-15 08:45,158,132,26,0,0,0
2022-02-15 09:00,92,61,31,0,0,0
2022-02-15 09:15,70,41,29,0,0,0
2022-02-15 09:30,110,77,33,0,0,0
2022-02-15 09:45,82,56,26,0,0,0
2022-02-15 10:00,79,57,22,0,0,0
2022-02-15 10:15,75,54,21,0,0,0
2022-02-15 10:30,74,49,25,0,0,0
2022-02-15 10:45,93,58,35,0,0,0
2022-02-15 11:00,77,46,31,0,0,0
2022-02-15 11:15,75,49,26,0,0,0
2022-02-15 11:30,74,45,29,0,0,0
2022-02-15 11:45,84,51,33,0,0,0
2022-02-15 12:00,76,39,37,0,0,0
2022-02-15 12:15,98,55,43,0,0,0
2022-02-15 12:30,112,57,55,0,0,0
2022-02-15 12:45,96,56,40,0,0,0
2022-02-15 13:00,127,65,62,0,0,0
2022-02-15 13:15,119,61,58,0,0,0
2022-02-15 13:30,111,63,48,0,0,0
2022-02-15 13:45,125,66,59,0,0,0
2022-02-15 14:00,116,52,64,0,0,0
2022-02-15 14:15,115,65,50,0,0,0
2022-02-15 14:30,101,60,41,0,0,0
2022-02-15 14:45,129,63,66,0,0,0
2022-02-15 15:00,108,48,60,0,0,0
2022-02-15 15:15,115,60,55,0,0,0
2022-02-15 15:30,120,73,47,0,0,0
2022-02-15 15:45,164,87,77,0,0,0
2022-02-15 16:00,153,76,77,0,0,0
2022-02-15 16:15,150,78,72,0,0,0
2022-02-15 16:30,131,63,68,0,0,0
2022-02-15 16:45,150,82,68,0,0,0
2022-02-15 17:00,147,63,84,0,0,0
2022-02-15 17:15,135,64,71,0,0,0
2022-02-15 17:30,146,71,75,0,0,0
2022-02-15 17:45,139,70,69,0,0,0
2022-02-15 18:00,118,59,59,0,0,0
2022-02-15 18:15,152,76,76,0,0,0
2022-02-15 18:30,92,43,49,0,0,0
2022-02-15 18:45,92,45,47,0,0,0
2022-02-15 19:00,93,48,45,0,0,0
2022-02-15 19:15,82,34,48,0,0,0
2022-02-15 19:30,78,36,42,0,0,0
2022-02-15 19:45,53,22,31,0,0,0
2022-02-15 20:00,58,25,33,0,0,0
2022-02-15 20:15,47,21,26,0,0,0
2022-02-15 20:30,35,12,23,0,0,0
2022-02-15 20:45,31,15,16,0,0,0
2022-02-15 21:00,43,17,26,0,0,0
2022-02-15 21:15,31,10,21,0,0,0
2022-02-15 21:30,46,22,24,0,0,0
2022-02-15 21:45,41,21,20,0,0,0
2022-02-15 22:00,31,12,19,0,0,0
2022-02-15 22:15,29,13,16,0,0,0
2022-02-15 22:30,19,11,8,0,0,0
2022-02-15 22:45,22,10,12,0,0,0
2022-02-15 23:00,26,14,12,0,0,0
2022-02-15 23:15,12,6,6,0,0,0
2022-02-15 23:30,9,2,7,0,0,0
2022-02-15 23:45,7,2,5,0,0,0
2022-02-16 00:00,8,3,5,0,0,0
2022-02-16 00:15,2,0,2,0,0,0
2022-02-16 00:30,8,1,7,0,0,0
2022-02-16 00:45,1,1,0,0,0,0
2022-02-16 01:00,7,1,6,0,0,0
2022-02-16 01:15,0,0,0,0,0,0
2022-02-16 01:30,1,0,1,0,0,0
2022-02-16 01:45,1,1,0,0,0,0
2022-02-16 02:00,1,0,1,0,0,0
2022-02-16 02:15,1,0,1,0,0,0
2022-02-16 02:30,1,1,0,0,0,0
2022-02-16 02:45,1,0,1,0,0,0
2022-02-16 03:00,1,0,1,0,0,0
2022-02-16 03:15,1,0,1,0,0,0
2022-02-16 03:30,0,0,0,0,0,0
2022-02-16 03:45,1,1,0,0,0,0
2022-02-16 04:00,0,0,0,0,0,0
2022-02-16 04:15,2,1,1,0,0,0
2022-02-16 04:30,0,0,0,0,0,0
2022-02-16 04:45,1,1,0,0,0,0
2022-02-16 05:00,1,1,0,0,0,0
2022-02-16 05:15,2,1,1,0,0,0
2022-02-16 05:30,10,6,4,0,0,0
2022-02-16 05:45,15,7,8,0,0,0
2022-02-16 06:00,11,6,5,0,0,0
2022-02-16 06:15,19,13,6,0,0,0
2022-02-16 06:30,29,18,11,0,0,0
2022-02-16 06:45,37,23,14,0,0,0
2022-02-16 07:00,74,48,26,0,0,0
2022-02-16 07:15,147,108,39,0,0,0
2022-02-16 07:30,282,226,56,0,0,0
2022-02-16 07:45,137,85,52,0,0,0
2022-02-16 08:00,98,69,29,0,0,0
2022-02-16 08:15,113,73,40,0,0,0
2022-02-16 08:30,107,80,27,0,0,0
2022-02-16 08:45,109,79,30,0,0,0
2022-02-16 09:00,93,66,27,0,0,0
2022-02-16 09:15,61,46,15,0,0,0
2022-02-16 09:30,88,65,23,0,0,0
2022-02-16 09:45,84,64,20,0,0,0
2022-02-16 10:00,51,44,7,0,0,0
2022-02-16 10:15,64,41,23,0,0,0
2022-02-16 10:30,54,36,18,0,0,0
2022-02-16 10:45,80,50,30,0,0,0
2022-02-16 11:00,61,46,15,0,0,0
2022-02-16 11:15,66,29,37,0,0,0
2022-02-16 11:30,77,33,44,0,0,0
2022-02-16 11:45,75,43,32,0,0,0
2022-02-16 12:00,53,25,28,0,0,0
2022-02-16 12:15,93,49,44,0,0,0
2022-02-16 12:30,85,42,43,0,0,0
2022-02-16 12:45,92,44,48,0,0,0
2022-02-16 13:00,43,13,30,0,0,0
2022-02-16 13:15,91,42,49,0,0,0
2022-02-16 13:30,70,43,27,0,0,0
2022-02-16 13:45,115,52,63,0,0,0
2022-02-16 14:00,113,38,75,0,0,0
2022-02-16 14:15,67,37,30,0,0,0
2022-02-16 14:30,75,43,32,0,0,0
2022-02-16 14:45,69,35,34,0,0,0
2022-02-16 15:00,71,39,32,0,0,0
2022-02-16 15:15,73,37,36,0,0,0
2022-02-16 15:30,81,43,38,0,0,0
2022-02-16 15:45,106,69,37,0,0,0
2022-02-16 16:00,101,47,54,0,0,0
2022-02-16 16:15,106,55,51,0,0,0
2022-02-16 16:30,96,49,47,0,0,0
2022-02-16 16:45,87,41,46,0,0,0
2022-02-16 17:00,84,51,33,0,0,0
2022-02-16 17:15,99,55,44,0,0,0
2022-02-16 17:30,81,40,41,0,0,0
2022-02-16 17:45,110,55,55,0,0,0
2022-02-16 18:00,90,39,51,0,0,0
2022-02-16 18:15,71,26,45,0,0,0
2022-02-16 18:30,63,32,31,0,0,0
2022-02-16 18:45,54,18,36,0,0,0
2022-02-16 19:00,42,19,23,0,0,0
2022-02-16 19:15,63,29,34,0,0,0
2022-02-16 19:30,36,16,20,0,0,0
2022-02-16 19:45,38,12,26,0,0,0
2022-02-16 20:00,46,17,29,0,0,0
2022-02-16 20:15,31,8,23,0,0,0
2022-02-16 20:30,26,12,14,0,0,0
2022-02-16 20:45,16,9,7,0,0,0
2022-02-16 21:00,18,8,10,0,0,0
2022-02-16 21:15,15,5,10,0,0,0
2022-02-16 21:30,13,7,6,0,0,0
2022-02-16 21:45,19,10,9,0,0,0
2022-02-16 22:00,25,9,16,0,0,0
2022-02-16 22:15,16,6,10,0,0,0
2022-02-16 22:30,8,1,7,0,0,0
2022-02-16 22:45,16,6,10,0,0,0
2022-02-16 23:00,11,5,6,0,0,0
2022-02-16 23:15,10,9,1,0,0,0
2022-02-16 23:30,14,5,9,0,0,0
2022-02-16 23:45,7,5,2,0,0,0
2022-02-17 00:00,1,0,1,0,0,0
2022-02-17 00:15,3,2,1,0,0,0
2022-02-17 00:30,13,12,1,0,0,0
2022-02-17 00:45,7,5,2,0,0,0
2022-02-17 01:00,1,1,0,0,0,0
2022-02-17 01:15,1,0,1,0,0,0
2022-02-17 01:30,4,3,1,0,0,0
2022-02-17 01:45,2,0,2,0,0,0
2022-02-17 02:00,2,1,1,0,0,0
2022-02-17 02:15,0,0,0,0,0,0
2022-02-17 02:30,0,0,0,0,0,0
2022-02-17 02:45,3,2,1,0,0,0
2022-02-17 03:00,1,1,0,0,0,0
2022-02-17 03:15,0,0,0,0,0,0
2022-02-17 03:30,2,2,0,0,0,0
2022-02-17 03:45,0,0,0,0,0,0
2022-02-17 04:00,3,2,1,0,0,0
2022-02-17 04:15,1,0,1,0,0,0
2022-02-17 04:30,1,0,1,0,0,0
2022-02-17 04:45,2,1,1,0,0,0
2022-02-17 05:00,0,0,0,0,0,0
2022-02-17 05:15,2,2,0,0,0,0
2022-02-17 05:30,8,5,3,0,0,0
2022-02-17 05:45,7,2,5,0,0,0
2022-02-17 06:00,6,2,4,0,0,0
2022-02-17 06:15,12,6,6,0,0,0
2022-02-17 06:30,19,11,8,0,0,0
2022-02-17 06:45,18,9,9,0,0,0
2022-02-17 07:00,32,17,15,0,0,0
2022-02-17 07:15,41,15,26,0,0,0
2022-02-17 07:30,66,51,15,0,0,0
2022-02-17 07:45,70,43,27,0,0,0
2022-02-17 08:00,59,41,18,0,0,0
2022-02-17 08:15,62,41,21,0,0,0
2022-02-17 08:30,61,44,17,0,0,0
2022-02-17 08:45,62,45,17,0,0,0
2022-02-17 09:00,53,41,12,0,0,0
2022-02-17 09:15,37,27,10,0,0,0
2022-02-17 09:30,43,31,12,0,0,0
2022-02-17 09:45,49,30,19,0,0,0
2022-02-17 10:00,33,22,11,0,0,0
2022-02-17 10:15,37,28,9,0,0,0
2022-02-17 10:30,44,25,19,0,0,0
2022-02-17 10:45,46,31,15,0,0,0
2022-02-17 11:00,33,20,13,0,0,0
2022-02-17 11:15,30,18,12,0,0,0
2022-02-17 11:30,48,35,13,0,0,0
2022-02-17 11:45,34,16,18,0,0,0
2022-02-17 12:00,49,27,22,0,0,0
2022-02-17 12:15,43,26,17,0,0,0
2022-02-17 12:30,64,41,23,0,0,0
2022-02-17 12:45,43,23,20,0,0,0
2022-02-17 13:00,46,25,21,0,0,0
2022-02-17 13:15,65,38,27,0,0,0
2022-02-17 13:30,47,23,24,0,0,0
2022-02-17 13:45,63,42,21,0,0,0
2022-02-17 14:00,51,35,16,0,0,0
2022-02-17 14:15,60,35,25,0,0,0
2022-02-17 14:30,60,30,30,0,0,0
2022-02-17 14:45,68,37,31,0,0,0
2022-02-17 15:00,76,34,42,0,0,0
2022-02-17 15:15,57,25,32,0,0,0
2022-02-17 15:30,61,33,28,0,0,0
2022-02-17 15:45,92,52,40,0,0,0
2022-02-17 16:00,83,50,33,0,0,0
2022-02-17 16:15,88,55,33,0,0,0
2022-02-17 16:30,89,47,42,0,0,0
2022-02-17 16:45,88,41,47,0,0,0
2022-02-17 17:00,93,47,46,0,0,0
2022-02-17 17:15,111,58,53,0,0,0
2022-02-17 17:30,74,33,41,0,0,0
2022-02-17 17:45,99,45,54,0,0,0
2022-02-17 18:00,87,43,44,0,0,0
2022-02-17 18:15,88,43,45,0,0,0
2022-02-17 18:30,62,31,31,0,0,0
2022-02-17 18:45,78,36,42,0,0,0
2022-02-17 19:00,63,24,39,0,0,0
2022-02-17 19:15,48,25,23,0,0,0
2022-02-17 19:30,40,14,26,0,0,0
2022-02-17 19:45,42,18,24,0,0,0
2022-02-17 20:00,54,20,34,0,0,0
2022-02-17 20:15,35,19,16,0,0,0
2022-02-17 20:30,25,13,12,0,0,0
2022-02-17 20:45,28,11,17,0,0,0
2022-02-17 21:00,18,8,10,0,0,0
2022-02-17 21:15,16,8,8,0,0,0
2022-02-17 21:30,32,14,18,0,0,0
2022-02-17 21:45,16,11,5,0,0,0
2022-02-17 22:00,24,10,14,0,0,0
2022-02-17 22:15,23,11,12,0,0,0
2022-02-17 22:30,28,14,14,0,0,0
2022-02-17 22:45,19,6,13,0,0,0
2022-02-17 23:00,21,7,14,0,0,0
2022-02-17 23:15,14,4,10,0,0,0
2022-02-17 23:30,8,5,3,0,0,0
2022-02-17 23:45,9,4,5,0,0,0
2022-02-18 00:00,7,3,4,0,0,0
2022-02-18 00:15,8,5,3,0,0,0
2022-02-18 00:30,8,4,4,0,0,0
2022-02-18 00:45,4,2,2,0,0,0
2022-02-18 01:00,4,1,3,0,0,0
2022-02-18 01:15,5,3,2,0,0,0
2022-02-18 01:30,2,1,1,0,0,0
2022-02-18 01:45,6,4,2,0,0,0
2022-02-18 02:00,1,0,1,0,0,0
2022-02-18 02:15,0,0,0,0,0,0
2022-02-18 02:30,1,1,0,0,0,0
2022-02-18 02:45,0,0,0,0,0,0
2022-02-18 03:00,3,1,2,0,0,0
2022-02-18 03:15,2,2,0,0,0,0
2022-02-18 03:30,0,0,0,0,0,0
2022-02-18 03:45,0,0,0,0,0,0
2022-02-18 04:00,0,0,0,0,0,0
2022-02-18 04:15,3,1,2,0,0,0
2022-02-18 04:30,3,1,2,0,0,0
2022-02-18 04:45,0,0,0,0,0,0
2022-02-18 05:00,2,2,0,0,0,0
2022-02-18 05:15,7,6,1,0,0,0
2022-02-18 05:30,11,9,2,0,0,0
2022-02-18 05:45,15,4,11,0,0,0
2022-02-18 06:00,10,7,3,0,0,0
2022-02-18 06:15,14,7,7,0,0,0
2022-02-18 06:30,35,18,17,0,0,0
2022-02-18 06:45,39,28,11,0,0,0
2022-02-18 07:00,62,39,23,0,0,0
2022-02-18 07:15,134,98,36,0,0,0
2022-02-18 07:30,276,229,47,0,0,0
2022-02-18 07:45,152,106,46,0,0,0
2022-02-18 08:00,77,61,16,0,0,0
2022-02-18 08:15,89,67,22,0,0,0
2022-02-18 08:30,102,67,35,0,0,0
2022-02-18 08:45,98,67,31,0,0,0
2022-02-18 09:00,80,49,31,0,0,0
2022-02-18 09:15,77,54,23,0,0,0
2022-02-18 09:30,52,38,14,0,0,0
2022-02-18 09:45,61,40,21,0,0,0
2022-02-18 10:00,62,43,19,0,0,0
2022-02-18 10:15,55,39,16,0,0,0
2022-02-18 10:30,49,34,15,0,0,0
2022-02-18 10:45,48,31,17,0,0,0
2022-02-18 11:00,63,37,26,0,0,0
2022-02-18 11:15,61,39,22,0,0,0
2022-02-18 11:30,73,35,38,0,0,0
2022-02-18 11:45,59,34,25,0,0,0
2022-02-18 12:00,74,41,33,0,0,0
2022-02-18 12:15,83,54,29,0,0,0
2022-02-18 12:30,89,45,44,0,0,0
2022-02-18 12:45,105,56,49,0,0,0
2022-02-18 13:00,136,59,77,0,0,0
2022-02-18 13:15,108,38,70,0,0,0
2022-02-18 13:30,96,48,48,0,0,0
2022-02-18 13:45,132,59,73,0,0,0
2022-02-18 14:00,162,51,111,0,0,0
2022-02-18 14:15,97,50,47,0,0,0
2022-02-18 14:30,91,44,47,0,0,0
2022-02-18 14:45,87,45,42,0,0,0
2022-02-18 15:00,77,41,36,0,0,0
2022-02-18 15:15,96,45,51,0,0,0
2022-02-18 15:30,55,22,33,0,0,0
2022-02-18 15:45,44,15,29,0,0,0
2022-02-18 16:00,49,19,30,0,0,0
2022-02-18 16:15,48,27,21,0,0,0
2022-02-18 16:30,49,24,25,0,0,0
2022-02-18 16:45,43,22,21,0,0,0
2022-02-18 17:00,48,26,22,0,0,0
2022-02-18 17:15,55,27,28,0,0,0
2022-02-18 17:30,58,29,29,0,0,0
2022-02-18 17:45,62,31,31,0,0,0
2022-02-18 18:00,47,15,32,0,0,0
2022-02-18 18:15,48,24,24,0,0,0
2022-02-18 18:30,21,11,10,0,0,0
2022-02-18 18:45,36,17,19,0,0,0
2022-02-18 19:00,26,10,16,0,0,0
2022-02-18 19:15,19,10,9,0,0,0
2022-02-18 19:30,22,5,17,0,0,0
2022-02-18 19:45,27,14,13,0,0,0
2022-02-18 20:00,17,5,12,0,0,0
2022-02-18 20:15,13,6,7,0,0,0
2022-02-18 20:30,10,2,8,0,0,0
2022-02-18 20:45,14,5,9,0,0,0
2022-02-18 21:00,14,8,6,0,0,0
2022-02-18 21:15,13,3,10,0,0,0
2022-02-18 21:30,11,1,10,0,0,0
2022-02-18 21:45,8,2,6,0,0,0
2022-02-18 22:00,10,4,6,0,0,0
2022-02-18 22:15,6,3,3,0,0,0
2022-02-18 22:30,6,3,3,0,0,0
2022-02-18 22:45,8,7,1,0,0,0
2022-02-18 23:00,11,8,3,0,0,0
2022-02-18 23:15,9,4,5,0,0,0
2022-02-18 23:30,8,4,4,0,0,0
2022-02-18 23:45,6,3,3,0,0,0
2022-02-19 00:00,8,6,2,0,0,0
2022-02-19 00:15,12,5,7,0,0,0
2022-02-19 00:30,12,3,9,0,0,0
2022-02-19 00:45,9,7,2,0,0,0
2022-02-19 01:00,4,2,2,0,0,0
2022-02-19 01:15,3,1,2,0,0,0
2022-02-19 01:30,4,2,2,0,0,0
2022-02-19 01:45,5,0,5,0,0,0
2022-02-19 02:00,2,0,2,0,0,0
2022-02-19 02:15,5,0,5,0,0,0
2022-02-19 02:30,5,1,4,0,0,0
2022-02-19 02:45,5,2,3,0,0,0
2022-02-19 03:00,2,0,2,0,0,0
2022-02-19 03:15,3,1,2,0,0,0
2022-02-19 03:30,0,0,0,0,0,0
2022-02-19 03:45,3,3,0,0,0,0
2022-02-19 04:00,1,0,1,0,0,0
2022-02-19 04:15,0,0,0,0,0,0
2022-02-19 04:30,2,0,2,0,0,0
2022-02-19 04:45,4,1,3,0,0,0
2022-02-19 05:00,1,0,1,0,0,0
2022-02-19 05:15,9,8,1,0,0,0
2022-02-19 05:30,7,3,4,0,0,0
2022-02-19 05:45,8,5,3,0,0,0
2022-02-19 06:00,10,4,6,0,0,0
2022-02-19 06:15,1,1,0,0,0,0
2022-02-19 06:30,4,1,3,0,0,0
2022-02-19 06:45,6,5,1,0,0,0
2022-02-19 07:00,4,2,2,0,0,0
2022-02-19 07:15,8,6,2,0,0,0
2022-02-19 07:30,12,7,5,0,0,0
2022-02-19 07:45,13,8,5,0,0,0
2022-02-19 08:00,22,15,7,0,0,0
2022-02-19 08:15,15,11,4,0,0,0
2022-02-19 08:30,25,17,8,0,0,0
2022-02-19 08:45,31,22,9,0,0,0
2022-02-19 09:00,36,22,14,0,0,0
2022-02-19 09:15,52,35,17,0,0,0
2022-02-19 09:30,58,45,13,0,0,0
2022-02-19 09:45,103,78,25,0,0,0
2022-02-19 10:00,82,60,22,0,0,0
2022-02-19 10:15,104,77,27,0,0,0
2022-02-19 10:30,92,64,28,0,0,0
2022-02-19 10:45,94,61,33,0,0,0
2022-02-19 11:00,102,68,34,0,0,0
2022-02-19 11:15,92,57,35,0,0,0
2022-02-19 11:30,112,75,37,0,0,0
2022-02-19 11:45,133,92,41,0,0,0
2022-02-19 12:00,114,86,28,0,0,0
2022-02-19 12:15,90,63,27,0,0,0
2022-02-19 12:30,101,55,46,0,0,0
2022-02-19 12:45,104,52,52,0,0,0
2022-02-19 13:00,120,53,67,0,0,0
2022-02-19 13:15,90,54,36,0,0,0
2022-02-19 13:30,126,75,51,0,0,0
2022-02-19 13:45,103,52,51,0,0,0
2022-02-19 14:00,125,72,53,0,0,0
2022-02-19 14:15,97,41,56,0,0,0
2022-02-19 14:30,111,66,45,0,0,0
2022-02-19 14:45,103,45,58,0,0,0
2022-02-19 15:00,70,32,38,0,0,0
2022-02-19 15:15,97,45,52,0,0,0
2022-02-19 15:30,87,49,38,0,0,0
2022-02-19 15:45,95,46,49,0,0,0
2022-02-19 16:00,72,26,46,0,0,0
2022-02-19 16:15,65,34,31,0,0,0
2022-02-19 16:30,69,20,49,0,0,0
2022-02-19 16:45,53,23,30,0,0,0
2022-02-19 17:00,52,27,25,0,0,0
2022-02-19 17:15,62,35,27,0,0,0
2022-02-19 17:30,49,21,28,0,0,0
2022-02-19 17:45,70,20,50,0,0,0
2022-02-19 18:00,52,27,25,0,0,0
2022-02-19 18:15,75,40,35,0,0,0
2022-02-19 18:30,47,21,26,0,0,0
2022-02-19 18:45,84,54,30,0,0,0
2022-02-19 19:00,68,36,32,0,0,0
2022-02-19 19:15,55,32,23,0,0,0
2022-02-19 19:30,37,19,18,0,0,0
2022-02-19 19:45,49,29,20,0,0,0
2022-02-19 20:00,46,22,24,0,0,0
2022-02-19 20:15,34,17,17,0,0,0
2022-02-19 20:30,22,15,7,0,0,0
2022-02-19 20:45,39,15,24,0,0,0
2022-02-19 21:00,16,6,10,0,0,0
2022-02-19 21:15,20,11,9,0,0,0
2022-02-19 21:30,16,8,8,0,0,0
2022-02-19 21:45,8,3,5,0,0,0
2022-02-19 22:00,11,3,8,0,0,0
2022-02-19 22:15,21,12,9,0,0,0
2022-02-19 22:30,33,18,15,0,0,0
2022-02-19 22:45,14,7,7,0,0,0
2022-02-19 23:00,27,11,16,0,0,0
2022-02-19 23:15,24,8,16,0,0,0
2022-02-19 23:30,26,8,18,0,0,0
2022-02-19 23:45,26,15,11,0,0,0
2022-02-20 00:00,19,8,11,0,0,0
2022-02-20 00:15,26,10,16,0,0,0
2022-02-20 00:30,25,12,13,0,0,0
2022-02-20 00:45,14,5,9,0,0,0
2022-02-20 01:00,14,8,6,0,0,0
2022-02-20 01:15,22,13,9,0,0,0
2022-02-20 01:30,8,1,7,0,0,0
2022-02-20 01:45,13,3,10,0,0,0
2022-02-20 02:00,17,6,11,0,0,0
2022-02-20 02:15,9,3,6,0,0,0
2022-02-20 02:30,10,1,9,0,0,0
2022-02-20 02:45,9,2,7,0,0,0
2022-02-20 03:00,4,2,2,0,0,0
2022-02-20 03:15,6,3,3,0,0,0
2022-02-20 03:30,3,2,1,0,0,0
2022-02-20 03:45,9,3,6,0,0,0
2022-02-20 04:00,6,1,5,0,0,0
2022-02-20 04:15,8,5,3,0,0,0
2022-02-20 04:30,5,3,2,0,0,0
2022-02-20 04:45,4,2,2,0,0,0
2022-02-20 05:00,4,2,2,0,0,0
2022-02-20 05:15,4,2,2,0,0,0
2022-02-20 05:30,7,3,4,0,0,0
2022-02-20 05:45,6,2,4,0,0,0
2022-02-20 06:00,5,3,2,0,0,0
2022-02-20 06:15,4,3,1,0,0,0
2022-02-20 06:30,3,2,1,0,0,0
2022-02-20 06:45,3,3,0,0,0,0
2022-02-20 07:00,3,1,2,0,0,0
2022-02-20 07:15,2,0,2,0,0,0
2022-02-20 07:30,5,4,1,0,0,0
2022-02-20 07:45,11,6,5,0,0,0
2022-02-20 08:00,6,4,2,0,0,0
2022-02-20 08:15,11,8,3,0,0,0
2022-02-20 08:30,9,8,1,0,0,0
2022-02-20 08:45,8,5,3,0,0,0
2022-02-20 09:00,7,4,3,0,0,0
2022-02-20 09:15,9,8,1,0,0,0
2022-02-20 09:30,7,3,4,0,0,0
2022-02-20 09:45,18,10,8,0,0,0
2022-02-20 10:00,23,16,7,0,0,0
2022-02-20 10:15,14,4,10,0,0,0
2022-02-20 10:30,16,9,7,0,0,0
2022-02-20 10:45,12,8,4,0,0,0
2022-02-20 11:00,16,5,11,0,0,0
2022-02-20 11:15,16,12,4,0,0,0
2022-02-20 11:30,15,10,5,0,0,0
2022-02-20 11:45,14,7,7,0,0,0
2022-02-20 12:00,18,10,8,0,0,0
2022-02-20 12:15,26,18,8,0,0,0
2022-02-20 12:30,14,6,8,0,0,0
2022-02-20 12:45,18,8,10,0,0,0
2022-02-20 13:00,18,9,9,0,0,0
2022-02-20 13:15,18,10,8,0,0,0
2022-02-20 13:30,28,15,13,0,0,0
2022-02-20 13:45,27,15,12,0,0,0
2022-02-20 14:00,27,16,11,0,0,0
2022-02-20 14:15,41,26,15,0,0,0
2022-02-20 14:30,21,11,10,0,0,0
2022-02-20 14:45,22,13,9,0,0,0
2022-02-20 15:00,20,13,7,0,0,0
2022-02-20 15:15,28,15,13,0,0,0
2022-02-20 15:30,20,9,11,0,0,0
2022-02-20 15:45,22,12,10,0,0,0
2022-02-20 16:00,16,8,8,0,0,0
2022-02-20 16:15,18,9,9,0,0,0
2022-02-20 16:30,18,8,10,0,0,0
2022-02-20 16:45,22,11,11,0,0,0
2022-02-20 17:00,24,10,14,0,0,0
2022-02-20 17:15,23,10,13,0,0,0
2022-02-20 17:30,20,6,14,0,0,0
2022-02-20 17:45,23,10,13,0,0,0
2022-02-20 18:00,23,10,13,0,0,0
2022-02-20 18:15,14,6,8,0,0,0
2022-02-20 18:30,15,5,10,0,0,0
2022-02-20 18:45,19,10,9,0,0,0
2022-02-20 19:00,8,5,3,0,0,0
2022-02-20 19:15,10,4,6,0,0,0
2022-02-20 19:30,26,14,12,0,0,0
2022-02-20 19:45,15,7,8,0,0,0
2022-02-20 20:00,21,12,9,0,0,0
2022-02-20 20:15,12,7,5,0,0,0
2022-02-20 20:30,14,10,4,0,0,0
2022-02-20 20:45,11,6,5,0,0,0
2022-02-20 21:00,17,10,7,0,0,0
2022-02-20 21:15,12,7,5,0,0,0
2022-02-20 21:30,9,4,5,0,0,0
2022-02-20 21:45,5,1,4,0,0,0
2022-02-20 22:00,3,2,1,0,0,0
2022-02-20 22:15,6,4,2,0,0,0
2022-02-20 22:30,0,0,0,0,0,0
2022-02-20 22:45,3,0,3,0,0,0
2022-02-20 23:00,2,0,2,0,0,0
2022-02-20 23:15,3,2,1,0,0,0
2022-02-20 23:30,2,0,2,0,0,0
2022-02-20 23:45,2,1,1,0,0,0
2022-02-21 00:00,1,1,0,0,0,0
2022-02-21 00:15,1,0,1,0,0,0
2022-02-21 00:30,2,1,1,0,0,0
2022-02-21 00:45,2,2,0,0,0,0
2022-02-21 01:00,0,0,0,0,0,0
2022-02-21 01:15,1,0,1,0,0,0
2022-02-21 01:30,1,1,0,0,0,0
2022-02-21 01:45,1,0,1,0,0,0
2022-02-21 02:00,1,1,0,0,0,0
2022-02-21 02:15,1,0,1,0,0,0
2022-02-21 02:30,0,0,0,0,0,0
2022-02-21 02:45,3,3,0,0,0,0
2022-02-21 03:00,0,0,0,0,0,0
2022-02-21 03:15,0,0,0,0,0,0
2022-02-21 03:30,0,0,0,0,0,0
2022-02-21 03:45,0,0,0,0,0,0
2022-02-21 04:00,1,1,0,0,0,0
2022-02-21 04:15,1,0,1,0,0,0
2022-02-21 04:30,0,0,0,0,0,0
2022-02-21 04:45,1,0,1,0,0,0
2022-02-21 05:00,2,1,1,0,0,0
2022-02-21 05:15,2,2,0,0,0,0
2022-02-21 05:30,8,5,3,0,0,0
2022-02-21 05:45,8,3,5,0,0,0
2022-02-21 06:00,19,13,6,0,0,0
2022-02-21 06:15,15,8,7,0,0,0
2022-02-21 06:30,33,17,16,0,0,0
2022-02-21 06:45,39,29,10,0,0,0
2022-02-21 07:00,59,40,19,0,0,0
2022-02-21 07:15,142,105,37,0,0,0
2022-02-21 07:30,291,227,64,0,0,0
2022-02-21 07:45,158,92,66,0,0,0
2022-02-21 08:00,95,66,29,0,0,0
2022-02-21 08:15,123,84,39,0,0,0
2022-02-21 08:30,128,92,36,0,0,0
2022-02-21 08:45,111,80,31,0,0,0
2022-02-21 09:00,82,63,19,0,0,0
2022-02-21 09:15,68,53,15,0,0,0
2022-02-21 09:30,68,47,21,0,0,0
2022-02-21 09:45,81,59,22,0,0,0
2022-02-21 10:00,50,38,12,0,0,0
2022-02-21 10:15,48,36,12,0,0,0
2022-02-21 10:30,66,43,23,0,0,0
2022-02-21 10:45,60,47,13,0,0,0
2022-02-21 11:00,82,53,29,0,0,0
2022-02-21 11:15,53,38,15,0,0,0
2022-02-21 11:30,51,23,28,0,0,0
2022-02-21 11:45,55,26,29,0,0,0
2022-02-21 12:00,57,39,18,0,0,0
2022-02-21 12:15,66,31,35,0,0,0
2022-02-21 12:30,89,25,64,0,0,0
2022-02-21 12:45,60,29,31,0,0,0
2022-02-21 13:00,78,34,44,0,0,0
2022-02-21 13:15,82,29,53,0,0,0
2022-02-21 13:30,52,21,31,0,0,0
2022-02-21 13:45,61,28,33,0,0,0
2022-02-21 14:00,56,27,29,0,0,0
2022-02-21 14:15,81,45,36,0,0,0
2022-02-21 14:30,55,26,29,0,0,0
2022-02-21 14:45,80,44,36,0,0,0
2022-02-21 15:00,82,38,44,0,0,0
2022-02-21 15:15,66,30,36,0,0,0
2022-02-21 15:30,90,36,54,0,0,0
2022-02-21 15:45,77,35,42,0,0,0
2022-02-21 16:00,96,45,51,0,0,0
2022-02-21 16:15,86,51,35,0,0,0
2022-02-21 16:30,82,48,34,0,0,0
2022-02-21 16:45,103,53,50,0,0,0
2022-02-21 17:00,115,61,54,0,0,0
2022-02-21 17:15,109,66,43,0,0,0
2022-02-21 17:30,110,53,57,0,0,0
2022-02-21 17:45,122,60,62,0,0,0
2022-02-21 18:00,102,43,59,0,0,0
2022-02-21 18:15,102,50,52,0,0,0
2022-02-21 18:30,66,32,34,0,0,0
2022-02-21 18:45,81,41,40,0,0,0
2022-02-21 19:00,62,28,34,0,0,0
2022-02-21 19:15,62,25,37,0,0,0
2022-02-21 19:30,45,17,28,0,0,0
2022-02-21 19:45,52,23,29,0,0,0
2022-02-21 20:00,47,17,30,0,0,0
2022-02-21 20:15,36,14,22,0,0,0
2022-02-21 20:30,25,8,17,0,0,0
2022-02-21 20:45,23,8,15,0,0,0
2022-02-21 21:00,31,10,21,0,0,0
2022-02-21 21:15,23,7,16,0,0,0
2022-02-21 21:30,19,9,10,0,0,0
2022-02-21 21:45,22,16,6,0,0,0
2022-02-21 22:00,27,17,10,0,0,0
2022-02-21 22:15,33,20,13,0,0,0
2022-02-21 22:30,16,9,7,0,0,0
2022-02-21 22:45,8,2,6,0,0,0
2022-02-21 23:00,9,3,6,0,0,0
2022-02-21 23:15,11,5,6,0,0,0
2022-02-21 23:30,8,2,6,0,0,0
2022-02-21 23:45,7,2,5,0,0,0
2022-02-22 00:00,4,2,2,0,0,0
2022-02-22 00:15,6,2,4,0,0,0
2022-02-22 00:30,5,1,4,0,0,0
2022-02-22 00:45,6,6,0,0,0,0
2022-02-22 01:00,2,0,2,0,0,0
2022-02-22 01:15,1,0,1,0,0,0
2022-02-22 01:30,2,2,0,0,0,0
2022-02-22 01:45,1,1,0,0,0,0
2022-02-22 02:00,3,0,3,0,0,0
2022-02-22 02:15,0,0,0,0,0,0
2022-02-22 02:30,0,0,0,0,0,0
2022-02-22 02:45,1,0,1,0,0,0
2022-02-22 03:00,1,0,1,0,0,0
2022-02-22 03:15,2,2,0,0,0,0
2022-02-22 03:30,2,0,2,0,0,0
2022-02-22 03:45,0,0,0,0,0,0
2022-02-22 04:00,0,0,0,0,0,0
2022-02-22 04:15,3,2,1,0,0,0
2022-02-22 04:30,1,0,1,0,0,0
2022-02-22 04:45,1,1,0,0,0,0
2022-02-22 05:00,3,3,0,0,0,0
2022-02-22 05:15,1,1,0,0,0,0
2022-02-22 05:30,13,9,4,0,0,0
2022-02-22 05:45,20,8,12,0,0,0
2022-02-22 06:00,20,6,14,0,0,0
2022-02-22 06:15,29,16,13,0,0,0
2022-02-22 06:30,36,19,17,0,0,0
2022-02-22 06:45,52,36,16,0,0,0
2022-02-22 07:00,74,44,30,0,0,0
2022-02-22 07:15,126,97,29,0,0,0
2022-02-22 07:30,329,268,61,0,0,0
2022-02-22 07:45,178,107,71,0,0,0
2022-02-22 08:00,127,94,33,0,0,0
2022-02-22 08:15,138,97,41,0,0,0
2022-02-22 08:30,101,74,27,0,0,0
2022-02-22 08:45,147,104,43,0,0,0
2022-02-22 09:00,97,69,28,0,0,0
2022-02-22 09:15,85,57,28,0,0,0
2022-02-22 09:30,109,76,33,0,0,0
2022-02-22 09:45,91,70,21,0,0,0
2022-02-22 10:00,82,56,26,0,0,0
2022-02-22 10:15,83,61,22,0,0,0
2022-02-22 10:30,71,43,28,0,0,0
2022-02-22 10:45,87,45,42,0,0,0
2022-02-22 11:00,77,47,30,0,0,0
2022-02-22 11:15,103,74,29,0,0,0
2022-02-22 11:30,89,57,32,0,0,0
2022-02-22 11:45,80,45,35,0,0,0
2022-02-22 12:00,83,38,45,0,0,0
2022-02-22 12:15,114,72,42,0,0,0
2022-02-22 12:30,110,48,62,0,0,0
2022-02-22 12:45,106,58,48,0,0,0
2022-02-22 13:00,129,59,70,0,0,0
2022-02-22 13:15,106,54,52,0,0,0
2022-02-22 13:30,75,30,45,0,0,0
2022-02-22 13:45,109,58,51,0,0,0
2022-02-22 14:00,115,43,72,0,0,0
2022-02-22 14:15,93,39,54,0,0,0
2022-02-22 14:30,92,43,49,0,0,0
2022-02-22 14:45,121,61,60,0,0,0
2022-02-22 15:00,124,47,77,0,0,0
2022-02-22 15:15,99,40,59,0,0,0
2022-02-22 15:30,122,71,51,0,0,0
2022-02-22 15:45,112,68,44,0,0,0
2022-02-22 16:00,129,58,71,0,0,0
2022-02-22 16:15,110,63,47,0,0,0
2022-02-22 16:30,142,59,83,0,0,0
2022-02-22 16:45,132,58,74,0,0,0
2022-02-22 17:00,116,46,70,0,0,0
2022-02-22 17:15,114,60,54,0,0,0
2022-02-22 17:30,127,62,65,0,0,0
2022-02-22 17:45,147,66,81,0,0,0
2022-02-22 18:00,118,53,65,0,0,0
2022-02-22 18:15,88,36,52,0,0,0
2022-02-22 18:30,83,36,47,0,0,0
2022-02-22 18:45,83,36,47,0,0,0
2022-02-22 19:00,67,28,39,0,0,0
2022-02-22 19:15,78,29,49,0,0,0
2022-02-22 19:30,53,19,34,0,0,0
2022-02-22 19:45,50,21,29,0,0,0
2022-02-22 20:00,49,20,29,0,0,0
2022-02-22 20:15,44,23,21,0,0,0
2022-02-22 20:30,41,19,22,0,0,0
2022-02-22 20:45,33,14,19,0,0,0
2022-02-22 21:00,41,13,28,0,0,0
2022-02-22 21:15,13,6,7,0,0,0
2022-02-22 21:30,24,9,15,0,0,0
2022-02-22 21:45,29,16,13,0,0,0
2022-02-22 22:00,41,19,22,0,0,0
2022-02-22 22:15,20,8,12,0,0,0
2022-02-22 22:30,19,15,4,0,0,0
2022-02-22 22:45,21,11,10,0,0,0
2022-02-22 23:00,15,3,12,0,0,0
2022-02-22 23:15,15,7,8,0,0,0
2022-02-22 23:30,2,0,2,0,0,0
2022-02-22 23:45,5,4,1,0,0,0
2022-02-23 00:00,8,3,5,0,0,0
2022-02-23 00:15,7,5,2,0,0,0
2022-02-23 00:30,7,4,3,0,0,0
2022-02-23 00:45,5,3,2,0,0,0
2022-02-23 01:00,1,0,1,0,0,0
2022-02-23 01:15,1,0,1,0,0,0
2022-02-23 01:30,5,2,3,0,0,0
2022-02-23 01:45,1,0,1,0,0,0
2022-02-23 02:00,2,0,2,0,0,0
2022-02-23 02:15,1,0,1,0,0,0
2022-02-23 02:30,4,3,1,0,0,0
2022-02-23 02:45,1,1,0,0,0,0
2022-02-23 03:00,1,0,1,0,0,0
2022-02-23 03:15,0,0,0,0,0,0
2022-02-23 03:30,1,0,1,0,0,0
2022-02-23 03:45,0,0,0,0,0,0
2022-02-23 04:00,1,0,1,0,0,0
2022-02-23 04:15,1,1,0,0,0,0
2022-02-23 04:30,0,0,0,0,0,0
2022-02-23 04:45,0,0,0,0,0,0
2022-02-23 05:00,3,2,1,0,0,0
2022-02-23 05:15,2,2,0,0,0,0
2022-02-23 05:30,11,7,4,0,0,0
2022-02-23 05:45,22,11,11,0,0,0
2022-02-23 06:00,10,2,8,0,0,0
2022-02-23 06:15,26,16,10,0,0,0
2022-02-23 06:30,44,22,22,0,0,0
2022-02-23 06:45,59,42,17,0,0,0
2022-02-23 07:00,92,51,41,0,0,0
2022-02-23 07:15,167,125,42,0,0,0
2022-02-23 07:30,299,249,50,0,0,0
2022-02-23 07:45,182,123,59,0,0,0
2022-02-23 08:00,146,109,37,0,0,0
2022-02-23 08:15,151,103,48,0,0,0
2022-02-23 08:30,153,116,37,0,0,0
2022-02-23 08:45,157,107,50,0,0,0
2022-02-23 09:00,92,67,25,0,0,0
2022-02-23 09:15,105,81,24,0,0,0
2022-02-23 09:30,122,92,30,0,0,0
2022-02-23 09:45,148,112,36,0,0,0
2022-02-23 10:00,100,79,21,0,0,0
2022-02-23 10:15,125,95,30,0,0,0
2022-02-23 10:30,116,82,34,0,0,0
2022-02-23 10:45,147,114,33,0,0,0
2022-02-23 11:00,111,66,45,0,0,0
2022-02-23 11:15,122,78,44,0,0,0
2022-02-23 11:30,112,62,50,0,0,0
2022-02-23 11:45,156,96,60,0,0,0
2022-02-23 12:00,129,83,46,0,0,0
2022-02-23 12:15,112,65,47,0,0,0
2022-02-23 12:30,155,78,77,0,0,0
2022-02-23 12:45,143,85,58,0,0,0
2022-02-23 13:00,146,79,67,0,0,0
2022-02-23 13:15,146,79,67,0,0,0
2022-02-23 13:30,115,53,62,0,0,0
2022-02-23 13:45,142,72,70,0,0,0
2022-02-23 14:00,164,62,102,0,0,0
2022-02-23 14:15,150,71,79,0,0,0
2022-02-23 14:30,143,82,61,0,0,0
2022-02-23 14:45,164,96,68,0,0,0
2022-02-23 15:00,145,70,75,0,0,0
2022-02-23 15:15,147,84,63,0,0,0
2022-02-23 15:30,154,85,69,0,0,0
2022-02-23 15:45,154,66,88,0,0,0
2022-02-23 16:00,157,94,63,0,0,0
2022-02-23 16:15,173,86,87,0,0,0
2022-02-23 16:30,148,71,77,0,0,0
2022-02-23 16:45,176,83,93,0,0,0
2022-02-23 17:00,148,72,76,0,0,0
2022-02-23 17:15,192,88,104,0,0,0
2022-02-23 17:30,124,66,58,0,0,0
2022-02-23 17:45,191,87,104,0,0,0
2022-02-23 18:00,152,71,81,0,0,0
2022-02-23 18:15,131,57,74,0,0,0
2022-02-23 18:30,110,44,66,0,0,0
2022-02-23 18:45,111,47,64,0,0,0
2022-02-23 19:00,99,45,54,0,0,0
2022-02-23 19:15,94,46,48,0,0,0
2022-02-23 19:30,73,40,33,0,0,0
2022-02-23 19:45,61,28,33,0,0,0
2022-02-23 20:00,64,37,27,0,0,0
2022-02-23 20:15,53,26,27,0,0,0
2022-02-23 20:30,36,14,22,0,0,0
2022-02-23 20:45,20,10,10,0,0,0
2022-02-23 21:00,35,14,21,0,0,0
2022-02-23 21:15,25,14,11,0,0,0
2022-02-23 21:30,32,16,16,0,0,0
2022-02-23 21:45,37,16,21,0,0,0
2022-02-23 22:00,45,23,22,0,0,0
2022-02-23 22:15,24,6,18,0,0,0
2022-02-23 22:30,40,19,21,0,0,0
2022-02-23 22:45,29,13,16,0,0,0
2022-02-23 23:00,18,10,8,0,0,0
2022-02-23 23:15,13,7,6,0,0,0
2022-02-23 23:30,13,7,6,0,0,0
2022-02-23 23:45,13,5,8,0,0,0
2022-02-24 00:00,12,3,9,0,0,0
2022-02-24 00:15,7,6,1,0,0,0
2022-02-24 00:30,10,9,1,0,0,0
2022-02-24 00:45,6,1,5,0,0,0
2022-02-24 01:00,4,2,2,0,0,0
2022-02-24 01:15,3,1,2,0,0,0
2022-02-24 01:30,3,0,3,0,0,0
2022-02-24 01:45,3,3,0,0,0,0
2022-02-24 02:00,6,1,5,0,0,0
2022-02-24 02:15,1,0,1,0,0,0
2022-02-24 02:30,0,0,0,0,0,0
2022-02-24 02:45,4,1,3,0,0,0
2022-02-24 03:00,2,0,2,0,0,0
2022-02-24 03:15,4,3,1,0,0,0
2022-02-24 03:30,2,2,0,0,0,0
2022-02-24 03:45,0,0,0,0,0,0
2022-02-24 04:00,0,0,0,0,0,0
2022-02-24 04:15,1,1,0,0,0,0
2022-02-24 04:30,1,0,1,0,0,0
2022-02-24 04:45,0,0,0,0,0,0
2022-02-24 05:00,3,2,1,0,0,0
2022-02-24 05:15,1,1,0,0,0,0
2022-02-24 05:30,11,7,4,0,0,0
2022-02-24 05:45,19,9,10,0,0,0
2022-02-24 06:00,19,9,10,0,0,0
2022-02-24 06:15,28,17,11,0,0,0
2022-02-24 06:30,43,24,19,0,0,0
2022-02-24 06:45,48,27,21,0,0,0
2022-02-24 07:00,78,51,27,0,0,0
2022-02-24 07:15,142,110,32,0,0,0
2022-02-24 07:30,310,253,57,0,0,0
2022-02-24 07:45,175,121,54,0,0,0
2022-02-24 08:00,131,90,41,0,0,0
2022-02-24 08:15,141,100,41,0,0,0
2022-02-24 08:30,111,92,19,0,0,0
2022-02-24 08:45,133,87,46,0,0,0
2022-02-24 09:00,82,54,28,0,0,0
2022-02-24 09:15,100,77,23,0,0,0
2022-02-24 09:30,85,56,29,0,0,0
2022-02-24 09:45,103,78,25,0,0,0
2022-02-24 10:00,72,57,15,0,0,0
2022-02-24 10:15,71,49,22,0,0,0
2022-02-24 10:30,86,59,27,0,0,0
2022-02-24 10:45,89,64,25,0,0,0
2022-02-24 11:00,89,55,34,0,0,0
2022-02-24 11:15,91,56,35,0,0,0
2022-02-24 11:30,95,54,41,0,0,0
2022-02-24 11:45,72,40,32,0,0,0
2022-02-24 12:00,91,48,43,0,0,0
2022-02-24 12:15,104,56,48,0,0,0
2022-02-24 12:30,111,53,58,0,0,0
2022-02-24 12:45,96,51,45,0,0,0
2022-02-24 13:00,112,47,65,0,0,0
2022-02-24 13:15,106,55,51,0,0,0
2022-02-24 13:30,95,48,47,0,0,0
2022-02-24 13:45,113,59,54,0,0,0
2022-02-24 14:00,125,56,69,0,0,0
2022-02-24 14:15,104,61,43,0,0,0
2022-02-24 14:30,119,61,58,0,0,0
2022-02-24 14:45,143,66,77,0,0,0
2022-02-24 15:00,124,53,71,0,0,0
2022-02-24 15:15,115,54,61,0,0,0
2022-02-24 15:30,118,57,61,0,0,0
2022-02-24 15:45,147,73,74,0,0,0
2022-02-24 16:00,135,75,60,0,0,0
2022-02-24 16:15,124,64,60,0,0,0
2022-02-24 16:30,126,50,76,0,0,0
2022-02-24 16:45,111,53,58,0,0,0
2022-02-24 17:00,100,47,53,0,0,0
2022-02-24 17:15,98,42,56,0,0,0
2022-02-24 17:30,101,57,44,0,0,0
2022-02-24 17:45,116,45,71,0,0,0
2022-02-24 18:00,102,35,67,0,0,0
2022-02-24 18:15,93,47,46,0,0,0
2022-02-24 18:30,78,32,46,0,0,0
2022-02-24 18:45,93,36,57,0,0,0
2022-02-24 19:00,69,29,40,0,0,0
2022-02-24 19:15,69,32,37,0,0,0
2022-02-24 19:30,56,26,30,0,0,0
2022-02-24 19:45,75,33,42,0,0,0
2022-02-24 20:00,48,24,24,0,0,0
2022-02-24 20:15,46,25,21,0,0,0
2022-02-24 20:30,30,20,10,0,0,0
2022-02-24 20:45,23,9,14,0,0,0
2022-02-24 21:00,20,10,10,0,0,0
2022-02-24 21:15,32,17,15,0,0,0
2022-02-24 21:30,28,15,13,0,0,0
2022-02-24 21:45,32,14,18,0,0,0
2022-02-24 22:00,25,6,19,0,0,0
2022-02-24 22:15,33,17,16,0,0,0
2022-02-24 22:30,27,10,17,0,0,0
2022-02-24 22:45,16,7,9,0,0,0
2022-02-24 23:00,19,9,10,0,0,0
2022-02-24 23:15,21,6,15,0,0,0
2022-02-24 23:30,14,8,6,0,0,0
2022-02-24 23:45,15,6,9,0,0,0
2022-02-25 00:00,10,3,7,0,0,0
2022-02-25 00:15,8,2,6,0,0,0
2022-02-25 00:30,8,5,3,0,0,0
2022-02-25 00:45,10,1,9,0,0,0
2022-02-25 01:00,10,5,5,0,0,0
2022-02-25 01:15,3,0,3,0,0,0
2022-02-25 01:30,3,0,3,0,0,0
2022-02-25 01:45,7,1,6,0,0,0
2022-02-25 02:00,3,1,2,0,0,0
2022-02-25 02:15,1,0,1,0,0,0
2022-02-25 02:30,3,2,1,0,0,0
2022-02-25 02:45,5,2,3,0,0,0
2022-02-25 03:00,2,2,0,0,0,0
2022-02-25 03:15,3,1,2,0,0,0
2022-02-25 03:30,0,0,0,0,0,0
2022-02-25 03:45,1,1,0,0,0,0
2022-02-25 04:00,0,0,0,0,0,0
2022-02-25 04:15,1,1,0,0,0,0
2022-02-25 04:30,0,0,0,0,0,0
2022-02-25 04:45,1,0,1,0,0,0
2022-02-25 05:00,4,3,1,0,0,0
2022-02-25 05:15,1,1,0,0,0,0
2022-02-25 05:30,11,6,5,0,0,0
2022-02-25 05:45,8,4,4,0,0,0
2022-02-25 06:00,14,5,9,0,0,0
2022-02-25 06:15,22,12,10,0,0,0
2022-02-25 06:30,38,24,14,0,0,0
2022-02-25 06:45,45,30,15,0,0,0
2022-02-25 07:00,64,43,21,0,0,0
2022-02-25 07:15,135,92,43,0,0,0
2022-02-25 07:30,250,201,49,0,0,0
2022-02-25 07:45,153,109,44,0,0,0
2022-02-25 08:00,105,81,24,0,0,0
2022-02-25 08:15,126,97,29,0,0,0
2022-02-25 08:30,116,77,39,0,0,0
2022-02-25 08:45,113,82,31,0,0,0
2022-02-25 09:00,74,55,19,0,0,0
2022-02-25 09:15,73,48,25,0,0,0
2022-02-25 09:30,85,58,27,0,0,0
2022-02-25 09:45,86,70,16,0,0,0
2022-02-25 10:00,74,53,21,0,0,0
2022-02-25 10:15,78,59,19,0,0,0
2022-02-25 10:30,67,45,22,0,0,0
2022-02-25 10:45,74,42,32,0,0,0
2022-02-25 11:00,81,45,36,0,0,0
2022-02-25 11:15,72,38,34,0,0,0
2022-02-25 11:30,79,50,29,0,0,0
2022-02-25 11:45,91,53,38,0,0,0
2022-02-25 12:00,72,35,37,0,0,0
2022-02-25 12:15,70,32,38,0,0,0
2022-02-25 12:30,98,44,54,0,0,0
2022-02-25 12:45,97,48,49,0,0,0
2022-02-25 13:00,113,48,65,0,0,0
2022-02-25 13:15,106,53,53,0,0,0
2022-02-25 13:30,77,36,41,0,0,0
2022-02-25 13:45,115,45,70,0,0,0
2022-02-25 14:00,116,46,70,0,0,0
2022-02-25 14:15,98,53,45,0,0,0
2022-02-25 14:30,118,71,47,0,0,0
2022-02-25 14:45,105,45,60,0,0,0
2022-02-25 15:00,111,53,58,0,0,0
2022-02-25 15:15,114,71,43,0,0,0
2022-02-25 15:30,87,44,43,0,0,0
2022-02-25 15:45,104,53,51,0,0,0
2022-02-25 16:00,104,59,45,0,0,0
2022-02-25 16:15,115,56,59,0,0,0
2022-02-25 16:30,98,66,32,0,0,0
2022-02-25 16:45,99,54,45,0,0,0
2022-02-25 17:00,117,72,45,0,0,0
2022-02-25 17:15,157,108,49,0,0,0
2022-02-25 17:30,119,66,53,0,0,0
2022-02-25 17:45,88,48,40,0,0,0
2022-02-25 18:00,113,55,58,0,0,0
2022-02-25 18:15,126,51,75,0,0,0
2022-02-25 18:30,113,38,75,0,0,0
2022-02-25 18:45,124,54,70,0,0,0
2022-02-25 19:00,72,29,43,0,0,0
2022-02-25 19:15,76,46,30,0,0,0
2022-02-25 19:30,63,28,35,0,0,0
2022-02-25 19:45,81,37,44,0,0,0
2022-02-25 20:00,40,14,26,0,0,0
2022-02-25 20:15,44,18,26,0,0,0
2022-02-25 20:30,32,19,13,0,0,0
2022-02-25 20:45,30,12,18,0,0,0
2022-02-25 21:00,27,14,13,0,0,0
2022-02-25 21:15,31,15,16,0,0,0
2022-02-25 21:30,13,7,6,0,0,0
2022-02-25 21:45,27,16,11,0,0,0
2022-02-25 22:00,34,14,20,0,0,0
2022-02-25 22:15,44,20,24,0,0,0
2022-02-25 22:30,42,20,22,0,0,0
2022-02-25 22:45,16,12,4,0,0,0
2022-02-25 23:00,30,11,19,0,0,0
2022-02-25 23:15,19,9,10,0,0,0
2022-02-25 23:30,18,5,13,0,0,0
2022-02-25 23:45,24,12,12,0,0,0
2022-02-26 00:00,18,9,9,0,0,0
2022-02-26 00:15,20,5,15,0,0,0
2022-02-26 00:30,20,16,4,0,0,0
2022-02-26 00:45,8,3,5,0,0,0
2022-02-26 01:00,17,7,10,0,0,0
2022-02-26 01:15,11,3,8,0,0,0
2022-02-26 01:30,12,6,6,0,0,0
2022-02-26 01:45,10,3,7,0,0,0
2022-02-26 02:00,6,2,4,0,0,0
2022-02-26 02:15,12,8,4,0,0,0
2022-02-26 02:30,8,2,6,0,0,0
2022-02-26 02:45,12,2,10,0,0,0
2022-02-26 03:00,9,2,7,0,0,0
2022-02-26 03:15,6,0,6,0,0,0
2022-02-26 03:30,8,4,4,0,0,0
2022-02-26 03:45,4,1,3,0,0,0
2022-02-26 04:00,4,3,1,0,0,0
2022-02-26 04:15,5,1,4,0,0,0
2022-02-26 04:30,3,1,2,0,0,0
2022-02-26 04:45,2,0,2,0,0,0
2022-02-26 05:00,0,0,0,0,0,0
2022-02-26 05:15,5,3,2,0,0,0
2022-02-26 05:30,6,3,3,0,0,0
2022-02-26 05:45,6,2,4,0,0,0
2022-02-26 06:00,6,4,2,0,0,0
2022-02-26 06:15,4,2,2,0,0,0
2022-02-26 06:30,9,4,5,0,0,0
2022-02-26 06:45,6,6,0,0,0,0
2022-02-26 07:00,8,6,2,0,0,0
2022-02-26 07:15,11,10,1,0,0,0
2022-02-26 07:30,17,10,7,0,0,0
2022-02-26 07:45,16,13,3,0,0,0
2022-02-26 08:00,21,12,9,0,0,0
2022-02-26 08:15,20,13,7,0,0,0
2022-02-26 08:30,37,28,9,0,0,0
2022-02-26 08:45,43,35,8,0,0,0
2022-02-26 09:00,43,32,11,0,0,0
2022-02-26 09:15,52,36,16,0,0,0
2022-02-26 09:30,55,42,13,0,0,0
2022-02-26 09:45,113,95,18,0,0,0
2022-02-26 10:00,87,74,13,0,0,0
2022-02-26 10:15,122,89,33,0,0,0
2022-02-26 10:30,117,84,33,0,0,0
2022-02-26 10:45,180,146,34,0,0,0
2022-02-26 11:00,133,104,29,0,0,0
2022-02-26 11:15,145,93,52,0,0,0
2022-02-26 11:30,128,91,37,0,0,0
2022-02-26 11:45,160,106,54,0,0,0
2022-02-26 12:00,131,91,40,0,0,0
2022-02-26 12:15,184,117,67,0,0,0
2022-02-26 12:30,157,94,63,0,0,0
2022-02-26 12:45,165,98,67,0,0,0
2022-02-26 13:00,137,84,53,0,0,0
2022-02-26 13:15,134,91,43,0,0,0
2022-02-26 13:30,128,64,64,0,0,0
2022-02-26 13:45,137,82,55,0,0,0
2022-02-26 14:00,146,84,62,0,0,0
2022-02-26 14:15,144,62,82,0,0,0
2022-02-26 14:30,113,40,73,0,0,0
2022-02-26 14:45,133,61,72,0,0,0
2022-02-26 15:00,113,51,62,0,0,0
2022-02-26 15:15,99,45,54,0,0,0
2022-02-26 15:30,102,47,55,0,0,0
2022-02-26 15:45,81,40,41,0,0,0
2022-02-26 16:00,103,60,43,0,0,0
2022-02-26 16:15,86,45,41,0,0,0
2022-02-26 16:30,95,38,57,0,0,0
2022-02-26 16:45,90,48,42,0,0,0
2022-02-26 17:00,92,38,54,0,0,0
2022-02-26 17:15,84,50,34,0,0,0
2022-02-26 17:30,78,33,45,0,0,0
2022-02-26 17:45,104,50,54,0,0,0
2022-02-26 18:00,77,29,48,0,0,0
2022-02-26 18:15,77,38,39,0,0,0
2022-02-26 18:30,61,33,28,0,0,0
2022-02-26 18:45,86,49,37,0,0,0
2022-02-26 19:00,60,30,30,0,0,0
2022-02-26 19:15,66,40,26,0,0,0
2022-02-26 19:30,53,30,23,0,0,0
2022-02-26 19:45,80,51,29,0,0,0
2022-02-26 20:00,39,15,24,0,0,0
2022-02-26 20:15,35,10,25,0,0,0
2022-02-26 20:30,32,19,13,0,0,0
2022-02-26 20:45,30,13,17,0,0,0
2022-02-26 21:00,37,18,19,0,0,0
2022-02-26 21:15,22,11,11,0,0,0
2022-02-26 21:30,14,9,5,0,0,0
2022-02-26 21:45,22,4,18,0,0,0
2022-02-26 22:00,35,17,18,0,0,0
2022-02-26 22:15,37,22,15,0,0,0
2022-02-26 22:30,25,9,16,0,0,0
2022-02-26 22:45,19,9,10,0,0,0
2022-02-26 23:00,23,5,18,0,0,0
2022-02-26 23:15,28,15,13,0,0,0
2022-02-26 23:30,16,7,9,0,0,0
2022-02-26 23:45,18,8,10,0,0,0
2022-02-27 00:00,12,6,6,0,0,0
2022-02-27 00:15,31,13,18,0,0,0
2022-02-27 00:30,18,10,8,0,0,0
2022-02-27 00:45,13,3,10,0,0,0
2022-02-27 01:00,12,6,6,0,0,0
2022-02-27 01:15,11,4,7,0,0,0
2022-02-27 01:30,16,10,6,0,0,0
2022-02-27 01:45,12,8,4,0,0,0
2022-02-27 02:00,12,0,12,0,0,0
2022-02-27 02:15,21,8,13,0,0,0
2022-02-27 02:30,6,1,5,0,0,0
2022-02-27 02:45,5,1,4,0,0,0
2022-02-27 03:00,8,3,5,0,0,0
2022-02-27 03:15,1,0,1,0,0,0
2022-02-27 03:30,6,1,5,0,0,0
2022-02-27 03:45,4,0,4,0,0,0
2022-02-27 04:00,1,0,1,0,0,0
2022-02-27 04:15,3,3,0,0,0,0
2022-02-27 04:30,2,1,1,0,0,0
2022-02-27 04:45,2,0,2,0,0,0
2022-02-27 05:00,0,0,0,0,0,0
2022-02-27 05:15,4,2,2,0,0,0
2022-02-27 05:30,3,3,0,0,0,0
2022-02-27 05:45,2,0,2,0,0,0
2022-02-27 06:00,11,6,5,0,0,0
2022-02-27 06:15,3,2,1,0,0,0
2022-02-27 06:30,4,2,2,0,0,0
2022-02-27 06:45,6,6,0,0,0,0
2022-02-27 07:00,4,3,1,0,0,0
2022-02-27 07:15,4,2,2,0,0,0
2022-02-27 07:30,8,5,3,0,0,0
2022-02-27 07:45,6,3,3,0,0,0
2022-02-27 08:00,11,9,2,0,0,0
2022-02-27 08:15,12,8,4,0,0,0
2022-02-27 08:30,8,5,3,0,0,0
2022-02-27 08:45,14,11,3,0,0,0
2022-02-27 09:00,25,13,12,0,0,0
2022-02-27 09:15,14,13,1,0,0,0
2022-02-27 09:30,24,20,4,0,0,0
2022-02-27 09:45,41,28,13,0,0,0
2022-02-27 10:00,39,32,7,0,0,0
2022-02-27 10:15,49,28,21,0,0,0
2022-02-27 10:30,38,32,6,0,0,0
2022-02-27 10:45,51,36,15,0,0,0
2022-02-27 11:00,34,23,11,0,0,0
2022-02-27 11:15,58,34,24,0,0,0
2022-02-27 11:30,51,35,16,0,0,0
2022-02-27 11:45,68,53,15,0,0,0
2022-02-27 12:00,54,23,31,0,0,0
2022-02-27 12:15,73,50,23,0,0,0
2022-02-27 12:30,55,33,22,0,0,0
2022-02-27 12:45,56,40,16,0,0,0
2022-02-27 13:00,87,50,37,0,0,0
2022-02-27 13:15,76,46,30,0,0,0
2022-02-27 13:30,81,47,34,0,0,0
2022-02-27 13:45,81,54,27,0,0,0
2022-02-27 14:00,79,50,29,0,0,0
2022-02-27 14:15,103,54,49,0,0,0
2022-02-27 14:30,78,44,34,0,0,0
2022-02-27 14:45,111,78,33,0,0,0
2022-02-27 15:00,81,39,42,0,0,0
2022-02-27 15:15,110,67,43,0,0,0
2022-02-27 15:30,99,47,52,0,0,0
2022-02-27 15:45,84,51,33,0,0,0
2022-02-27 16:00,75,47,28,0,0,0
2022-02-27 16:15,67,38,29,0,0,0
2022-02-27 16:30,79,50,29,0,0,0
2022-02-27 16:45,74,43,31,0,0,0
2022-02-27 17:00,65,32,33,0,0,0
2022-02-27 17:15,68,40,28,0,0,0
2022-02-27 17:30,60,31,29,0,0,0
2022-02-27 17:45,52,34,18,0,0,0
2022-02-27 18:00,68,27,41,0,0,0
2022-02-27 18:15,42,23,19,0,0,0
2022-02-27 18:30,40,21,19,0,0,0
2022-02-27 18:45,48,22,26,0,0,0
2022-02-27 19:00,50,31,19,0,0,0
2022-02-27 19:15,45,31,14,0,0,0
2022-02-27 19:30,31,15,16,0,0,0
2022-02-27 19:45,22,11,11,0,0,0
2022-02-27 20:00,27,11,16,0,0,0
2022-02-27 20:15,27,14,13,0,0,0
2022-02-27 20:30,24,12,12,0,0,0
2022-02-27 20:45,21,7,14,0,0,0
2022-02-27 21:00,30,9,21,0,0,0
2022-02-27 21:15,19,10,9,0,0,0
2022-02-27 21:30,15,8,7,0,0,0
2022-02-27 21:45,14,8,6,0,0,0
2022-02-27 22:00,23,8,15,0,0,0
2022-02-27 22:15,16,7,9,0,0,0
2022-02-27 22:30,10,4,6,0,0,0
2022-02-27 22:45,5,2,3,0,0,0
2022-02-27 23:00,3,1,2,0,0,0
2022-02-27 23:15,5,3,2,0,0,0
2022-02-27 23:30,9,4,5,0,0,0
2022-02-27 23:45,3,0,3,0,0,0
