Datetime,100034982 (Hüfferstraße),101034982 (Hüfferstraße stadteinwärts),102034982 (Hüfferstraße stadtauswärts),100034982-status,101034982-status,102034982-status
2019-06-01 00:00,38,7,31,0,0,0
2019-06-01 00:15,36,6,30,0,0,0
2019-06-01 00:30,13,5,8,0,0,0
2019-06-01 00:45,16,3,13,0,0,0
2019-06-01 01:00,6,0,6,0,0,0
2019-06-01 01:15,25,2,23,0,0,0
2019-06-01 01:30,9,2,7,0,0,0
2019-06-01 01:45,11,4,7,0,0,0
2019-06-01 02:00,6,0,6,0,0,0
2019-06-01 02:15,5,0,5,0,0,0
2019-06-01 02:30,7,0,7,0,0,0
2019-06-01 02:45,7,2,5,0,0,0
2019-06-01 03:00,1,0,1,0,0,0
2019-06-01 03:15,6,1,5,0,0,0
2019-06-01 03:30,1,0,1,0,0,0
2019-06-01 03:45,2,1,1,0,0,0
2019-06-01 04:00,9,0,9,0,0,0
2019-06-01 04:15,3,1,2,0,0,0
2019-06-01 04:30,1,0,1,0,0,0
2019-06-01 04:45,2,0,2,0,0,0
2019-06-01 05:00,0,0,0,0,0,0
2019-06-01 05:15,4,1,3,0,0,0
2019-06-01 05:30,4,0,4,0,0,0
2019-06-01 05:45,3,0,3,0,0,0
2019-06-01 06:00,5,1,4,0,0,0
2019-06-01 06:15,8,4,4,0,0,0
2019-06-01 06:30,7,5,2,0,0,0
2019-06-01 06:45,8,5,3,0,0,0
2019-06-01 07:00,14,9,5,0,0,0
2019-06-01 07:15,15,10,5,0,0,0
2019-06-01 07:30,12,4,8,0,0,0
2019-06-01 07:45,20,12,8,0,0,0
2019-06-01 08:00,35,25,10,0,0,0
2019-06-01 08:15,28,17,11,0,0,0
2019-06-01 08:30,26,15,11,0,0,0
2019-06-01 08:45,43,26,17,0,0,0
2019-06-01 09:00,49,33,16,0,0,0
2019-06-01 09:15,50,34,16,0,0,0
2019-06-01 09:30,98,54,44,0,0,0
2019-06-01 09:45,114,84,30,0,0,0
2019-06-01 10:00,139,90,49,0,0,0
2019-06-01 10:15,103,70,33,0,0,0
2019-06-01 10:30,93,63,30,0,0,0
2019-06-01 10:45,132,97,35,0,0,0
2019-06-01 11:00,110,69,41,0,0,0
2019-06-01 11:15,79,49,30,0,0,0
2019-06-01 11:30,89,46,43,0,0,0
2019-06-01 11:45,115,75,40,0,0,0
2019-06-01 12:00,93,47,46,0,0,0
2019-06-01 12:15,123,60,63,0,0,0
2019-06-01 12:30,124,54,70,0,0,0
2019-06-01 12:45,110,49,61,0,0,0
2019-06-01 13:00,128,63,65,0,0,0
2019-06-01 13:15,102,59,43,0,0,0
2019-06-01 13:30,107,55,52,0,0,0
2019-06-01 13:45,112,47,65,0,0,0
2019-06-01 14:00,102,39,63,0,0,0
2019-06-01 14:15,100,43,57,0,0,0
2019-06-01 14:30,89,43,46,0,0,0
2019-06-01 14:45,105,33,72,0,0,0
2019-06-01 15:00,88,46,42,0,0,0
2019-06-01 15:15,91,42,49,0,0,0
2019-06-01 15:30,85,28,57,0,0,0
2019-06-01 15:45,84,36,48,0,0,0
2019-06-01 16:00,75,25,50,0,0,0
2019-06-01 16:15,105,47,58,0,0,0
2019-06-01 16:30,84,40,44,0,0,0
2019-06-01 16:45,95,53,42,0,0,0
2019-06-01 17:00,91,44,47,0,0,0
2019-06-01 17:15,76,34,42,0,0,0
2019-06-01 17:30,63,34,29,0,0,0
2019-06-01 17:45,121,62,59,0,0,0
2019-06-01 18:00,99,40,59,0,0,0
2019-06-01 18:15,99,42,57,0,0,0
2019-06-01 18:30,80,41,39,0,0,0
2019-06-01 18:45,82,46,36,0,0,0
2019-06-01 19:00,81,43,38,0,0,0
2019-06-01 19:15,83,43,40,0,0,0
2019-06-01 19:30,79,38,41,0,0,0
2019-06-01 19:45,80,35,45,0,0,0
2019-06-01 20:00,87,32,55,0,0,0
2019-06-01 20:15,57,35,22,0,0,0
2019-06-01 20:30,50,24,26,0,0,0
2019-06-01 20:45,67,29,38,0,0,0
2019-06-01 21:00,54,22,32,0,0,0
2019-06-01 21:15,36,11,25,0,0,0
2019-06-01 21:30,53,13,40,0,0,0
2019-06-01 21:45,37,8,29,0,0,0
2019-06-01 22:00,48,10,38,0,0,0
2019-06-01 22:15,30,7,23,0,0,0
2019-06-01 22:30,47,16,31,0,0,0
2019-06-01 22:45,40,4,36,0,0,0
2019-06-01 23:00,47,4,43,0,0,0
2019-06-01 23:15,43,7,36,0,0,0
2019-06-01 23:30,61,7,54,0,0,0
2019-06-01 23:45,58,7,51,0,0,0
2019-06-02 00:00,41,2,39,0,0,0
2019-06-02 00:15,32,3,29,0,0,0
2019-06-02 00:30,48,7,41,0,0,0
2019-06-02 00:45,26,2,24,0,0,0
2019-06-02 01:00,30,3,27,0,0,0
2019-06-02 01:15,20,3,17,0,0,0
2019-06-02 01:30,17,2,15,0,0,0
2019-06-02 01:45,24,4,20,0,0,0
2019-06-02 02:00,15,3,12,0,0,0
2019-06-02 02:15,18,2,16,0,0,0
2019-06-02 02:30,11,0,11,0,0,0
2019-06-02 02:45,9,0,9,0,0,0
2019-06-02 03:00,13,1,12,0,0,0
2019-06-02 03:15,10,1,9,0,0,0
2019-06-02 03:30,11,0,11,0,0,0
2019-06-02 03:45,2,0,2,0,0,0
2019-06-02 04:00,7,1,6,0,0,0
2019-06-02 04:15,4,0,4,0,0,0
2019-06-02 04:30,2,1,1,0,0,0
2019-06-02 04:45,0,0,0,0,0,0
2019-06-02 05:00,1,0,1,0,0,0
2019-06-02 05:15,3,0,3,0,0,0
2019-06-02 05:30,9,0,9,0,0,0
2019-06-02 05:45,9,0,9,0,0,0
2019-06-02 06:00,0,0,0,0,0,0
2019-06-02 06:15,5,4,1,0,0,0
2019-06-02 06:30,5,2,3,0,0,0
2019-06-02 06:45,8,5,3,0,0,0
2019-06-02 07:00,1,0,1,0,0,0
2019-06-02 07:15,4,2,2,0,0,0
2019-06-02 07:30,11,1,10,0,0,0
2019-06-02 07:45,10,4,6,0,0,0
2019-06-02 08:00,8,4,4,0,0,0
2019-06-02 08:15,10,5,5,0,0,0
2019-06-02 08:30,20,15,5,0,0,0
2019-06-02 08:45,18,10,8,0,0,0
2019-06-02 09:00,24,13,11,0,0,0
2019-06-02 09:15,37,20,17,0,0,0
2019-06-02 09:30,32,15,17,0,0,0
2019-06-02 09:45,34,22,12,0,0,0
2019-06-02 10:00,39,28,11,0,0,0
2019-06-02 10:15,22,16,6,0,0,0
2019-06-02 10:30,39,31,8,0,0,0
2019-06-02 10:45,44,29,15,0,0,0
2019-06-02 11:00,35,22,13,0,0,0
2019-06-02 11:15,39,11,28,0,0,0
2019-06-02 11:30,46,21,25,0,0,0
2019-06-02 11:45,43,26,17,0,0,0
2019-06-02 12:00,52,30,22,0,0,0
2019-06-02 12:15,47,13,34,0,0,0
2019-06-02 12:30,82,43,39,0,0,0
2019-06-02 12:45,84,33,51,0,0,0
2019-06-02 13:00,45,26,19,0,0,0
2019-06-02 13:15,43,21,22,0,0,0
2019-06-02 13:30,53,22,31,0,0,0
2019-06-02 13:45,81,47,34,0,0,0
2019-06-02 14:00,62,28,34,0,0,0
2019-06-02 14:15,57,39,18,0,0,0
2019-06-02 14:30,80,39,41,0,0,0
2019-06-02 14:45,91,43,48,0,0,0
2019-06-02 15:00,82,36,46,0,0,0
2019-06-02 15:15,60,29,31,0,0,0
2019-06-02 15:30,57,29,28,0,0,0
2019-06-02 15:45,79,39,40,0,0,0
2019-06-02 16:00,86,42,44,0,0,0
2019-06-02 16:15,74,42,32,0,0,0
2019-06-02 16:30,49,19,30,0,0,0
2019-06-02 16:45,63,28,35,0,0,0
2019-06-02 17:00,68,20,48,0,0,0
2019-06-02 17:15,68,25,43,0,0,0
2019-06-02 17:30,65,23,42,0,0,0
2019-06-02 17:45,62,22,40,0,0,0
2019-06-02 18:00,58,27,31,0,0,0
2019-06-02 18:15,52,29,23,0,0,0
2019-06-02 18:30,57,20,37,0,0,0
2019-06-02 18:45,71,36,35,0,0,0
2019-06-02 19:00,60,20,40,0,0,0
2019-06-02 19:15,70,20,50,0,0,0
2019-06-02 19:30,80,22,58,0,0,0
2019-06-02 19:45,62,18,44,0,0,0
2019-06-02 20:00,47,4,43,0,0,0
2019-06-02 20:15,55,18,37,0,0,0
2019-06-02 20:30,38,8,30,0,0,0
2019-06-02 20:45,31,7,24,0,0,0
2019-06-02 21:00,57,11,46,0,0,0
2019-06-02 21:15,30,14,16,0,0,0
2019-06-02 21:30,43,3,40,0,0,0
2019-06-02 21:45,35,7,28,0,0,0
2019-06-02 22:00,20,5,15,0,0,0
2019-06-02 22:15,25,2,23,0,0,0
2019-06-02 22:30,12,3,9,0,0,0
2019-06-02 22:45,11,3,8,0,0,0
2019-06-02 23:00,18,2,16,0,0,0
2019-06-02 23:15,16,5,11,0,0,0
2019-06-02 23:30,5,1,4,0,0,0
2019-06-02 23:45,9,4,5,0,0,0
2019-06-03 00:00,20,5,15,0,0,0
2019-06-03 00:15,3,0,3,0,0,0
2019-06-03 00:30,1,0,1,0,0,0
2019-06-03 00:45,6,2,4,0,0,0
2019-06-03 01:00,3,0,3,0,0,0
2019-06-03 01:15,6,2,4,0,0,0
2019-06-03 01:30,1,1,0,0,0,0
2019-06-03 01:45,0,0,0,0,0,0
2019-06-03 02:00,3,1,2,0,0,0
2019-06-03 02:15,2,0,2,0,0,0
2019-06-03 02:30,3,1,2,0,0,0
2019-06-03 02:45,0,0,0,0,0,0
2019-06-03 03:00,1,0,1,0,0,0
2019-06-03 03:15,0,0,0,0,0,0
2019-06-03 03:30,1,0,1,0,0,0
2019-06-03 03:45,0,0,0,0,0,0
2019-06-03 04:00,0,0,0,0,0,0
2019-06-03 04:15,2,0,2,0,0,0
2019-06-03 04:30,1,0,1,0,0,0
2019-06-03 04:45,1,0,1,0,0,0
2019-06-03 05:00,1,1,0,0,0,0
2019-06-03 05:15,1,0,1,0,0,0
2019-06-03 05:30,11,3,8,0,0,0
2019-06-03 05:45,5,1,4,0,0,0
2019-06-03 06:00,7,5,2,0,0,0
2019-06-03 06:15,25,9,16,0,0,0
2019-06-03 06:30,26,2,24,0,0,0
2019-06-03 06:45,37,12,25,0,0,0
2019-06-03 07:00,45,11,34,0,0,0
2019-06-03 07:15,71,21,50,0,0,0
2019-06-03 07:30,82,45,37,0,0,0
2019-06-03 07:45,118,39,79,0,0,0
2019-06-03 08:00,137,22,115,0,0,0
2019-06-03 08:15,113,37,76,0,0,0
2019-06-03 08:30,49,12,37,0,0,0
2019-06-03 08:45,69,14,55,0,0,0
2019-06-03 09:00,83,21,62,0,0,0
2019-06-03 09:15,74,31,43,0,0,0
2019-06-03 09:30,99,46,53,0,0,0
2019-06-03 09:45,116,41,75,0,0,0
2019-06-03 10:00,193,70,123,0,0,0
2019-06-03 10:15,61,28,33,0,0,0
2019-06-03 10:30,61,31,30,0,0,0
2019-06-03 10:45,64,27,37,0,0,0
2019-06-03 11:00,62,27,35,0,0,0
2019-06-03 11:15,91,33,58,0,0,0
2019-06-03 11:30,69,27,42,0,0,0
2019-06-03 11:45,177,81,96,0,0,0
2019-06-03 12:00,154,75,79,0,0,0
2019-06-03 12:15,76,24,52,0,0,0
2019-06-03 12:30,71,35,36,0,0,0
2019-06-03 12:45,105,45,60,0,0,0
2019-06-03 13:00,111,54,57,0,0,0
2019-06-03 13:15,104,48,56,0,0,0
2019-06-03 13:30,81,37,44,0,0,0
2019-06-03 13:45,169,84,85,0,0,0
2019-06-03 14:00,162,71,91,0,0,0
2019-06-03 14:15,94,45,49,0,0,0
2019-06-03 14:30,85,44,41,0,0,0
2019-06-03 14:45,107,60,47,0,0,0
2019-06-03 15:00,94,49,45,0,0,0
2019-06-03 15:15,74,49,25,0,0,0
2019-06-03 15:30,140,78,62,0,0,0
2019-06-03 15:45,206,126,80,0,0,0
2019-06-03 16:00,175,103,72,0,0,0
2019-06-03 16:15,113,66,47,0,0,0
2019-06-03 16:30,130,72,58,0,0,0
2019-06-03 16:45,107,72,35,0,0,0
2019-06-03 17:00,166,83,83,0,0,0
2019-06-03 17:15,123,71,52,0,0,0
2019-06-03 17:30,164,94,70,0,0,0
2019-06-03 17:45,229,137,92,0,0,0
2019-06-03 18:00,153,70,83,0,0,0
2019-06-03 18:15,106,52,54,0,0,0
2019-06-03 18:30,86,31,55,0,0,0
2019-06-03 18:45,88,28,60,0,0,0
2019-06-03 19:00,85,42,43,0,0,0
2019-06-03 19:15,63,18,45,0,0,0
2019-06-03 19:30,77,30,47,0,0,0
2019-06-03 19:45,86,39,47,0,0,0
2019-06-03 20:00,78,30,48,0,0,0
2019-06-03 20:15,50,15,35,0,0,0
2019-06-03 20:30,34,14,20,0,0,0
2019-06-03 20:45,45,15,30,0,0,0
2019-06-03 21:00,39,19,20,0,0,0
2019-06-03 21:15,38,23,15,0,0,0
2019-06-03 21:30,38,10,28,0,0,0
2019-06-03 21:45,41,11,30,0,0,0
2019-06-03 22:00,27,9,18,0,0,0
2019-06-03 22:15,26,4,22,0,0,0
2019-06-03 22:30,25,4,21,0,0,0
2019-06-03 22:45,17,7,10,0,0,0
2019-06-03 23:00,14,4,10,0,0,0
2019-06-03 23:15,19,6,13,0,0,0
2019-06-03 23:30,17,3,14,0,0,0
2019-06-03 23:45,14,4,10,0,0,0
2019-06-04 00:00,6,3,3,0,0,0
2019-06-04 00:15,9,1,8,0,0,0
2019-06-04 00:30,2,1,1,0,0,0
2019-06-04 00:45,2,1,1,0,0,0
2019-06-04 01:00,2,1,1,0,0,0
2019-06-04 01:15,1,0,1,0,0,0
2019-06-04 01:30,2,0,2,0,0,0
2019-06-04 01:45,0,0,0,0,0,0
2019-06-04 02:00,1,0,1,0,0,0
2019-06-04 02:15,0,0,0,0,0,0
2019-06-04 02:30,2,2,0,0,0,0
2019-06-04 02:45,2,0,2,0,0,0
2019-06-04 03:00,0,0,0,0,0,0
2019-06-04 03:15,1,1,0,0,0,0
2019-06-04 03:30,0,0,0,0,0,0
2019-06-04 03:45,0,0,0,0,0,0
2019-06-04 04:00,1,0,1,0,0,0
2019-06-04 04:15,0,0,0,0,0,0
2019-06-04 04:30,1,0,1,0,0,0
2019-06-04 04:45,2,1,1,0,0,0
2019-06-04 05:00,2,1,1,0,0,0
2019-06-04 05:15,6,3,3,0,0,0
2019-06-04 05:30,14,4,10,0,0,0
2019-06-04 05:45,7,2,5,0,0,0
2019-06-04 06:00,10,6,4,0,0,0
2019-06-04 06:15,25,8,17,0,0,0
2019-06-04 06:30,34,15,19,0,0,0
2019-06-04 06:45,58,19,39,0,0,0
2019-06-04 07:00,70,21,49,0,0,0
2019-06-04 07:15,117,61,56,0,0,0
2019-06-04 07:30,289,200,89,0,0,0
2019-06-04 07:45,254,110,144,0,0,0
2019-06-04 08:00,299,94,205,0,0,0
2019-06-04 08:15,176,65,111,0,0,0
2019-06-04 08:30,161,59,102,0,0,0
2019-06-04 08:45,205,89,116,0,0,0
2019-06-04 09:00,185,67,118,0,0,0
2019-06-04 09:15,97,49,48,0,0,0
2019-06-04 09:30,174,71,103,0,0,0
2019-06-04 09:45,258,81,177,0,0,0
2019-06-04 10:00,370,131,239,0,0,0
2019-06-04 10:15,100,41,59,0,0,0
2019-06-04 10:30,89,51,38,0,0,0
2019-06-04 10:45,86,46,40,0,0,0
2019-06-04 11:00,98,46,52,0,0,0
2019-06-04 11:15,105,43,62,0,0,0
2019-06-04 11:30,109,45,64,0,0,0
2019-06-04 11:45,253,132,121,0,0,0
2019-06-04 12:00,231,123,108,0,0,0
2019-06-04 12:15,134,62,72,0,0,0
2019-06-04 12:30,134,44,90,0,0,0
2019-06-04 12:45,140,64,76,0,0,0
2019-06-04 13:00,160,48,112,0,0,0
2019-06-04 13:15,146,45,101,0,0,0
2019-06-04 13:30,154,67,87,0,0,0
2019-06-04 13:45,246,115,131,0,0,0
2019-06-04 14:00,202,79,123,0,0,0
2019-06-04 14:15,131,70,61,0,0,0
2019-06-04 14:30,108,52,56,0,0,0
2019-06-04 14:45,147,69,78,0,0,0
2019-06-04 15:00,132,63,69,0,0,0
2019-06-04 15:15,151,84,67,0,0,0
2019-06-04 15:30,186,103,83,0,0,0
2019-06-04 15:45,267,147,120,0,0,0
2019-06-04 16:00,223,117,106,0,0,0
2019-06-04 16:15,150,80,70,0,0,0
2019-06-04 16:30,135,74,61,0,0,0
2019-06-04 16:45,164,87,77,0,0,0
2019-06-04 17:00,182,117,65,0,0,0
2019-06-04 17:15,144,91,53,0,0,0
2019-06-04 17:30,167,88,79,0,0,0
2019-06-04 17:45,254,126,128,0,0,0
2019-06-04 18:00,170,73,97,0,0,0
2019-06-04 18:15,148,61,87,0,0,0
2019-06-04 18:30,147,68,79,0,0,0
2019-06-04 18:45,131,50,81,0,0,0
2019-06-04 19:00,111,50,61,0,0,0
2019-06-04 19:15,97,30,67,0,0,0
2019-06-04 19:30,83,32,51,0,0,0
2019-06-04 19:45,122,46,76,0,0,0
2019-06-04 20:00,76,32,44,0,0,0
2019-06-04 20:15,76,29,47,0,0,0
2019-06-04 20:30,62,27,35,0,0,0
2019-06-04 20:45,48,23,25,0,0,0
2019-06-04 21:00,59,27,32,0,0,0
2019-06-04 21:15,81,33,48,0,0,0
2019-06-04 21:30,37,9,28,0,0,0
2019-06-04 21:45,45,10,35,0,0,0
2019-06-04 22:00,43,12,31,0,0,0
2019-06-04 22:15,40,13,27,0,0,0
2019-06-04 22:30,36,11,25,0,0,0
2019-06-04 22:45,41,9,32,0,0,0
2019-06-04 23:00,40,10,30,0,0,0
2019-06-04 23:15,25,12,13,0,0,0
2019-06-04 23:30,18,7,11,0,0,0
2019-06-04 23:45,24,8,16,0,0,0
2019-06-05 00:00,14,2,12,0,0,0
2019-06-05 00:15,18,4,14,0,0,0
2019-06-05 00:30,7,1,6,0,0,0
2019-06-05 00:45,4,3,1,0,0,0
2019-06-05 01:00,5,0,5,0,0,0
2019-06-05 01:15,3,1,2,0,0,0
2019-06-05 01:30,2,0,2,0,0,0
2019-06-05 01:45,10,3,7,0,0,0
2019-06-05 02:00,2,0,2,0,0,0
2019-06-05 02:15,5,0,5,0,0,0
2019-06-05 02:30,0,0,0,0,0,0
2019-06-05 02:45,1,0,1,0,0,0
2019-06-05 03:00,1,1,0,0,0,0
2019-06-05 03:15,2,1,1,0,0,0
2019-06-05 03:30,0,0,0,0,0,0
2019-06-05 03:45,0,0,0,0,0,0
2019-06-05 04:00,0,0,0,0,0,0
2019-06-05 04:15,1,1,0,0,0,0
2019-06-05 04:30,4,0,4,0,0,0
2019-06-05 04:45,1,0,1,0,0,0
2019-06-05 05:00,2,0,2,0,0,0
2019-06-05 05:15,4,4,0,0,0,0
2019-06-05 05:30,18,5,13,0,0,0
2019-06-05 05:45,10,3,7,0,0,0
2019-06-05 06:00,5,3,2,0,0,0
2019-06-05 06:15,25,9,16,0,0,0
2019-06-05 06:30,30,13,17,0,0,0
2019-06-05 06:45,55,23,32,0,0,0
2019-06-05 07:00,81,30,51,0,0,0
2019-06-05 07:15,143,73,70,0,0,0
2019-06-05 07:30,176,90,86,0,0,0
2019-06-05 07:45,253,91,162,0,0,0
2019-06-05 08:00,328,88,240,0,0,0
2019-06-05 08:15,211,80,131,0,0,0
2019-06-05 08:30,162,61,101,0,0,0
2019-06-05 08:45,198,87,111,0,0,0
2019-06-05 09:00,158,64,94,0,0,0
2019-06-05 09:15,126,64,62,0,0,0
2019-06-05 09:30,115,45,70,0,0,0
2019-06-05 09:45,255,96,159,0,0,0
2019-06-05 10:00,295,136,159,0,0,0
2019-06-05 10:15,131,60,71,0,0,0
2019-06-05 10:30,107,53,54,0,0,0
2019-06-05 10:45,109,50,59,0,0,0
2019-06-05 11:00,98,51,47,0,0,0
2019-06-05 11:15,110,57,53,0,0,0
2019-06-05 11:30,124,63,61,0,0,0
2019-06-05 11:45,257,128,129,0,0,0
2019-06-05 12:00,227,112,115,0,0,0
2019-06-05 12:15,140,68,72,0,0,0
2019-06-05 12:30,137,54,83,0,0,0
2019-06-05 12:45,152,68,84,0,0,0
2019-06-05 13:00,152,70,82,0,0,0
2019-06-05 13:15,159,65,94,0,0,0
2019-06-05 13:30,171,77,94,0,0,0
2019-06-05 13:45,303,121,182,0,0,0
2019-06-05 14:00,202,89,113,0,0,0
2019-06-05 14:15,141,70,71,0,0,0
2019-06-05 14:30,106,53,53,0,0,0
2019-06-05 14:45,143,68,75,0,0,0
2019-06-05 15:00,143,72,71,0,0,0
2019-06-05 15:15,147,84,63,0,0,0
2019-06-05 15:30,198,106,92,0,0,0
2019-06-05 15:45,221,111,110,0,0,0
2019-06-05 16:00,236,128,108,0,0,0
2019-06-05 16:15,165,92,73,0,0,0
2019-06-05 16:30,175,96,79,0,0,0
2019-06-05 16:45,158,87,71,0,0,0
2019-06-05 17:00,202,108,94,0,0,0
2019-06-05 17:15,128,63,65,0,0,0
2019-06-05 17:30,178,82,96,0,0,0
2019-06-05 17:45,246,152,94,0,0,0
2019-06-05 18:00,204,104,100,0,0,0
2019-06-05 18:15,139,64,75,0,0,0
2019-06-05 18:30,92,44,48,0,0,0
2019-06-05 18:45,121,66,55,0,0,0
2019-06-05 19:00,111,48,63,0,0,0
2019-06-05 19:15,120,40,80,0,0,0
2019-06-05 19:30,107,63,44,0,0,0
2019-06-05 19:45,122,50,72,0,0,0
2019-06-05 20:00,108,51,57,0,0,0
2019-06-05 20:15,88,36,52,0,0,0
2019-06-05 20:30,99,35,64,0,0,0
2019-06-05 20:45,57,14,43,0,0,0
2019-06-05 21:00,50,17,33,0,0,0
2019-06-05 21:15,53,19,34,0,0,0
2019-06-05 21:30,58,20,38,0,0,0
2019-06-05 21:45,48,7,41,0,0,0
2019-06-05 22:00,48,11,37,0,0,0
2019-06-05 22:15,55,18,37,0,0,0
2019-06-05 22:30,35,7,28,0,0,0
2019-06-05 22:45,31,8,23,0,0,0
2019-06-05 23:00,60,30,30,0,0,0
2019-06-05 23:15,36,7,29,0,0,0
2019-06-05 23:30,28,7,21,0,0,0
2019-06-05 23:45,18,3,15,0,0,0
2019-06-06 00:00,22,4,18,0,0,0
2019-06-06 00:15,13,2,11,0,0,0
2019-06-06 00:30,8,0,8,0,0,0
2019-06-06 00:45,13,2,11,0,0,0
2019-06-06 01:00,13,1,12,0,0,0
2019-06-06 01:15,9,0,9,0,0,0
2019-06-06 01:30,3,0,3,0,0,0
2019-06-06 01:45,6,1,5,0,0,0
2019-06-06 02:00,3,2,1,0,0,0
2019-06-06 02:15,8,1,7,0,0,0
2019-06-06 02:30,3,0,3,0,0,0
2019-06-06 02:45,6,0,6,0,0,0
2019-06-06 03:00,2,0,2,0,0,0
2019-06-06 03:15,3,0,3,0,0,0
2019-06-06 03:30,1,0,1,0,0,0
2019-06-06 03:45,2,0,2,0,0,0
2019-06-06 04:00,2,0,2,0,0,0
2019-06-06 04:15,0,0,0,0,0,0
2019-06-06 04:30,3,1,2,0,0,0
2019-06-06 04:45,1,0,1,0,0,0
2019-06-06 05:00,3,1,2,0,0,0
2019-06-06 05:15,0,0,0,0,0,0
2019-06-06 05:30,14,5,9,0,0,0
2019-06-06 05:45,6,0,6,0,0,0
2019-06-06 06:00,9,7,2,0,0,0
2019-06-06 06:15,16,7,9,0,0,0
2019-06-06 06:30,25,11,14,0,0,0
2019-06-06 06:45,44,15,29,0,0,0
2019-06-06 07:00,58,9,49,0,0,0
2019-06-06 07:15,98,40,58,0,0,0
2019-06-06 07:30,203,117,86,0,0,0
2019-06-06 07:45,216,68,148,0,0,0
2019-06-06 08:00,254,57,197,0,0,0
2019-06-06 08:15,172,52,120,0,0,0
2019-06-06 08:30,108,42,66,0,0,0
2019-06-06 08:45,140,68,72,0,0,0
2019-06-06 09:00,119,37,82,0,0,0
2019-06-06 09:15,88,35,53,0,0,0
2019-06-06 09:30,96,56,40,0,0,0
2019-06-06 09:45,188,82,106,0,0,0
2019-06-06 10:00,196,71,125,0,0,0
2019-06-06 10:15,93,45,48,0,0,0
2019-06-06 10:30,68,16,52,0,0,0
2019-06-06 10:45,86,35,51,0,0,0
2019-06-06 11:00,104,59,45,0,0,0
2019-06-06 11:15,94,43,51,0,0,0
2019-06-06 11:30,109,48,61,0,0,0
2019-06-06 11:45,192,98,94,0,0,0
2019-06-06 12:00,174,83,91,0,0,0
2019-06-06 12:15,110,45,65,0,0,0
2019-06-06 12:30,112,44,68,0,0,0
2019-06-06 12:45,114,48,66,0,0,0
2019-06-06 13:00,142,55,87,0,0,0
2019-06-06 13:15,117,49,68,0,0,0
2019-06-06 13:30,163,68,95,0,0,0
2019-06-06 13:45,225,103,122,0,0,0
2019-06-06 14:00,177,77,100,0,0,0
2019-06-06 14:15,94,51,43,0,0,0
2019-06-06 14:30,111,56,55,0,0,0
2019-06-06 14:45,112,58,54,0,0,0
2019-06-06 15:00,117,69,48,0,0,0
2019-06-06 15:15,111,57,54,0,0,0
2019-06-06 15:30,154,90,64,0,0,0
2019-06-06 15:45,206,114,92,0,0,0
2019-06-06 16:00,188,90,98,0,0,0
2019-06-06 16:15,136,80,56,0,0,0
2019-06-06 16:30,121,68,53,0,0,0
2019-06-06 16:45,142,72,70,0,0,0
2019-06-06 17:00,125,82,43,0,0,0
2019-06-06 17:15,135,77,58,0,0,0
2019-06-06 17:30,147,85,62,0,0,0
2019-06-06 17:45,196,102,94,0,0,0
2019-06-06 18:00,187,92,95,0,0,0
2019-06-06 18:15,124,63,61,0,0,0
2019-06-06 18:30,118,61,57,0,0,0
2019-06-06 18:45,109,53,56,0,0,0
2019-06-06 19:00,83,33,50,0,0,0
2019-06-06 19:15,86,32,54,0,0,0
2019-06-06 19:30,75,32,43,0,0,0
2019-06-06 19:45,89,46,43,0,0,0
2019-06-06 20:00,89,27,62,0,0,0
2019-06-06 20:15,68,31,37,0,0,0
2019-06-06 20:30,61,19,42,0,0,0
2019-06-06 20:45,42,18,24,0,0,0
2019-06-06 21:00,58,25,33,0,0,0
2019-06-06 21:15,51,26,25,0,0,0
2019-06-06 21:30,35,12,23,0,0,0
2019-06-06 21:45,35,7,28,0,0,0
2019-06-06 22:00,38,14,24,0,0,0
2019-06-06 22:15,47,11,36,0,0,0
2019-06-06 22:30,39,8,31,0,0,0
2019-06-06 22:45,33,8,25,0,0,0
2019-06-06 23:00,27,12,15,0,0,0
2019-06-06 23:15,21,8,13,0,0,0
2019-06-06 23:30,13,3,10,0,0,0
2019-06-06 23:45,19,3,16,0,0,0
2019-06-07 00:00,9,3,6,0,0,0
2019-06-07 00:15,9,4,5,0,0,0
2019-06-07 00:30,12,4,8,0,0,0
2019-06-07 00:45,13,5,8,0,0,0
2019-06-07 01:00,8,0,8,0,0,0
2019-06-07 01:15,6,0,6,0,0,0
2019-06-07 01:30,4,0,4,0,0,0
2019-06-07 01:45,6,0,6,0,0,0
2019-06-07 02:00,4,1,3,0,0,0
2019-06-07 02:15,2,0,2,0,0,0
2019-06-07 02:30,1,0,1,0,0,0
2019-06-07 02:45,3,0,3,0,0,0
2019-06-07 03:00,4,0,4,0,0,0
2019-06-07 03:15,1,1,0,0,0,0
2019-06-07 03:30,3,1,2,0,0,0
2019-06-07 03:45,0,0,0,0,0,0
2019-06-07 04:00,2,2,0,0,0,0
2019-06-07 04:15,3,1,2,0,0,0
2019-06-07 04:30,1,0,1,0,0,0
2019-06-07 04:45,4,1,3,0,0,0
2019-06-07 05:00,3,1,2,0,0,0
2019-06-07 05:15,6,3,3,0,0,0
2019-06-07 05:30,10,4,6,0,0,0
2019-06-07 05:45,8,4,4,0,0,0
2019-06-07 06:00,4,2,2,0,0,0
2019-06-07 06:15,32,12,20,0,0,0
2019-06-07 06:30,35,13,22,0,0,0
2019-06-07 06:45,44,13,31,0,0,0
2019-06-07 07:00,72,20,52,0,0,0
2019-06-07 07:15,111,52,59,0,0,0
2019-06-07 07:30,253,175,78,0,0,0
2019-06-07 07:45,243,100,143,0,0,0
2019-06-07 08:00,259,69,190,0,0,0
2019-06-07 08:15,147,38,109,0,0,0
2019-06-07 08:30,120,60,60,0,0,0
2019-06-07 08:45,145,77,68,0,0,0
2019-06-07 09:00,116,53,63,0,0,0
2019-06-07 09:15,83,36,47,0,0,0
2019-06-07 09:30,135,52,83,0,0,0
2019-06-07 09:45,147,70,77,0,0,0
2019-06-07 10:00,265,81,184,0,0,0
2019-06-07 10:15,103,49,54,0,0,0
2019-06-07 10:30,83,39,44,0,0,0
2019-06-07 10:45,97,44,53,0,0,0
2019-06-07 11:00,63,25,38,0,0,0
2019-06-07 11:15,70,32,38,0,0,0
2019-06-07 11:30,92,48,44,0,0,0
2019-06-07 11:45,127,68,59,0,0,0
2019-06-07 12:00,158,102,56,0,0,0
2019-06-07 12:15,159,67,92,0,0,0
2019-06-07 12:30,144,72,72,0,0,0
2019-06-07 12:45,138,67,71,0,0,0
2019-06-07 13:00,182,85,97,0,0,0
2019-06-07 13:15,179,60,119,0,0,0
2019-06-07 13:30,140,74,66,0,0,0
2019-06-07 13:45,157,72,85,0,0,0
2019-06-07 14:00,157,80,77,0,0,0
2019-06-07 14:15,131,67,64,0,0,0
2019-06-07 14:30,158,84,74,0,0,0
2019-06-07 14:45,133,61,72,0,0,0
2019-06-07 15:00,108,55,53,0,0,0
2019-06-07 15:15,97,51,46,0,0,0
2019-06-07 15:30,165,70,95,0,0,0
2019-06-07 15:45,144,78,66,0,0,0
2019-06-07 16:00,174,103,71,0,0,0
2019-06-07 16:15,129,57,72,0,0,0
2019-06-07 16:30,132,76,56,0,0,0
2019-06-07 16:45,125,74,51,0,0,0
2019-06-07 17:00,122,58,64,0,0,0
2019-06-07 17:15,101,44,57,0,0,0
2019-06-07 17:30,150,78,72,0,0,0
2019-06-07 17:45,116,49,67,0,0,0
2019-06-07 18:00,83,38,45,0,0,0
2019-06-07 18:15,103,35,68,0,0,0
2019-06-07 18:30,85,43,42,0,0,0
2019-06-07 18:45,92,52,40,0,0,0
2019-06-07 19:00,39,12,27,0,0,0
2019-06-07 19:15,54,24,30,0,0,0
2019-06-07 19:30,41,12,29,0,0,0
2019-06-07 19:45,49,26,23,0,0,0
2019-06-07 20:00,58,27,31,0,0,0
2019-06-07 20:15,64,24,40,0,0,0
2019-06-07 20:30,33,16,17,0,0,0
2019-06-07 20:45,41,20,21,0,0,0
2019-06-07 21:00,35,11,24,0,0,0
2019-06-07 21:15,31,13,18,0,0,0
2019-06-07 21:30,36,11,25,0,0,0
2019-06-07 21:45,26,9,17,0,0,0
2019-06-07 22:00,23,8,15,0,0,0
2019-06-07 22:15,21,10,11,0,0,0
2019-06-07 22:30,29,17,12,0,0,0
2019-06-07 22:45,17,2,15,0,0,0
2019-06-07 23:00,15,4,11,0,0,0
2019-06-07 23:15,19,9,10,0,0,0
2019-06-07 23:30,18,4,14,0,0,0
2019-06-07 23:45,14,3,11,0,0,0
2019-06-08 00:00,7,2,5,0,0,0
2019-06-08 00:15,19,6,13,0,0,0
2019-06-08 00:30,10,5,5,0,0,0
2019-06-08 00:45,8,5,3,0,0,0
2019-06-08 01:00,12,3,9,0,0,0
2019-06-08 01:15,6,0,6,0,0,0
2019-06-08 01:30,10,1,9,0,0,0
2019-06-08 01:45,10,3,7,0,0,0
2019-06-08 02:00,14,3,11,0,0,0
2019-06-08 02:15,15,1,14,0,0,0
2019-06-08 02:30,3,1,2,0,0,0
2019-06-08 02:45,2,1,1,0,0,0
2019-06-08 03:00,4,1,3,0,0,0
2019-06-08 03:15,10,1,9,0,0,0
2019-06-08 03:30,3,0,3,0,0,0
2019-06-08 03:45,4,1,3,0,0,0
2019-06-08 04:00,6,0,6,0,0,0
2019-06-08 04:15,1,0,1,0,0,0
2019-06-08 04:30,2,0,2,0,0,0
2019-06-08 04:45,0,0,0,0,0,0
2019-06-08 05:00,2,0,2,0,0,0
2019-06-08 05:15,2,1,1,0,0,0
2019-06-08 05:30,5,0,5,0,0,0
2019-06-08 05:45,1,0,1,0,0,0
2019-06-08 06:00,2,2,0,0,0,0
2019-06-08 06:15,6,5,1,0,0,0
2019-06-08 06:30,7,5,2,0,0,0
2019-06-08 06:45,6,5,1,0,0,0
2019-06-08 07:00,6,2,4,0,0,0
2019-06-08 07:15,10,4,6,0,0,0
2019-06-08 07:30,20,14,6,0,0,0
2019-06-08 07:45,19,9,10,0,0,0
2019-06-08 08:00,12,6,6,0,0,0
2019-06-08 08:15,18,14,4,0,0,0
2019-06-08 08:30,27,14,13,0,0,0
2019-06-08 08:45,33,23,10,0,0,0
2019-06-08 09:00,36,22,14,0,0,0
2019-06-08 09:15,36,24,12,0,0,0
2019-06-08 09:30,30,23,7,0,0,0
2019-06-08 09:45,53,36,17,0,0,0
2019-06-08 10:00,48,33,15,0,0,0
2019-06-08 10:15,54,30,24,0,0,0
2019-06-08 10:30,68,55,13,0,0,0
2019-06-08 10:45,54,44,10,0,0,0
2019-06-08 11:00,70,49,21,0,0,0
2019-06-08 11:15,56,33,23,0,0,0
2019-06-08 11:30,84,55,29,0,0,0
2019-06-08 11:45,56,35,21,0,0,0
2019-06-08 12:00,71,47,24,0,0,0
2019-06-08 12:15,66,35,31,0,0,0
2019-06-08 12:30,77,40,37,0,0,0
2019-06-08 12:45,91,53,38,0,0,0
2019-06-08 13:00,86,44,42,0,0,0
2019-06-08 13:15,72,31,41,0,0,0
2019-06-08 13:30,69,25,44,0,0,0
2019-06-08 13:45,72,30,42,0,0,0
2019-06-08 14:00,86,49,37,0,0,0
2019-06-08 14:15,55,22,33,0,0,0
2019-06-08 14:30,89,34,55,0,0,0
2019-06-08 14:45,74,27,47,0,0,0
2019-06-08 15:00,67,20,47,0,0,0
2019-06-08 15:15,72,27,45,0,0,0
2019-06-08 15:30,84,41,43,0,0,0
2019-06-08 15:45,48,19,29,0,0,0
2019-06-08 16:00,46,25,21,0,0,0
2019-06-08 16:15,66,25,41,0,0,0
2019-06-08 16:30,63,31,32,0,0,0
2019-06-08 16:45,47,27,20,0,0,0
2019-06-08 17:00,30,11,19,0,0,0
2019-06-08 17:15,56,17,39,0,0,0
2019-06-08 17:30,60,16,44,0,0,0
2019-06-08 17:45,59,34,25,0,0,0
2019-06-08 18:00,37,8,29,0,0,0
2019-06-08 18:15,53,20,33,0,0,0
2019-06-08 18:30,72,30,42,0,0,0
2019-06-08 18:45,44,17,27,0,0,0
2019-06-08 19:00,39,14,25,0,0,0
2019-06-08 19:15,30,17,13,0,0,0
2019-06-08 19:30,33,14,19,0,0,0
2019-06-08 19:45,52,19,33,0,0,0
2019-06-08 20:00,28,0,28,0,0,0
2019-06-08 20:15,30,12,18,0,0,0
2019-06-08 20:30,27,13,14,0,0,0
2019-06-08 20:45,31,10,21,0,0,0
2019-06-08 21:00,29,17,12,0,0,0
2019-06-08 21:15,18,5,13,0,0,0
2019-06-08 21:30,10,6,4,0,0,0
2019-06-08 21:45,6,2,4,0,0,0
2019-06-08 22:00,11,2,9,0,0,0
2019-06-08 22:15,24,4,20,0,0,0
2019-06-08 22:30,15,4,11,0,0,0
2019-06-08 22:45,18,4,14,0,0,0
2019-06-08 23:00,9,5,4,0,0,0
2019-06-08 23:15,10,4,6,0,0,0
2019-06-08 23:30,12,4,8,0,0,0
2019-06-08 23:45,22,12,10,0,0,0
2019-06-09 00:00,19,7,12,0,0,0
2019-06-09 00:15,16,3,13,0,0,0
2019-06-09 00:30,17,7,10,0,0,0
2019-06-09 00:45,14,9,5,0,0,0
2019-06-09 01:00,6,4,2,0,0,0
2019-06-09 01:15,10,4,6,0,0,0
2019-06-09 01:30,13,5,8,0,0,0
2019-06-09 01:45,2,2,0,0,0,0
2019-06-09 02:00,7,0,7,0,0,0
2019-06-09 02:15,11,0,11,0,0,0
2019-06-09 02:30,1,0,1,0,0,0
2019-06-09 02:45,3,1,2,0,0,0
2019-06-09 03:00,1,1,0,0,0,0
2019-06-09 03:15,8,0,8,0,0,0
2019-06-09 03:30,5,0,5,0,0,0
2019-06-09 03:45,3,0,3,0,0,0
2019-06-09 04:00,7,0,7,0,0,0
2019-06-09 04:15,3,0,3,0,0,0
2019-06-09 04:30,6,2,4,0,0,0
2019-06-09 04:45,0,0,0,0,0,0
2019-06-09 05:00,0,0,0,0,0,0
2019-06-09 05:15,1,0,1,0,0,0
2019-06-09 05:30,4,1,3,0,0,0
2019-06-09 05:45,4,0,4,0,0,0
2019-06-09 06:00,5,4,1,0,0,0
2019-06-09 06:15,3,2,1,0,0,0
2019-06-09 06:30,4,3,1,0,0,0
2019-06-09 06:45,5,0,5,0,0,0
2019-06-09 07:00,5,1,4,0,0,0
2019-06-09 07:15,2,2,0,0,0,0
2019-06-09 07:30,12,3,9,0,0,0
2019-06-09 07:45,15,10,5,0,0,0
2019-06-09 08:00,3,1,2,0,0,0
2019-06-09 08:15,4,4,0,0,0,0
2019-06-09 08:30,10,3,7,0,0,0
2019-06-09 08:45,20,14,6,0,0,0
2019-06-09 09:00,6,4,2,0,0,0
2019-06-09 09:15,15,8,7,0,0,0
2019-06-09 09:30,19,12,7,0,0,0
2019-06-09 09:45,37,24,13,0,0,0
2019-06-09 10:00,20,8,12,0,0,0
2019-06-09 10:15,21,9,12,0,0,0
2019-06-09 10:30,36,21,15,0,0,0
2019-06-09 10:45,37,29,8,0,0,0
2019-06-09 11:00,31,17,14,0,0,0
2019-06-09 11:15,36,9,27,0,0,0
2019-06-09 11:30,57,18,39,0,0,0
2019-06-09 11:45,28,18,10,0,0,0
2019-06-09 12:00,32,12,20,0,0,0
2019-06-09 12:15,57,38,19,0,0,0
2019-06-09 12:30,46,23,23,0,0,0
2019-06-09 12:45,49,22,27,0,0,0
2019-06-09 13:00,56,23,33,0,0,0
2019-06-09 13:15,54,23,31,0,0,0
2019-06-09 13:30,43,16,27,0,0,0
2019-06-09 13:45,58,26,32,0,0,0
2019-06-09 14:00,42,19,23,0,0,0
2019-06-09 14:15,42,16,26,0,0,0
2019-06-09 14:30,52,24,28,0,0,0
2019-06-09 14:45,62,30,32,0,0,0
2019-06-09 15:00,81,34,47,0,0,0
2019-06-09 15:15,71,29,42,0,0,0
2019-06-09 15:30,57,19,38,0,0,0
2019-06-09 15:45,48,27,21,0,0,0
2019-06-09 16:00,72,31,41,0,0,0
2019-06-09 16:15,52,30,22,0,0,0
2019-06-09 16:30,63,36,27,0,0,0
2019-06-09 16:45,67,31,36,0,0,0
2019-06-09 17:00,66,24,42,0,0,0
2019-06-09 17:15,48,28,20,0,0,0
2019-06-09 17:30,72,21,51,0,0,0
2019-06-09 17:45,69,25,44,0,0,0
2019-06-09 18:00,47,15,32,0,0,0
2019-06-09 18:15,39,18,21,0,0,0
2019-06-09 18:30,55,27,28,0,0,0
2019-06-09 18:45,47,22,25,0,0,0
2019-06-09 19:00,65,37,28,0,0,0
2019-06-09 19:15,45,17,28,0,0,0
2019-06-09 19:30,71,61,10,0,0,0
2019-06-09 19:45,83,57,26,0,0,0
2019-06-09 20:00,81,58,23,0,0,0
2019-06-09 20:15,85,63,22,0,0,0
2019-06-09 20:30,47,32,15,0,0,0
2019-06-09 20:45,51,21,30,0,0,0
2019-06-09 21:00,41,18,23,0,0,0
2019-06-09 21:15,30,10,20,0,0,0
2019-06-09 21:30,46,5,41,0,0,0
2019-06-09 21:45,43,3,40,0,0,0
2019-06-09 22:00,110,8,102,0,0,0
2019-06-09 22:15,45,4,41,0,0,0
2019-06-09 22:30,24,0,24,0,0,0
2019-06-09 22:45,12,4,8,0,0,0
2019-06-09 23:00,25,2,23,0,0,0
2019-06-09 23:15,25,1,24,0,0,0
2019-06-09 23:30,13,2,11,0,0,0
2019-06-09 23:45,5,1,4,0,0,0
2019-06-10 00:00,20,1,19,0,0,0
2019-06-10 00:15,15,1,14,0,0,0
2019-06-10 00:30,13,5,8,0,0,0
2019-06-10 00:45,17,11,6,0,0,0
2019-06-10 01:00,5,1,4,0,0,0
2019-06-10 01:15,4,0,4,0,0,0
2019-06-10 01:30,2,0,2,0,0,0
2019-06-10 01:45,7,1,6,0,0,0
2019-06-10 02:00,3,0,3,0,0,0
2019-06-10 02:15,2,1,1,0,0,0
2019-06-10 02:30,0,0,0,0,0,0
2019-06-10 02:45,1,1,0,0,0,0
2019-06-10 03:00,2,0,2,0,0,0
2019-06-10 03:15,1,0,1,0,0,0
2019-06-10 03:30,2,1,1,0,0,0
2019-06-10 03:45,5,0,5,0,0,0
2019-06-10 04:00,0,0,0,0,0,0
2019-06-10 04:15,0,0,0,0,0,0
2019-06-10 04:30,0,0,0,0,0,0
2019-06-10 04:45,1,1,0,0,0,0
2019-06-10 05:00,2,0,2,0,0,0
2019-06-10 05:15,4,0,4,0,0,0
2019-06-10 05:30,9,0,9,0,0,0
2019-06-10 05:45,5,0,5,0,0,0
2019-06-10 06:00,2,2,0,0,0,0
2019-06-10 06:15,0,0,0,0,0,0
2019-06-10 06:30,5,4,1,0,0,0
2019-06-10 06:45,8,5,3,0,0,0
2019-06-10 07:00,4,1,3,0,0,0
2019-06-10 07:15,1,0,1,0,0,0
2019-06-10 07:30,2,0,2,0,0,0
2019-06-10 07:45,8,4,4,0,0,0
2019-06-10 08:00,9,5,4,0,0,0
2019-06-10 08:15,6,2,4,0,0,0
2019-06-10 08:30,18,5,13,0,0,0
2019-06-10 08:45,11,5,6,0,0,0
2019-06-10 09:00,16,9,7,0,0,0
2019-06-10 09:15,21,13,8,0,0,0
2019-06-10 09:30,12,7,5,0,0,0
2019-06-10 09:45,24,15,9,0,0,0
2019-06-10 10:00,25,12,13,0,0,0
2019-06-10 10:15,37,26,11,0,0,0
2019-06-10 10:30,27,11,16,0,0,0
2019-06-10 10:45,46,40,6,0,0,0
2019-06-10 11:00,70,48,22,0,0,0
2019-06-10 11:15,46,36,10,0,0,0
2019-06-10 11:30,40,14,26,0,0,0
2019-06-10 11:45,58,24,34,0,0,0
2019-06-10 12:00,53,18,35,0,0,0
2019-06-10 12:15,38,17,21,0,0,0
2019-06-10 12:30,56,20,36,0,0,0
2019-06-10 12:45,57,26,31,0,0,0
2019-06-10 13:00,80,33,47,0,0,0
2019-06-10 13:15,53,21,32,0,0,0
2019-06-10 13:30,42,14,28,0,0,0
2019-06-10 13:45,61,34,27,0,0,0
2019-06-10 14:00,51,17,34,0,0,0
2019-06-10 14:15,52,24,28,0,0,0
2019-06-10 14:30,56,14,42,0,0,0
2019-06-10 14:45,75,51,24,0,0,0
2019-06-10 15:00,65,16,49,0,0,0
2019-06-10 15:15,53,24,29,0,0,0
2019-06-10 15:30,52,35,17,0,0,0
2019-06-10 15:45,58,26,32,0,0,0
2019-06-10 16:00,50,20,30,0,0,0
2019-06-10 16:15,58,33,25,0,0,0
2019-06-10 16:30,68,44,24,0,0,0
2019-06-10 16:45,60,33,27,0,0,0
2019-06-10 17:00,79,44,35,0,0,0
2019-06-10 17:15,44,17,27,0,0,0
2019-06-10 17:30,50,25,25,0,0,0
2019-06-10 17:45,66,17,49,0,0,0
2019-06-10 18:00,54,16,38,0,0,0
2019-06-10 18:15,48,17,31,0,0,0
2019-06-10 18:30,55,18,37,0,0,0
2019-06-10 18:45,52,27,25,0,0,0
2019-06-10 19:00,48,15,33,0,0,0
2019-06-10 19:15,28,14,14,0,0,0
2019-06-10 19:30,21,12,9,0,0,0
2019-06-10 19:45,23,6,17,0,0,0
2019-06-10 20:00,23,5,18,0,0,0
2019-06-10 20:15,15,8,7,0,0,0
2019-06-10 20:30,27,10,17,0,0,0
2019-06-10 20:45,17,8,9,0,0,0
2019-06-10 21:00,17,6,11,0,0,0
2019-06-10 21:15,20,5,15,0,0,0
2019-06-10 21:30,26,2,24,0,0,0
2019-06-10 21:45,15,2,13,0,0,0
2019-06-10 22:00,18,8,10,0,0,0
2019-06-10 22:15,12,4,8,0,0,0
2019-06-10 22:30,7,1,6,0,0,0
2019-06-10 22:45,7,0,7,0,0,0
2019-06-10 23:00,10,1,9,0,0,0
2019-06-10 23:15,7,3,4,0,0,0
2019-06-10 23:30,4,1,3,0,0,0
2019-06-10 23:45,2,1,1,0,0,0
2019-06-11 00:00,3,0,3,0,0,0
2019-06-11 00:15,5,2,3,0,0,0
2019-06-11 00:30,0,0,0,0,0,0
2019-06-11 00:45,5,1,4,0,0,0
2019-06-11 01:00,2,1,1,0,0,0
2019-06-11 01:15,4,2,2,0,0,0
2019-06-11 01:30,0,0,0,0,0,0
2019-06-11 01:45,3,3,0,0,0,0
2019-06-11 02:00,2,0,2,0,0,0
2019-06-11 02:15,0,0,0,0,0,0
2019-06-11 02:30,1,0,1,0,0,0
2019-06-11 02:45,1,1,0,0,0,0
2019-06-11 03:00,0,0,0,0,0,0
2019-06-11 03:15,0,0,0,0,0,0
2019-06-11 03:30,0,0,0,0,0,0
2019-06-11 03:45,0,0,0,0,0,0
2019-06-11 04:00,0,0,0,0,0,0
2019-06-11 04:15,1,1,0,0,0,0
2019-06-11 04:30,2,1,1,0,0,0
2019-06-11 04:45,3,3,0,0,0,0
2019-06-11 05:00,0,0,0,0,0,0
2019-06-11 05:15,2,2,0,0,0,0
2019-06-11 05:30,10,4,6,0,0,0
2019-06-11 05:45,12,1,11,0,0,0
2019-06-11 06:00,7,6,1,0,0,0
2019-06-11 06:15,17,7,10,0,0,0
2019-06-11 06:30,20,4,16,0,0,0
2019-06-11 06:45,25,10,15,0,0,0
2019-06-11 07:00,42,10,32,0,0,0
2019-06-11 07:15,49,21,28,0,0,0
2019-06-11 07:30,63,28,35,0,0,0
2019-06-11 07:45,96,37,59,0,0,0
2019-06-11 08:00,101,27,74,0,0,0
2019-06-11 08:15,86,39,47,0,0,0
2019-06-11 08:30,75,33,42,0,0,0
2019-06-11 08:45,114,51,63,0,0,0
2019-06-11 09:00,91,42,49,0,0,0
2019-06-11 09:15,68,33,35,0,0,0
2019-06-11 09:30,65,30,35,0,0,0
2019-06-11 09:45,84,39,45,0,0,0
2019-06-11 10:00,50,16,34,0,0,0
2019-06-11 10:15,61,25,36,0,0,0
2019-06-11 10:30,48,20,28,0,0,0
2019-06-11 10:45,54,32,22,0,0,0
2019-06-11 11:00,61,36,25,0,0,0
2019-06-11 11:15,58,27,31,0,0,0
2019-06-11 11:30,56,26,30,0,0,0
2019-06-11 11:45,72,43,29,0,0,0
2019-06-11 12:00,67,28,39,0,0,0
2019-06-11 12:15,92,36,56,0,0,0
2019-06-11 12:30,81,45,36,0,0,0
2019-06-11 12:45,64,31,33,0,0,0
2019-06-11 13:00,77,36,41,0,0,0
2019-06-11 13:15,67,31,36,0,0,0
2019-06-11 13:30,82,37,45,0,0,0
2019-06-11 13:45,98,40,58,0,0,0
2019-06-11 14:00,57,23,34,0,0,0
2019-06-11 14:15,96,55,41,0,0,0
2019-06-11 14:30,59,28,31,0,0,0
2019-06-11 14:45,110,57,53,0,0,0
2019-06-11 15:00,99,67,32,0,0,0
2019-06-11 15:15,98,55,43,0,0,0
2019-06-11 15:30,87,44,43,0,0,0
2019-06-11 15:45,108,64,44,0,0,0
2019-06-11 16:00,114,51,63,0,0,0
2019-06-11 16:15,100,56,44,0,0,0
2019-06-11 16:30,114,60,54,0,0,0
2019-06-11 16:45,130,73,57,0,0,0
2019-06-11 17:00,118,49,69,0,0,0
2019-06-11 17:15,108,55,53,0,0,0
2019-06-11 17:30,117,66,51,0,0,0
2019-06-11 17:45,132,57,75,0,0,0
2019-06-11 18:00,89,34,55,0,0,0
2019-06-11 18:15,119,49,70,0,0,0
2019-06-11 18:30,77,25,52,0,0,0
2019-06-11 18:45,97,28,69,0,0,0
2019-06-11 19:00,93,35,58,0,0,0
2019-06-11 19:15,72,26,46,0,0,0
2019-06-11 19:30,68,25,43,0,0,0
2019-06-11 19:45,82,29,53,0,0,0
2019-06-11 20:00,55,12,43,0,0,0
2019-06-11 20:15,53,15,38,0,0,0
2019-06-11 20:30,41,13,28,0,0,0
2019-06-11 20:45,53,21,32,0,0,0
2019-06-11 21:00,30,15,15,0,0,0
2019-06-11 21:15,32,14,18,0,0,0
2019-06-11 21:30,31,8,23,0,0,0
2019-06-11 21:45,41,14,27,0,0,0
2019-06-11 22:00,29,11,18,0,0,0
2019-06-11 22:15,22,12,10,0,0,0
2019-06-11 22:30,37,11,26,0,0,0
2019-06-11 22:45,21,2,19,0,0,0
2019-06-11 23:00,17,2,15,0,0,0
2019-06-11 23:15,12,2,10,0,0,0
2019-06-11 23:30,16,6,10,0,0,0
2019-06-11 23:45,16,6,10,0,0,0
2019-06-12 00:00,7,0,7,0,0,0
2019-06-12 00:15,9,3,6,0,0,0
2019-06-12 00:30,5,2,3,0,0,0
2019-06-12 00:45,2,0,2,0,0,0
2019-06-12 01:00,6,1,5,0,0,0
2019-06-12 01:15,3,0,3,0,0,0
2019-06-12 01:30,1,0,1,0,0,0
2019-06-12 01:45,0,0,0,0,0,0
2019-06-12 02:00,1,0,1,0,0,0
2019-06-12 02:15,0,0,0,0,0,0
2019-06-12 02:30,1,0,1,0,0,0
2019-06-12 02:45,2,1,1,0,0,0
2019-06-12 03:00,0,0,0,0,0,0
2019-06-12 03:15,0,0,0,0,0,0
2019-06-12 03:30,0,0,0,0,0,0
2019-06-12 03:45,2,1,1,0,0,0
2019-06-12 04:00,1,0,1,0,0,0
2019-06-12 04:15,1,0,1,0,0,0
2019-06-12 04:30,3,2,1,0,0,0
2019-06-12 04:45,1,0,1,0,0,0
2019-06-12 05:00,4,3,1,0,0,0
2019-06-12 05:15,4,2,2,0,0,0
2019-06-12 05:30,10,2,8,0,0,0
2019-06-12 05:45,14,3,11,0,0,0
2019-06-12 06:00,12,10,2,0,0,0
2019-06-12 06:15,23,7,16,0,0,0
2019-06-12 06:30,31,10,21,0,0,0
2019-06-12 06:45,50,19,31,0,0,0
2019-06-12 07:00,79,26,53,0,0,0
2019-06-12 07:15,115,60,55,0,0,0
2019-06-12 07:30,222,173,49,0,0,0
2019-06-12 07:45,204,83,121,0,0,0
2019-06-12 08:00,175,64,111,0,0,0
2019-06-12 08:15,128,66,62,0,0,0
2019-06-12 08:30,135,57,78,0,0,0
2019-06-12 08:45,145,66,79,0,0,0
2019-06-12 09:00,101,51,50,0,0,0
2019-06-12 09:15,104,54,50,0,0,0
2019-06-12 09:30,110,57,53,0,0,0
2019-06-12 09:45,118,56,62,0,0,0
2019-06-12 10:00,81,38,43,0,0,0
2019-06-12 10:15,74,36,38,0,0,0
2019-06-12 10:30,65,29,36,0,0,0
2019-06-12 10:45,73,32,41,0,0,0
2019-06-12 11:00,65,30,35,0,0,0
2019-06-12 11:15,72,36,36,0,0,0
2019-06-12 11:30,82,36,46,0,0,0
2019-06-12 11:45,79,32,47,0,0,0
2019-06-12 12:00,56,21,35,0,0,0
2019-06-12 12:15,69,24,45,0,0,0
2019-06-12 12:30,58,16,42,0,0,0
2019-06-12 12:45,45,13,32,0,0,0
2019-06-12 13:00,61,13,48,0,0,0
2019-06-12 13:15,48,16,32,0,0,0
2019-06-12 13:30,62,27,35,0,0,0
2019-06-12 13:45,90,48,42,0,0,0
2019-06-12 14:00,78,34,44,0,0,0
2019-06-12 14:15,50,24,26,0,0,0
2019-06-12 14:30,50,24,26,0,0,0
2019-06-12 14:45,72,24,48,0,0,0
2019-06-12 15:00,63,33,30,0,0,0
2019-06-12 15:15,85,53,32,0,0,0
2019-06-12 15:30,154,58,96,0,0,0
2019-06-12 15:45,112,49,63,0,0,0
2019-06-12 16:00,100,59,41,0,0,0
2019-06-12 16:15,133,80,53,0,0,0
2019-06-12 16:30,110,62,48,0,0,0
2019-06-12 16:45,121,73,48,0,0,0
2019-06-12 17:00,92,57,35,0,0,0
2019-06-12 17:15,137,81,56,0,0,0
2019-06-12 17:30,104,56,48,0,0,0
2019-06-12 17:45,120,55,65,0,0,0
2019-06-12 18:00,123,42,81,0,0,0
2019-06-12 18:15,112,44,68,0,0,0
2019-06-12 18:30,85,44,41,0,0,0
2019-06-12 18:45,101,44,57,0,0,0
2019-06-12 19:00,93,40,53,0,0,0
2019-06-12 19:15,66,29,37,0,0,0
2019-06-12 19:30,67,29,38,0,0,0
2019-06-12 19:45,77,31,46,0,0,0
2019-06-12 20:00,74,21,53,0,0,0
2019-06-12 20:15,82,22,60,0,0,0
2019-06-12 20:30,53,16,37,0,0,0
2019-06-12 20:45,53,17,36,0,0,0
2019-06-12 21:00,53,20,33,0,0,0
2019-06-12 21:15,40,17,23,0,0,0
2019-06-12 21:30,34,5,29,0,0,0
2019-06-12 21:45,22,10,12,0,0,0
2019-06-12 22:00,59,35,24,0,0,0
2019-06-12 22:15,36,13,23,0,0,0
2019-06-12 22:30,41,18,23,0,0,0
2019-06-12 22:45,29,12,17,0,0,0
2019-06-12 23:00,28,15,13,0,0,0
2019-06-12 23:15,24,9,15,0,0,0
2019-06-12 23:30,47,26,21,0,0,0
2019-06-12 23:45,24,17,7,0,0,0
2019-06-13 00:00,21,8,13,0,0,0
2019-06-13 00:15,20,13,7,0,0,0
2019-06-13 00:30,17,12,5,0,0,0
2019-06-13 00:45,9,4,5,0,0,0
2019-06-13 01:00,12,4,8,0,0,0
2019-06-13 01:15,9,1,8,0,0,0
2019-06-13 01:30,4,1,3,0,0,0
2019-06-13 01:45,2,0,2,0,0,0
2019-06-13 02:00,0,0,0,0,0,0
2019-06-13 02:15,3,0,3,0,0,0
2019-06-13 02:30,2,0,2,0,0,0
2019-06-13 02:45,2,1,1,0,0,0
2019-06-13 03:00,3,2,1,0,0,0
2019-06-13 03:15,0,0,0,0,0,0
2019-06-13 03:30,2,1,1,0,0,0
2019-06-13 03:45,0,0,0,0,0,0
2019-06-13 04:00,0,0,0,0,0,0
2019-06-13 04:15,2,1,1,0,0,0
2019-06-13 04:30,3,0,3,0,0,0
2019-06-13 04:45,4,3,1,0,0,0
2019-06-13 05:00,4,0,4,0,0,0
2019-06-13 05:15,1,1,0,0,0,0
2019-06-13 05:30,8,3,5,0,0,0
2019-06-13 05:45,16,5,11,0,0,0
2019-06-13 06:00,12,9,3,0,0,0
2019-06-13 06:15,19,8,11,0,0,0
2019-06-13 06:30,34,14,20,0,0,0
2019-06-13 06:45,50,19,31,0,0,0
2019-06-13 07:00,57,22,35,0,0,0
2019-06-13 07:15,121,62,59,0,0,0
2019-06-13 07:30,205,141,64,0,0,0
2019-06-13 07:45,185,62,123,0,0,0
2019-06-13 08:00,142,47,95,0,0,0
2019-06-13 08:15,122,50,72,0,0,0
2019-06-13 08:30,133,58,75,0,0,0
2019-06-13 08:45,143,86,57,0,0,0
2019-06-13 09:00,111,39,72,0,0,0
2019-06-13 09:15,99,51,48,0,0,0
2019-06-13 09:30,112,49,63,0,0,0
2019-06-13 09:45,124,59,65,0,0,0
2019-06-13 10:00,110,55,55,0,0,0
2019-06-13 10:15,74,31,43,0,0,0
2019-06-13 10:30,66,40,26,0,0,0
2019-06-13 10:45,97,56,41,0,0,0
2019-06-13 11:00,77,38,39,0,0,0
2019-06-13 11:15,79,35,44,0,0,0
2019-06-13 11:30,100,53,47,0,0,0
2019-06-13 11:45,129,71,58,0,0,0
2019-06-13 12:00,90,41,49,0,0,0
2019-06-13 12:15,116,46,70,0,0,0
2019-06-13 12:30,85,37,48,0,0,0
2019-06-13 12:45,132,72,60,0,0,0
2019-06-13 13:00,129,43,86,0,0,0
2019-06-13 13:15,117,31,86,0,0,0
2019-06-13 13:30,121,60,61,0,0,0
2019-06-13 13:45,130,54,76,0,0,0
2019-06-13 14:00,106,55,51,0,0,0
2019-06-13 14:15,113,68,45,0,0,0
2019-06-13 14:30,106,50,56,0,0,0
2019-06-13 14:45,140,70,70,0,0,0
2019-06-13 15:00,114,51,63,0,0,0
2019-06-13 15:15,125,55,70,0,0,0
2019-06-13 15:30,131,54,77,0,0,0
2019-06-13 15:45,141,71,70,0,0,0
2019-06-13 16:00,171,96,75,0,0,0
2019-06-13 16:15,127,76,51,0,0,0
2019-06-13 16:30,137,63,74,0,0,0
2019-06-13 16:45,131,61,70,0,0,0
2019-06-13 17:00,137,66,71,0,0,0
2019-06-13 17:15,136,69,67,0,0,0
2019-06-13 17:30,142,82,60,0,0,0
2019-06-13 17:45,128,57,71,0,0,0
2019-06-13 18:00,128,62,66,0,0,0
2019-06-13 18:15,122,51,71,0,0,0
2019-06-13 18:30,101,44,57,0,0,0
2019-06-13 18:45,103,52,51,0,0,0
2019-06-13 19:00,85,40,45,0,0,0
2019-06-13 19:15,92,42,50,0,0,0
2019-06-13 19:30,63,25,38,0,0,0
2019-06-13 19:45,73,29,44,0,0,0
2019-06-13 20:00,85,30,55,0,0,0
2019-06-13 20:15,53,14,39,0,0,0
2019-06-13 20:30,58,24,34,0,0,0
2019-06-13 20:45,40,17,23,0,0,0
2019-06-13 21:00,47,12,35,0,0,0
2019-06-13 21:15,38,16,22,0,0,0
2019-06-13 21:30,41,15,26,0,0,0
2019-06-13 21:45,48,11,37,0,0,0
2019-06-13 22:00,19,4,15,0,0,0
2019-06-13 22:15,50,14,36,0,0,0
2019-06-13 22:30,31,7,24,0,0,0
2019-06-13 22:45,20,7,13,0,0,0
2019-06-13 23:00,15,2,13,0,0,0
2019-06-13 23:15,17,5,12,0,0,0
2019-06-13 23:30,27,19,8,0,0,0
2019-06-13 23:45,18,2,16,0,0,0
2019-06-14 00:00,15,3,12,0,0,0
2019-06-14 00:15,9,3,6,0,0,0
2019-06-14 00:30,13,10,3,0,0,0
2019-06-14 00:45,9,4,5,0,0,0
2019-06-14 01:00,4,0,4,0,0,0
2019-06-14 01:15,2,1,1,0,0,0
2019-06-14 01:30,3,0,3,0,0,0
2019-06-14 01:45,4,0,4,0,0,0
2019-06-14 02:00,1,1,0,0,0,0
2019-06-14 02:15,1,0,1,0,0,0
2019-06-14 02:30,2,0,2,0,0,0
2019-06-14 02:45,5,1,4,0,0,0
2019-06-14 03:00,0,0,0,0,0,0
2019-06-14 03:15,1,0,1,0,0,0
2019-06-14 03:30,2,2,0,0,0,0
2019-06-14 03:45,1,1,0,0,0,0
2019-06-14 04:00,2,0,2,0,0,0
2019-06-14 04:15,2,0,2,0,0,0
2019-06-14 04:30,3,0,3,0,0,0
2019-06-14 04:45,2,1,1,0,0,0
2019-06-14 05:00,0,0,0,0,0,0
2019-06-14 05:15,6,1,5,0,0,0
2019-06-14 05:30,11,4,7,0,0,0
2019-06-14 05:45,14,7,7,0,0,0
2019-06-14 06:00,20,16,4,0,0,0
2019-06-14 06:15,25,11,14,0,0,0
2019-06-14 06:30,33,9,24,0,0,0
2019-06-14 06:45,56,26,30,0,0,0
2019-06-14 07:00,61,20,41,0,0,0
2019-06-14 07:15,118,55,63,0,0,0
2019-06-14 07:30,222,154,68,0,0,0
2019-06-14 07:45,202,95,107,0,0,0
2019-06-14 08:00,142,41,101,0,0,0
2019-06-14 08:15,120,48,72,0,0,0
2019-06-14 08:30,108,47,61,0,0,0
2019-06-14 08:45,135,68,67,0,0,0
2019-06-14 09:00,108,58,50,0,0,0
2019-06-14 09:15,76,43,33,0,0,0
2019-06-14 09:30,115,46,69,0,0,0
2019-06-14 09:45,102,52,50,0,0,0
2019-06-14 10:00,99,51,48,0,0,0
2019-06-14 10:15,86,48,38,0,0,0
2019-06-14 10:30,76,42,34,0,0,0
2019-06-14 10:45,94,50,44,0,0,0
2019-06-14 11:00,86,52,34,0,0,0
2019-06-14 11:15,92,42,50,0,0,0
2019-06-14 11:30,95,45,50,0,0,0
2019-06-14 11:45,110,58,52,0,0,0
2019-06-14 12:00,94,49,45,0,0,0
2019-06-14 12:15,130,49,81,0,0,0
2019-06-14 12:30,123,63,60,0,0,0
2019-06-14 12:45,106,48,58,0,0,0
2019-06-14 13:00,145,43,102,0,0,0
2019-06-14 13:15,153,48,105,0,0,0
2019-06-14 13:30,106,45,61,0,0,0
2019-06-14 13:45,119,60,59,0,0,0
2019-06-14 14:00,121,52,69,0,0,0
2019-06-14 14:15,125,71,54,0,0,0
2019-06-14 14:30,118,58,60,0,0,0
2019-06-14 14:45,122,62,60,0,0,0
2019-06-14 15:00,138,61,77,0,0,0
2019-06-14 15:15,132,65,67,0,0,0
2019-06-14 15:30,134,50,84,0,0,0
2019-06-14 15:45,151,91,60,0,0,0
2019-06-14 16:00,130,84,46,0,0,0
2019-06-14 16:15,116,63,53,0,0,0
2019-06-14 16:30,115,60,55,0,0,0
2019-06-14 16:45,114,66,48,0,0,0
2019-06-14 17:00,106,46,60,0,0,0
2019-06-14 17:15,119,65,54,0,0,0
2019-06-14 17:30,107,50,57,0,0,0
2019-06-14 17:45,103,48,55,0,0,0
2019-06-14 18:00,112,51,61,0,0,0
2019-06-14 18:15,106,55,51,0,0,0
2019-06-14 18:30,86,34,52,0,0,0
2019-06-14 18:45,122,56,66,0,0,0
2019-06-14 19:00,90,43,47,0,0,0
2019-06-14 19:15,69,29,40,0,0,0
2019-06-14 19:30,69,34,35,0,0,0
2019-06-14 19:45,69,33,36,0,0,0
2019-06-14 20:00,64,31,33,0,0,0
2019-06-14 20:15,75,34,41,0,0,0
2019-06-14 20:30,47,24,23,0,0,0
2019-06-14 20:45,50,27,23,0,0,0
2019-06-14 21:00,51,29,22,0,0,0
2019-06-14 21:15,34,12,22,0,0,0
2019-06-14 21:30,49,21,28,0,0,0
2019-06-14 21:45,27,6,21,0,0,0
2019-06-14 22:00,36,5,31,0,0,0
2019-06-14 22:15,30,6,24,0,0,0
2019-06-14 22:30,43,8,35,0,0,0
2019-06-14 22:45,38,16,22,0,0,0
2019-06-14 23:00,22,3,19,0,0,0
2019-06-14 23:15,31,7,24,0,0,0
2019-06-14 23:30,35,11,24,0,0,0
2019-06-14 23:45,32,11,21,0,0,0
2019-06-15 00:00,32,8,24,0,0,0
2019-06-15 00:15,26,7,19,0,0,0
2019-06-15 00:30,15,1,14,0,0,0
2019-06-15 00:45,24,9,15,0,0,0
2019-06-15 01:00,18,10,8,0,0,0
2019-06-15 01:15,24,6,18,0,0,0
2019-06-15 01:30,7,0,7,0,0,0
2019-06-15 01:45,13,0,13,0,0,0
2019-06-15 02:00,6,0,6,0,0,0
2019-06-15 02:15,7,0,7,0,0,0
2019-06-15 02:30,2,0,2,0,0,0
2019-06-15 02:45,12,1,11,0,0,0
2019-06-15 03:00,12,0,12,0,0,0
2019-06-15 03:15,4,0,4,0,0,0
2019-06-15 03:30,1,0,1,0,0,0
2019-06-15 03:45,2,0,2,0,0,0
2019-06-15 04:00,1,0,1,0,0,0
2019-06-15 04:15,4,1,3,0,0,0
2019-06-15 04:30,4,3,1,0,0,0
2019-06-15 04:45,6,2,4,0,0,0
2019-06-15 05:00,5,2,3,0,0,0
2019-06-15 05:15,1,0,1,0,0,0
2019-06-15 05:30,20,8,12,0,0,0
2019-06-15 05:45,8,4,4,0,0,0
2019-06-15 06:00,4,2,2,0,0,0
2019-06-15 06:15,5,2,3,0,0,0
2019-06-15 06:30,13,7,6,0,0,0
2019-06-15 06:45,17,10,7,0,0,0
2019-06-15 07:00,10,8,2,0,0,0
2019-06-15 07:15,21,16,5,0,0,0
2019-06-15 07:30,29,21,8,0,0,0
2019-06-15 07:45,34,26,8,0,0,0
2019-06-15 08:00,25,16,9,0,0,0
2019-06-15 08:15,46,27,19,0,0,0
2019-06-15 08:30,49,29,20,0,0,0
2019-06-15 08:45,76,50,26,0,0,0
2019-06-15 09:00,49,35,14,0,0,0
2019-06-15 09:15,65,39,26,0,0,0
2019-06-15 09:30,71,42,29,0,0,0
2019-06-15 09:45,90,68,22,0,0,0
2019-06-15 10:00,82,62,20,0,0,0
2019-06-15 10:15,92,67,25,0,0,0
2019-06-15 10:30,92,55,37,0,0,0
2019-06-15 10:45,107,71,36,0,0,0
2019-06-15 11:00,96,49,47,0,0,0
2019-06-15 11:15,85,46,39,0,0,0
2019-06-15 11:30,80,46,34,0,0,0
2019-06-15 11:45,100,47,53,0,0,0
2019-06-15 12:00,86,44,42,0,0,0
2019-06-15 12:15,74,38,36,0,0,0
2019-06-15 12:30,124,70,54,0,0,0
2019-06-15 12:45,107,54,53,0,0,0
2019-06-15 13:00,86,26,60,0,0,0
2019-06-15 13:15,87,43,44,0,0,0
2019-06-15 13:30,93,41,52,0,0,0
2019-06-15 13:45,135,57,78,0,0,0
2019-06-15 14:00,103,34,69,0,0,0
2019-06-15 14:15,106,50,56,0,0,0
2019-06-15 14:30,82,31,51,0,0,0
2019-06-15 14:45,113,36,77,0,0,0
2019-06-15 15:00,57,19,38,0,0,0
2019-06-15 15:15,93,30,63,0,0,0
2019-06-15 15:30,65,23,42,0,0,0
2019-06-15 15:45,75,22,53,0,0,0
2019-06-15 16:00,78,31,47,0,0,0
2019-06-15 16:15,58,22,36,0,0,0
2019-06-15 16:30,76,26,50,0,0,0
2019-06-15 16:45,79,32,47,0,0,0
2019-06-15 17:00,49,22,27,0,0,0
2019-06-15 17:15,57,25,32,0,0,0
2019-06-15 17:30,65,26,39,0,0,0
2019-06-15 17:45,73,30,43,0,0,0
2019-06-15 18:00,80,31,49,0,0,0
2019-06-15 18:15,70,31,39,0,0,0
2019-06-15 18:30,59,24,35,0,0,0
2019-06-15 18:45,83,42,41,0,0,0
2019-06-15 19:00,74,31,43,0,0,0
2019-06-15 19:15,40,22,18,0,0,0
2019-06-15 19:30,48,12,36,0,0,0
2019-06-15 19:45,58,19,39,0,0,0
2019-06-15 20:00,46,18,28,0,0,0
2019-06-15 20:15,46,14,32,0,0,0
2019-06-15 20:30,36,28,8,0,0,0
2019-06-15 20:45,72,27,45,0,0,0
2019-06-15 21:00,43,20,23,0,0,0
2019-06-15 21:15,47,18,29,0,0,0
2019-06-15 21:30,39,10,29,0,0,0
2019-06-15 21:45,28,8,20,0,0,0
2019-06-15 22:00,36,17,19,0,0,0
2019-06-15 22:15,27,8,19,0,0,0
2019-06-15 22:30,27,4,23,0,0,0
2019-06-15 22:45,25,6,19,0,0,0
2019-06-15 23:00,33,8,25,0,0,0
2019-06-15 23:15,16,2,14,0,0,0
2019-06-15 23:30,28,7,21,0,0,0
2019-06-15 23:45,30,16,14,0,0,0
2019-06-16 00:00,27,1,26,0,0,0
2019-06-16 00:15,21,7,14,0,0,0
2019-06-16 00:30,31,9,22,0,0,0
2019-06-16 00:45,15,5,10,0,0,0
2019-06-16 01:00,12,8,4,0,0,0
2019-06-16 01:15,29,15,14,0,0,0
2019-06-16 01:30,15,4,11,0,0,0
2019-06-16 01:45,12,2,10,0,0,0
2019-06-16 02:00,11,2,9,0,0,0
2019-06-16 02:15,5,2,3,0,0,0
2019-06-16 02:30,15,5,10,0,0,0
2019-06-16 02:45,6,3,3,0,0,0
2019-06-16 03:00,7,3,4,0,0,0
2019-06-16 03:15,6,2,4,0,0,0
2019-06-16 03:30,7,3,4,0,0,0
2019-06-16 03:45,7,0,7,0,0,0
2019-06-16 04:00,7,1,6,0,0,0
2019-06-16 04:15,7,5,2,0,0,0
2019-06-16 04:30,7,4,3,0,0,0
2019-06-16 04:45,2,1,1,0,0,0
2019-06-16 05:00,6,2,4,0,0,0
2019-06-16 05:15,2,0,2,0,0,0
2019-06-16 05:30,9,0,9,0,0,0
2019-06-16 05:45,9,5,4,0,0,0
2019-06-16 06:00,3,2,1,0,0,0
2019-06-16 06:15,2,1,1,0,0,0
2019-06-16 06:30,9,5,4,0,0,0
2019-06-16 06:45,5,1,4,0,0,0
2019-06-16 07:00,0,0,0,0,0,0
2019-06-16 07:15,2,1,1,0,0,0
2019-06-16 07:30,6,3,3,0,0,0
2019-06-16 07:45,10,5,5,0,0,0
2019-06-16 08:00,5,2,3,0,0,0
2019-06-16 08:15,12,7,5,0,0,0
2019-06-16 08:30,11,7,4,0,0,0
2019-06-16 08:45,23,13,10,0,0,0
2019-06-16 09:00,22,10,12,0,0,0
2019-06-16 09:15,28,20,8,0,0,0
2019-06-16 09:30,22,12,10,0,0,0
2019-06-16 09:45,78,61,17,0,0,0
2019-06-16 10:00,26,18,8,0,0,0
2019-06-16 10:15,26,10,16,0,0,0
2019-06-16 10:30,28,17,11,0,0,0
2019-06-16 10:45,51,41,10,0,0,0
2019-06-16 11:00,39,16,23,0,0,0
2019-06-16 11:15,36,20,16,0,0,0
2019-06-16 11:30,66,35,31,0,0,0
2019-06-16 11:45,53,31,22,0,0,0
2019-06-16 12:00,45,18,27,0,0,0
2019-06-16 12:15,63,28,35,0,0,0
2019-06-16 12:30,47,24,23,0,0,0
2019-06-16 12:45,48,19,29,0,0,0
2019-06-16 13:00,56,25,31,0,0,0
2019-06-16 13:15,40,26,14,0,0,0
2019-06-16 13:30,36,18,18,0,0,0
2019-06-16 13:45,85,46,39,0,0,0
2019-06-16 14:00,55,22,33,0,0,0
2019-06-16 14:15,59,26,33,0,0,0
2019-06-16 14:30,67,43,24,0,0,0
2019-06-16 14:45,63,39,24,0,0,0
2019-06-16 15:00,73,32,41,0,0,0
2019-06-16 15:15,57,22,35,0,0,0
2019-06-16 15:30,67,34,33,0,0,0
2019-06-16 15:45,61,25,36,0,0,0
2019-06-16 16:00,61,22,39,0,0,0
2019-06-16 16:15,44,18,26,0,0,0
2019-06-16 16:30,69,35,34,0,0,0
2019-06-16 16:45,74,20,54,0,0,0
2019-06-16 17:00,44,17,27,0,0,0
2019-06-16 17:15,85,44,41,0,0,0
2019-06-16 17:30,58,28,30,0,0,0
2019-06-16 17:45,39,8,31,0,0,0
2019-06-16 18:00,47,16,31,0,0,0
2019-06-16 18:15,40,18,22,0,0,0
2019-06-16 18:30,47,16,31,0,0,0
2019-06-16 18:45,54,25,29,0,0,0
2019-06-16 19:00,56,16,40,0,0,0
2019-06-16 19:15,39,19,20,0,0,0
2019-06-16 19:30,42,14,28,0,0,0
2019-06-16 19:45,48,16,32,0,0,0
2019-06-16 20:00,50,13,37,0,0,0
2019-06-16 20:15,38,16,22,0,0,0
2019-06-16 20:30,30,11,19,0,0,0
2019-06-16 20:45,36,17,19,0,0,0
2019-06-16 21:00,28,17,11,0,0,0
2019-06-16 21:15,25,13,12,0,0,0
2019-06-16 21:30,32,11,21,0,0,0
2019-06-16 21:45,25,7,18,0,0,0
2019-06-16 22:00,16,7,9,0,0,0
2019-06-16 22:15,19,3,16,0,0,0
2019-06-16 22:30,14,4,10,0,0,0
2019-06-16 22:45,21,3,18,0,0,0
2019-06-16 23:00,18,2,16,0,0,0
2019-06-16 23:15,9,1,8,0,0,0
2019-06-16 23:30,7,1,6,0,0,0
2019-06-16 23:45,4,3,1,0,0,0
2019-06-17 00:00,2,0,2,0,0,0
2019-06-17 00:15,5,1,4,0,0,0
2019-06-17 00:30,3,0,3,0,0,0
2019-06-17 00:45,2,1,1,0,0,0
2019-06-17 01:00,1,1,0,0,0,0
2019-06-17 01:15,3,1,2,0,0,0
2019-06-17 01:30,3,0,3,0,0,0
2019-06-17 01:45,0,0,0,0,0,0
2019-06-17 02:00,3,0,3,0,0,0
2019-06-17 02:15,0,0,0,0,0,0
2019-06-17 02:30,2,1,1,0,0,0
2019-06-17 02:45,0,0,0,0,0,0
2019-06-17 03:00,1,0,1,0,0,0
2019-06-17 03:15,0,0,0,0,0,0
2019-06-17 03:30,0,0,0,0,0,0
2019-06-17 03:45,0,0,0,0,0,0
2019-06-17 04:00,0,0,0,0,0,0
2019-06-17 04:15,0,0,0,0,0,0
2019-06-17 04:30,1,0,1,0,0,0
2019-06-17 04:45,2,1,1,0,0,0
2019-06-17 05:00,0,0,0,0,0,0
2019-06-17 05:15,2,1,1,0,0,0
2019-06-17 05:30,17,4,13,0,0,0
2019-06-17 05:45,14,3,11,0,0,0
2019-06-17 06:00,17,10,7,0,0,0
2019-06-17 06:15,27,10,17,0,0,0
2019-06-17 06:30,36,7,29,0,0,0
2019-06-17 06:45,55,26,29,0,0,0
2019-06-17 07:00,59,22,37,0,0,0
2019-06-17 07:15,133,63,70,0,0,0
2019-06-17 07:30,234,165,69,0,0,0
2019-06-17 07:45,236,87,149,0,0,0
2019-06-17 08:00,267,91,176,0,0,0
2019-06-17 08:15,159,45,114,0,0,0
2019-06-17 08:30,126,49,77,0,0,0
2019-06-17 08:45,165,69,96,0,0,0
2019-06-17 09:00,149,64,85,0,0,0
2019-06-17 09:15,99,45,54,0,0,0
2019-06-17 09:30,114,55,59,0,0,0
2019-06-17 09:45,194,75,119,0,0,0
2019-06-17 10:00,216,98,118,0,0,0
2019-06-17 10:15,101,52,49,0,0,0
2019-06-17 10:30,87,34,53,0,0,0
2019-06-17 10:45,93,44,49,0,0,0
2019-06-17 11:00,93,39,54,0,0,0
2019-06-17 11:15,105,45,60,0,0,0
2019-06-17 11:30,148,80,68,0,0,0
2019-06-17 11:45,250,119,131,0,0,0
2019-06-17 12:00,201,119,82,0,0,0
2019-06-17 12:15,141,69,72,0,0,0
2019-06-17 12:30,115,48,67,0,0,0
2019-06-17 12:45,152,78,74,0,0,0
2019-06-17 13:00,200,80,120,0,0,0
2019-06-17 13:15,125,31,94,0,0,0
2019-06-17 13:30,154,58,96,0,0,0
2019-06-17 13:45,251,116,135,0,0,0
2019-06-17 14:00,231,98,133,0,0,0
2019-06-17 14:15,137,70,67,0,0,0
2019-06-17 14:30,127,59,68,0,0,0
2019-06-17 14:45,129,62,67,0,0,0
2019-06-17 15:00,134,65,69,0,0,0
2019-06-17 15:15,127,66,61,0,0,0
2019-06-17 15:30,179,86,93,0,0,0
2019-06-17 15:45,297,155,142,0,0,0
2019-06-17 16:00,250,146,104,0,0,0
2019-06-17 16:15,177,102,75,0,0,0
2019-06-17 16:30,126,75,51,0,0,0
2019-06-17 16:45,162,89,73,0,0,0
2019-06-17 17:00,168,88,80,0,0,0
2019-06-17 17:15,148,63,85,0,0,0
2019-06-17 17:30,184,73,111,0,0,0
2019-06-17 17:45,243,121,122,0,0,0
2019-06-17 18:00,186,85,101,0,0,0
2019-06-17 18:15,118,53,65,0,0,0
2019-06-17 18:30,134,60,74,0,0,0
2019-06-17 18:45,134,55,79,0,0,0
2019-06-17 19:00,106,35,71,0,0,0
2019-06-17 19:15,85,30,55,0,0,0
2019-06-17 19:30,90,42,48,0,0,0
2019-06-17 19:45,124,51,73,0,0,0
2019-06-17 20:00,101,32,69,0,0,0
2019-06-17 20:15,72,22,50,0,0,0
2019-06-17 20:30,54,18,36,0,0,0
2019-06-17 20:45,53,22,31,0,0,0
2019-06-17 21:00,63,28,35,0,0,0
2019-06-17 21:15,50,27,23,0,0,0
2019-06-17 21:30,46,23,23,0,0,0
2019-06-17 21:45,39,13,26,0,0,0
2019-06-17 22:00,46,21,25,0,0,0
2019-06-17 22:15,40,16,24,0,0,0
2019-06-17 22:30,25,9,16,0,0,0
2019-06-17 22:45,34,8,26,0,0,0
2019-06-17 23:00,30,11,19,0,0,0
2019-06-17 23:15,25,6,19,0,0,0
2019-06-17 23:30,14,3,11,0,0,0
2019-06-17 23:45,8,1,7,0,0,0
2019-06-18 00:00,12,4,8,0,0,0
2019-06-18 00:15,16,2,14,0,0,0
2019-06-18 00:30,18,4,14,0,0,0
2019-06-18 00:45,11,2,9,0,0,0
2019-06-18 01:00,6,1,5,0,0,0
2019-06-18 01:15,7,2,5,0,0,0
2019-06-18 01:30,9,3,6,0,0,0
2019-06-18 01:45,0,0,0,0,0,0
2019-06-18 02:00,1,1,0,0,0,0
2019-06-18 02:15,1,0,1,0,0,0
2019-06-18 02:30,1,0,1,0,0,0
2019-06-18 02:45,0,0,0,0,0,0
2019-06-18 03:00,0,0,0,0,0,0
2019-06-18 03:15,2,1,1,0,0,0
2019-06-18 03:30,0,0,0,0,0,0
2019-06-18 03:45,0,0,0,0,0,0
2019-06-18 04:00,0,0,0,0,0,0
2019-06-18 04:15,1,1,0,0,0,0
2019-06-18 04:30,2,0,2,0,0,0
2019-06-18 04:45,3,1,2,0,0,0
2019-06-18 05:00,2,0,2,0,0,0
2019-06-18 05:15,3,3,0,0,0,0
2019-06-18 05:30,18,4,14,0,0,0
2019-06-18 05:45,13,6,7,0,0,0
2019-06-18 06:00,21,12,9,0,0,0
2019-06-18 06:15,35,19,16,0,0,0
2019-06-18 06:30,37,12,25,0,0,0
2019-06-18 06:45,61,24,37,0,0,0
2019-06-18 07:00,78,22,56,0,0,0
2019-06-18 07:15,125,58,67,0,0,0
2019-06-18 07:30,225,154,71,0,0,0
2019-06-18 07:45,272,109,163,0,0,0
2019-06-18 08:00,330,107,223,0,0,0
2019-06-18 08:15,193,63,130,0,0,0
2019-06-18 08:30,147,65,82,0,0,0
2019-06-18 08:45,165,77,88,0,0,0
2019-06-18 09:00,179,76,103,0,0,0
2019-06-18 09:15,119,58,61,0,0,0
2019-06-18 09:30,149,52,97,0,0,0
2019-06-18 09:45,253,105,148,0,0,0
2019-06-18 10:00,300,106,194,0,0,0
2019-06-18 10:15,120,58,62,0,0,0
2019-06-18 10:30,98,52,46,0,0,0
2019-06-18 10:45,113,60,53,0,0,0
2019-06-18 11:00,125,51,74,0,0,0
2019-06-18 11:15,112,55,57,0,0,0
2019-06-18 11:30,111,52,59,0,0,0
2019-06-18 11:45,271,149,122,0,0,0
2019-06-18 12:00,242,127,115,0,0,0
2019-06-18 12:15,158,75,83,0,0,0
2019-06-18 12:30,140,57,83,0,0,0
2019-06-18 12:45,169,74,95,0,0,0
2019-06-18 13:00,198,74,124,0,0,0
2019-06-18 13:15,175,53,122,0,0,0
2019-06-18 13:30,144,61,83,0,0,0
2019-06-18 13:45,279,118,161,0,0,0
2019-06-18 14:00,241,96,145,0,0,0
2019-06-18 14:15,157,70,87,0,0,0
2019-06-18 14:30,154,79,75,0,0,0
2019-06-18 14:45,158,90,68,0,0,0
2019-06-18 15:00,132,58,74,0,0,0
2019-06-18 15:15,172,92,80,0,0,0
2019-06-18 15:30,197,105,92,0,0,0
2019-06-18 15:45,296,175,121,0,0,0
2019-06-18 16:00,226,127,99,0,0,0
2019-06-18 16:15,176,103,73,0,0,0
2019-06-18 16:30,196,108,88,0,0,0
2019-06-18 16:45,187,95,92,0,0,0
2019-06-18 17:00,167,97,70,0,0,0
2019-06-18 17:15,152,76,76,0,0,0
2019-06-18 17:30,222,132,90,0,0,0
2019-06-18 17:45,254,115,139,0,0,0
2019-06-18 18:00,174,88,86,0,0,0
2019-06-18 18:15,133,51,82,0,0,0
2019-06-18 18:30,121,56,65,0,0,0
2019-06-18 18:45,138,62,76,0,0,0
2019-06-18 19:00,131,62,69,0,0,0
2019-06-18 19:15,133,68,65,0,0,0
2019-06-18 19:30,97,47,50,0,0,0
2019-06-18 19:45,118,48,70,0,0,0
2019-06-18 20:00,110,47,63,0,0,0
2019-06-18 20:15,81,23,58,0,0,0
2019-06-18 20:30,51,23,28,0,0,0
2019-06-18 20:45,58,20,38,0,0,0
2019-06-18 21:00,57,21,36,0,0,0
2019-06-18 21:15,55,21,34,0,0,0
2019-06-18 21:30,51,11,40,0,0,0
2019-06-18 21:45,64,12,52,0,0,0
2019-06-18 22:00,74,23,51,0,0,0
2019-06-18 22:15,61,33,28,0,0,0
2019-06-18 22:30,51,9,42,0,0,0
2019-06-18 22:45,29,4,25,0,0,0
2019-06-18 23:00,31,2,29,0,0,0
2019-06-18 23:15,23,2,21,0,0,0
2019-06-18 23:30,17,7,10,0,0,0
2019-06-18 23:45,20,5,15,0,0,0
2019-06-19 00:00,11,4,7,0,0,0
2019-06-19 00:15,11,2,9,0,0,0
2019-06-19 00:30,10,2,8,0,0,0
2019-06-19 00:45,12,1,11,0,0,0
2019-06-19 01:00,10,5,5,0,0,0
2019-06-19 01:15,4,0,4,0,0,0
2019-06-19 01:30,6,1,5,0,0,0
2019-06-19 01:45,5,0,5,0,0,0
2019-06-19 02:00,0,0,0,0,0,0
2019-06-19 02:15,2,1,1,0,0,0
2019-06-19 02:30,0,0,0,0,0,0
2019-06-19 02:45,11,7,4,0,0,0
2019-06-19 03:00,1,1,0,0,0,0
2019-06-19 03:15,0,0,0,0,0,0
2019-06-19 03:30,1,0,1,0,0,0
2019-06-19 03:45,0,0,0,0,0,0
2019-06-19 04:00,2,0,2,0,0,0
2019-06-19 04:15,3,3,0,0,0,0
2019-06-19 04:30,1,0,1,0,0,0
2019-06-19 04:45,1,0,1,0,0,0
2019-06-19 05:00,5,4,1,0,0,0
2019-06-19 05:15,8,6,2,0,0,0
2019-06-19 05:30,25,9,16,0,0,0
2019-06-19 05:45,9,6,3,0,0,0
2019-06-19 06:00,12,7,5,0,0,0
2019-06-19 06:15,23,14,9,0,0,0
2019-06-19 06:30,34,8,26,0,0,0
2019-06-19 06:45,73,32,41,0,0,0
2019-06-19 07:00,89,31,58,0,0,0
2019-06-19 07:15,136,81,55,0,0,0
2019-06-19 07:30,247,178,69,0,0,0
2019-06-19 07:45,310,129,181,0,0,0
2019-06-19 08:00,325,82,243,0,0,0
2019-06-19 08:15,203,93,110,0,0,0
2019-06-19 08:30,159,61,98,0,0,0
2019-06-19 08:45,165,77,88,0,0,0
2019-06-19 09:00,167,68,99,0,0,0
2019-06-19 09:15,132,71,61,0,0,0
2019-06-19 09:30,137,61,76,0,0,0
2019-06-19 09:45,257,131,126,0,0,0
2019-06-19 10:00,274,110,164,0,0,0
2019-06-19 10:15,120,55,65,0,0,0
2019-06-19 10:30,95,50,45,0,0,0
2019-06-19 10:45,116,51,65,0,0,0
2019-06-19 11:00,131,65,66,0,0,0
2019-06-19 11:15,158,75,83,0,0,0
2019-06-19 11:30,162,80,82,0,0,0
2019-06-19 11:45,228,122,106,0,0,0
2019-06-19 12:00,233,107,126,0,0,0
2019-06-19 12:15,194,78,116,0,0,0
2019-06-19 12:30,164,68,96,0,0,0
2019-06-19 12:45,166,71,95,0,0,0
2019-06-19 13:00,181,78,103,0,0,0
2019-06-19 13:15,165,54,111,0,0,0
2019-06-19 13:30,157,64,93,0,0,0
2019-06-19 13:45,245,95,150,0,0,0
2019-06-19 14:00,225,96,129,0,0,0
2019-06-19 14:15,152,81,71,0,0,0
2019-06-19 14:30,134,76,58,0,0,0
2019-06-19 14:45,101,43,58,0,0,0
2019-06-19 15:00,117,49,68,0,0,0
2019-06-19 15:15,133,69,64,0,0,0
2019-06-19 15:30,192,72,120,0,0,0
2019-06-19 15:45,263,136,127,0,0,0
2019-06-19 16:00,211,91,120,0,0,0
2019-06-19 16:15,94,51,43,0,0,0
2019-06-19 16:30,150,82,68,0,0,0
2019-06-19 16:45,161,98,63,0,0,0
2019-06-19 17:00,152,81,71,0,0,0
2019-06-19 17:15,128,72,56,0,0,0
2019-06-19 17:30,146,88,58,0,0,0
2019-06-19 17:45,163,87,76,0,0,0
2019-06-19 18:00,151,72,79,0,0,0
2019-06-19 18:15,127,60,67,0,0,0
2019-06-19 18:30,103,56,47,0,0,0
2019-06-19 18:45,126,56,70,0,0,0
2019-06-19 19:00,97,52,45,0,0,0
2019-06-19 19:15,104,55,49,0,0,0
2019-06-19 19:30,117,55,62,0,0,0
2019-06-19 19:45,139,73,66,0,0,0
2019-06-19 20:00,86,19,67,0,0,0
2019-06-19 20:15,63,21,42,0,0,0
2019-06-19 20:30,56,19,37,0,0,0
2019-06-19 20:45,64,23,41,0,0,0
2019-06-19 21:00,30,12,18,0,0,0
2019-06-19 21:15,39,11,28,0,0,0
2019-06-19 21:30,34,7,27,0,0,0
2019-06-19 21:45,42,15,27,0,0,0
2019-06-19 22:00,43,17,26,0,0,0
2019-06-19 22:15,40,19,21,0,0,0
2019-06-19 22:30,29,17,12,0,0,0
2019-06-19 22:45,30,10,20,0,0,0
2019-06-19 23:00,16,5,11,0,0,0
2019-06-19 23:15,32,17,15,0,0,0
2019-06-19 23:30,15,10,5,0,0,0
2019-06-19 23:45,23,10,13,0,0,0
2019-06-20 00:00,22,5,17,0,0,0
2019-06-20 00:15,19,5,14,0,0,0
2019-06-20 00:30,21,11,10,0,0,0
2019-06-20 00:45,15,2,13,0,0,0
2019-06-20 01:00,20,8,12,0,0,0
2019-06-20 01:15,17,6,11,0,0,0
2019-06-20 01:30,12,6,6,0,0,0
2019-06-20 01:45,10,4,6,0,0,0
2019-06-20 02:00,9,1,8,0,0,0
2019-06-20 02:15,9,5,4,0,0,0
2019-06-20 02:30,7,1,6,0,0,0
2019-06-20 02:45,20,7,13,0,0,0
2019-06-20 03:00,14,3,11,0,0,0
2019-06-20 03:15,28,6,22,0,0,0
2019-06-20 03:30,6,2,4,0,0,0
2019-06-20 03:45,7,0,7,0,0,0
2019-06-20 04:00,13,2,11,0,0,0
2019-06-20 04:15,4,0,4,0,0,0
2019-06-20 04:30,24,1,23,0,0,0
2019-06-20 04:45,6,1,5,0,0,0
2019-06-20 05:00,7,1,6,0,0,0
2019-06-20 05:15,9,1,8,0,0,0
2019-06-20 05:30,9,0,9,0,0,0
2019-06-20 05:45,7,1,6,0,0,0
2019-06-20 06:00,7,4,3,0,0,0
2019-06-20 06:15,6,5,1,0,0,0
2019-06-20 06:30,5,3,2,0,0,0
2019-06-20 06:45,13,6,7,0,0,0
2019-06-20 07:00,5,3,2,0,0,0
2019-06-20 07:15,9,3,6,0,0,0
2019-06-20 07:30,8,3,5,0,0,0
2019-06-20 07:45,16,8,8,0,0,0
2019-06-20 08:00,21,14,7,0,0,0
2019-06-20 08:15,9,5,4,0,0,0
2019-06-20 08:30,16,9,7,0,0,0
2019-06-20 08:45,27,14,13,0,0,0
2019-06-20 09:00,18,13,5,0,0,0
2019-06-20 09:15,48,38,10,0,0,0
2019-06-20 09:30,35,26,9,0,0,0
2019-06-20 09:45,45,28,17,0,0,0
2019-06-20 10:00,31,19,12,0,0,0
2019-06-20 10:15,32,20,12,0,0,0
2019-06-20 10:30,25,14,11,0,0,0
2019-06-20 10:45,32,18,14,0,0,0
2019-06-20 11:00,35,16,19,0,0,0
2019-06-20 11:15,23,10,13,0,0,0
2019-06-20 11:30,23,7,16,0,0,0
2019-06-20 11:45,53,20,33,0,0,0
2019-06-20 12:00,71,22,49,0,0,0
2019-06-20 12:15,45,23,22,0,0,0
2019-06-20 12:30,64,26,38,0,0,0
2019-06-20 12:45,52,31,21,0,0,0
2019-06-20 13:00,72,23,49,0,0,0
2019-06-20 13:15,45,21,24,0,0,0
2019-06-20 13:30,25,14,11,0,0,0
2019-06-20 13:45,62,31,31,0,0,0
2019-06-20 14:00,57,35,22,0,0,0
2019-06-20 14:15,69,40,29,0,0,0
2019-06-20 14:30,57,25,32,0,0,0
2019-06-20 14:45,58,35,23,0,0,0
2019-06-20 15:00,46,17,29,0,0,0
2019-06-20 15:15,74,34,40,0,0,0
2019-06-20 15:30,70,22,48,0,0,0
2019-06-20 15:45,57,20,37,0,0,0
2019-06-20 16:00,49,21,28,0,0,0
2019-06-20 16:15,34,11,23,0,0,0
2019-06-20 16:30,57,25,32,0,0,0
2019-06-20 16:45,47,19,28,0,0,0
2019-06-20 17:00,47,18,29,0,0,0
2019-06-20 17:15,67,34,33,0,0,0
2019-06-20 17:30,50,29,21,0,0,0
2019-06-20 17:45,75,25,50,0,0,0
2019-06-20 18:00,59,35,24,0,0,0
2019-06-20 18:15,53,20,33,0,0,0
2019-06-20 18:30,38,16,22,0,0,0
2019-06-20 18:45,43,13,30,0,0,0
2019-06-20 19:00,54,19,35,0,0,0
2019-06-20 19:15,43,19,24,0,0,0
2019-06-20 19:30,56,25,31,0,0,0
2019-06-20 19:45,45,17,28,0,0,0
2019-06-20 20:00,24,5,19,0,0,0
2019-06-20 20:15,50,21,29,0,0,0
2019-06-20 20:30,49,13,36,0,0,0
2019-06-20 20:45,34,13,21,0,0,0
2019-06-20 21:00,26,8,18,0,0,0
2019-06-20 21:15,33,11,22,0,0,0
2019-06-20 21:30,16,3,13,0,0,0
2019-06-20 21:45,28,11,17,0,0,0
2019-06-20 22:00,16,1,15,0,0,0
2019-06-20 22:15,17,9,8,0,0,0
2019-06-20 22:30,17,1,16,0,0,0
2019-06-20 22:45,15,5,10,0,0,0
2019-06-20 23:00,11,4,7,0,0,0
2019-06-20 23:15,18,4,14,0,0,0
2019-06-20 23:30,9,2,7,0,0,0
2019-06-20 23:45,13,2,11,0,0,0
2019-06-21 00:00,16,5,11,0,0,0
2019-06-21 00:15,10,3,7,0,0,0
2019-06-21 00:30,11,2,9,0,0,0
2019-06-21 00:45,8,5,3,0,0,0
2019-06-21 01:00,8,3,5,0,0,0
2019-06-21 01:15,8,1,7,0,0,0
2019-06-21 01:30,4,1,3,0,0,0
2019-06-21 01:45,2,0,2,0,0,0
2019-06-21 02:00,2,1,1,0,0,0
2019-06-21 02:15,0,0,0,0,0,0
2019-06-21 02:30,0,0,0,0,0,0
2019-06-21 02:45,0,0,0,0,0,0
2019-06-21 03:00,1,0,1,0,0,0
2019-06-21 03:15,2,0,2,0,0,0
2019-06-21 03:30,3,1,2,0,0,0
2019-06-21 03:45,1,0,1,0,0,0
2019-06-21 04:00,1,0,1,0,0,0
2019-06-21 04:15,0,0,0,0,0,0
2019-06-21 04:30,2,0,2,0,0,0
2019-06-21 04:45,3,2,1,0,0,0
2019-06-21 05:00,0,0,0,0,0,0
2019-06-21 05:15,5,5,0,0,0,0
2019-06-21 05:30,12,2,10,0,0,0
2019-06-21 05:45,17,4,13,0,0,0
2019-06-21 06:00,7,2,5,0,0,0
2019-06-21 06:15,17,8,9,0,0,0
2019-06-21 06:30,21,9,12,0,0,0
2019-06-21 06:45,41,14,27,0,0,0
2019-06-21 07:00,54,25,29,0,0,0
2019-06-21 07:15,76,21,55,0,0,0
2019-06-21 07:30,120,53,67,0,0,0
2019-06-21 07:45,162,53,109,0,0,0
2019-06-21 08:00,172,58,114,0,0,0
2019-06-21 08:15,106,46,60,0,0,0
2019-06-21 08:30,92,47,45,0,0,0
2019-06-21 08:45,109,55,54,0,0,0
2019-06-21 09:00,94,47,47,0,0,0
2019-06-21 09:15,86,51,35,0,0,0
2019-06-21 09:30,93,44,49,0,0,0
2019-06-21 09:45,201,72,129,0,0,0
2019-06-21 10:00,192,88,104,0,0,0
2019-06-21 10:15,115,61,54,0,0,0
2019-06-21 10:30,77,44,33,0,0,0
2019-06-21 10:45,81,43,38,0,0,0
2019-06-21 11:00,105,53,52,0,0,0
2019-06-21 11:15,105,49,56,0,0,0
2019-06-21 11:30,114,71,43,0,0,0
2019-06-21 11:45,141,84,57,0,0,0
2019-06-21 12:00,168,85,83,0,0,0
2019-06-21 12:15,120,56,64,0,0,0
2019-06-21 12:30,152,78,74,0,0,0
2019-06-21 12:45,134,81,53,0,0,0
2019-06-21 13:00,138,62,76,0,0,0
2019-06-21 13:15,119,51,68,0,0,0
2019-06-21 13:30,141,48,93,0,0,0
2019-06-21 13:45,150,90,60,0,0,0
2019-06-21 14:00,161,54,107,0,0,0
2019-06-21 14:15,126,70,56,0,0,0
2019-06-21 14:30,148,75,73,0,0,0
2019-06-21 14:45,149,70,79,0,0,0
2019-06-21 15:00,121,67,54,0,0,0
2019-06-21 15:15,125,68,57,0,0,0
2019-06-21 15:30,130,56,74,0,0,0
2019-06-21 15:45,142,72,70,0,0,0
2019-06-21 16:00,154,84,70,0,0,0
2019-06-21 16:15,136,76,60,0,0,0
2019-06-21 16:30,161,67,94,0,0,0
2019-06-21 16:45,137,86,51,0,0,0
2019-06-21 17:00,110,58,52,0,0,0
2019-06-21 17:15,142,78,64,0,0,0
2019-06-21 17:30,111,60,51,0,0,0
2019-06-21 17:45,137,76,61,0,0,0
2019-06-21 18:00,104,39,65,0,0,0
2019-06-21 18:15,109,40,69,0,0,0
2019-06-21 18:30,121,52,69,0,0,0
2019-06-21 18:45,95,49,46,0,0,0
2019-06-21 19:00,81,39,42,0,0,0
2019-06-21 19:15,92,44,48,0,0,0
2019-06-21 19:30,88,38,50,0,0,0
2019-06-21 19:45,92,33,59,0,0,0
2019-06-21 20:00,77,41,36,0,0,0
2019-06-21 20:15,80,32,48,0,0,0
2019-06-21 20:30,69,30,39,0,0,0
2019-06-21 20:45,43,19,24,0,0,0
2019-06-21 21:00,42,14,28,0,0,0
2019-06-21 21:15,48,12,36,0,0,0
2019-06-21 21:30,50,14,36,0,0,0
2019-06-21 21:45,57,24,33,0,0,0
2019-06-21 22:00,43,9,34,0,0,0
2019-06-21 22:15,37,9,28,0,0,0
2019-06-21 22:30,57,14,43,0,0,0
2019-06-21 22:45,41,15,26,0,0,0
2019-06-21 23:00,32,5,27,0,0,0
2019-06-21 23:15,22,5,17,0,0,0
2019-06-21 23:30,26,5,21,0,0,0
2019-06-21 23:45,19,3,16,0,0,0
2019-06-22 00:00,37,12,25,0,0,0
2019-06-22 00:15,18,1,17,0,0,0
2019-06-22 00:30,16,4,12,0,0,0
2019-06-22 00:45,16,3,13,0,0,0
2019-06-22 01:00,14,1,13,0,0,0
2019-06-22 01:15,12,6,6,0,0,0
2019-06-22 01:30,9,5,4,0,0,0
2019-06-22 01:45,13,0,13,0,0,0
2019-06-22 02:00,6,1,5,0,0,0
2019-06-22 02:15,4,0,4,0,0,0
2019-06-22 02:30,9,0,9,0,0,0
2019-06-22 02:45,9,1,8,0,0,0
2019-06-22 03:00,2,0,2,0,0,0
2019-06-22 03:15,6,0,6,0,0,0
2019-06-22 03:30,3,2,1,0,0,0
2019-06-22 03:45,6,0,6,0,0,0
2019-06-22 04:00,2,0,2,0,0,0
2019-06-22 04:15,0,0,0,0,0,0
2019-06-22 04:30,2,0,2,0,0,0
2019-06-22 04:45,3,1,2,0,0,0
2019-06-22 05:00,3,1,2,0,0,0
2019-06-22 05:15,4,0,4,0,0,0
2019-06-22 05:30,12,3,9,0,0,0
2019-06-22 05:45,11,5,6,0,0,0
2019-06-22 06:00,1,1,0,0,0,0
2019-06-22 06:15,9,6,3,0,0,0
2019-06-22 06:30,7,5,2,0,0,0
2019-06-22 06:45,13,8,5,0,0,0
2019-06-22 07:00,20,15,5,0,0,0
2019-06-22 07:15,19,14,5,0,0,0
2019-06-22 07:30,30,18,12,0,0,0
2019-06-22 07:45,52,28,24,0,0,0
2019-06-22 08:00,35,9,26,0,0,0
2019-06-22 08:15,52,22,30,0,0,0
2019-06-22 08:30,50,33,17,0,0,0
2019-06-22 08:45,50,32,18,0,0,0
2019-06-22 09:00,39,24,15,0,0,0
2019-06-22 09:15,71,48,23,0,0,0
2019-06-22 09:30,72,52,20,0,0,0
2019-06-22 09:45,101,73,28,0,0,0
2019-06-22 10:00,72,47,25,0,0,0
2019-06-22 10:15,64,49,15,0,0,0
2019-06-22 10:30,68,48,20,0,0,0
2019-06-22 10:45,120,85,35,0,0,0
2019-06-22 11:00,91,53,38,0,0,0
2019-06-22 11:15,91,60,31,0,0,0
2019-06-22 11:30,99,62,37,0,0,0
2019-06-22 11:45,99,52,47,0,0,0
2019-06-22 12:00,77,44,33,0,0,0
2019-06-22 12:15,112,55,57,0,0,0
2019-06-22 12:30,147,74,73,0,0,0
2019-06-22 12:45,95,48,47,0,0,0
2019-06-22 13:00,93,46,47,0,0,0
2019-06-22 13:15,107,51,56,0,0,0
2019-06-22 13:30,120,56,64,0,0,0
2019-06-22 13:45,140,67,73,0,0,0
2019-06-22 14:00,104,42,62,0,0,0
2019-06-22 14:15,111,54,57,0,0,0
2019-06-22 14:30,118,47,71,0,0,0
2019-06-22 14:45,93,51,42,0,0,0
2019-06-22 15:00,97,64,33,0,0,0
2019-06-22 15:15,92,43,49,0,0,0
2019-06-22 15:30,79,32,47,0,0,0
2019-06-22 15:45,108,50,58,0,0,0
2019-06-22 16:00,111,46,65,0,0,0
2019-06-22 16:15,103,37,66,0,0,0
2019-06-22 16:30,73,35,38,0,0,0
2019-06-22 16:45,94,47,47,0,0,0
2019-06-22 17:00,133,55,78,0,0,0
2019-06-22 17:15,88,26,62,0,0,0
2019-06-22 17:30,110,36,74,0,0,0
2019-06-22 17:45,119,33,86,0,0,0
2019-06-22 18:00,105,21,84,0,0,0
2019-06-22 18:15,100,39,61,0,0,0
2019-06-22 18:30,85,23,62,0,0,0
2019-06-22 18:45,96,38,58,0,0,0
2019-06-22 19:00,85,34,51,0,0,0
2019-06-22 19:15,63,18,45,0,0,0
2019-06-22 19:30,56,21,35,0,0,0
2019-06-22 19:45,78,38,40,0,0,0
2019-06-22 20:00,82,29,53,0,0,0
2019-06-22 20:15,56,23,33,0,0,0
2019-06-22 20:30,54,28,26,0,0,0
2019-06-22 20:45,41,18,23,0,0,0
2019-06-22 21:00,29,12,17,0,0,0
2019-06-22 21:15,61,23,38,0,0,0
2019-06-22 21:30,48,22,26,0,0,0
2019-06-22 21:45,51,12,39,0,0,0
2019-06-22 22:00,42,30,12,0,0,0
2019-06-22 22:15,40,15,25,0,0,0
2019-06-22 22:30,38,19,19,0,0,0
2019-06-22 22:45,37,7,30,0,0,0
2019-06-22 23:00,38,4,34,0,0,0
2019-06-22 23:15,36,3,33,0,0,0
2019-06-22 23:30,53,10,43,0,0,0
2019-06-22 23:45,54,6,48,0,0,0
2019-06-23 00:00,26,4,22,0,0,0
2019-06-23 00:15,24,7,17,0,0,0
2019-06-23 00:30,21,4,17,0,0,0
2019-06-23 00:45,25,4,21,0,0,0
2019-06-23 01:00,31,6,25,0,0,0
2019-06-23 01:15,14,2,12,0,0,0
2019-06-23 01:30,10,1,9,0,0,0
2019-06-23 01:45,16,6,10,0,0,0
2019-06-23 02:00,11,3,8,0,0,0
2019-06-23 02:15,16,5,11,0,0,0
2019-06-23 02:30,13,5,8,0,0,0
2019-06-23 02:45,5,3,2,0,0,0
2019-06-23 03:00,2,1,1,0,0,0
2019-06-23 03:15,4,1,3,0,0,0
2019-06-23 03:30,2,0,2,0,0,0
2019-06-23 03:45,6,0,6,0,0,0
2019-06-23 04:00,6,1,5,0,0,0
2019-06-23 04:15,5,0,5,0,0,0
2019-06-23 04:30,6,0,6,0,0,0
2019-06-23 04:45,1,1,0,0,0,0
2019-06-23 05:00,1,0,1,0,0,0
2019-06-23 05:15,3,1,2,0,0,0
2019-06-23 05:30,8,1,7,0,0,0
2019-06-23 05:45,4,0,4,0,0,0
2019-06-23 06:00,1,0,1,0,0,0
2019-06-23 06:15,2,0,2,0,0,0
2019-06-23 06:30,13,5,8,0,0,0
2019-06-23 06:45,6,3,3,0,0,0
2019-06-23 07:00,3,1,2,0,0,0
2019-06-23 07:15,3,3,0,0,0,0
2019-06-23 07:30,14,4,10,0,0,0
2019-06-23 07:45,10,6,4,0,0,0
2019-06-23 08:00,10,1,9,0,0,0
2019-06-23 08:15,15,8,7,0,0,0
2019-06-23 08:30,24,8,16,0,0,0
2019-06-23 08:45,18,13,5,0,0,0
2019-06-23 09:00,21,13,8,0,0,0
2019-06-23 09:15,24,13,11,0,0,0
2019-06-23 09:30,23,17,6,0,0,0
2019-06-23 09:45,36,20,16,0,0,0
2019-06-23 10:00,47,36,11,0,0,0
2019-06-23 10:15,50,25,25,0,0,0
2019-06-23 10:30,32,20,12,0,0,0
2019-06-23 10:45,45,27,18,0,0,0
2019-06-23 11:00,39,30,9,0,0,0
2019-06-23 11:15,52,26,26,0,0,0
2019-06-23 11:30,73,22,51,0,0,0
2019-06-23 11:45,51,16,35,0,0,0
2019-06-23 12:00,41,19,22,0,0,0
2019-06-23 12:15,54,10,44,0,0,0
2019-06-23 12:30,73,38,35,0,0,0
2019-06-23 12:45,73,35,38,0,0,0
2019-06-23 13:00,57,26,31,0,0,0
2019-06-23 13:15,54,19,35,0,0,0
2019-06-23 13:30,57,20,37,0,0,0
2019-06-23 13:45,90,48,42,0,0,0
2019-06-23 14:00,49,19,30,0,0,0
2019-06-23 14:15,58,21,37,0,0,0
2019-06-23 14:30,58,22,36,0,0,0
2019-06-23 14:45,71,35,36,0,0,0
2019-06-23 15:00,72,30,42,0,0,0
2019-06-23 15:15,57,30,27,0,0,0
2019-06-23 15:30,76,39,37,0,0,0
2019-06-23 15:45,65,19,46,0,0,0
2019-06-23 16:00,49,23,26,0,0,0
2019-06-23 16:15,73,35,38,0,0,0
2019-06-23 16:30,68,24,44,0,0,0
2019-06-23 16:45,79,32,47,0,0,0
2019-06-23 17:00,63,26,37,0,0,0
2019-06-23 17:15,71,13,58,0,0,0
2019-06-23 17:30,53,27,26,0,0,0
2019-06-23 17:45,61,17,44,0,0,0
2019-06-23 18:00,68,23,45,0,0,0
2019-06-23 18:15,53,27,26,0,0,0
2019-06-23 18:30,42,13,29,0,0,0
2019-06-23 18:45,56,25,31,0,0,0
2019-06-23 19:00,34,13,21,0,0,0
2019-06-23 19:15,44,10,34,0,0,0
2019-06-23 19:30,47,12,35,0,0,0
2019-06-23 19:45,52,23,29,0,0,0
2019-06-23 20:00,49,13,36,0,0,0
2019-06-23 20:15,39,7,32,0,0,0
2019-06-23 20:30,50,18,32,0,0,0
2019-06-23 20:45,41,17,24,0,0,0
2019-06-23 21:00,27,6,21,0,0,0
2019-06-23 21:15,24,11,13,0,0,0
2019-06-23 21:30,38,12,26,0,0,0
2019-06-23 21:45,30,15,15,0,0,0
2019-06-23 22:00,38,11,27,0,0,0
2019-06-23 22:15,23,2,21,0,0,0
2019-06-23 22:30,11,2,9,0,0,0
2019-06-23 22:45,10,1,9,0,0,0
2019-06-23 23:00,18,2,16,0,0,0
2019-06-23 23:15,12,1,11,0,0,0
2019-06-23 23:30,9,2,7,0,0,0
2019-06-23 23:45,6,3,3,0,0,0
2019-06-24 00:00,7,3,4,0,0,0
2019-06-24 00:15,2,0,2,0,0,0
2019-06-24 00:30,4,0,4,0,0,0
2019-06-24 00:45,4,1,3,0,0,0
2019-06-24 01:00,3,0,3,0,0,0
2019-06-24 01:15,4,3,1,0,0,0
2019-06-24 01:30,2,0,2,0,0,0
2019-06-24 01:45,0,0,0,0,0,0
2019-06-24 02:00,1,0,1,0,0,0
2019-06-24 02:15,1,0,1,0,0,0
2019-06-24 02:30,1,1,0,0,0,0
2019-06-24 02:45,0,0,0,0,0,0
2019-06-24 03:00,0,0,0,0,0,0
2019-06-24 03:15,1,0,1,0,0,0
2019-06-24 03:30,0,0,0,0,0,0
2019-06-24 03:45,0,0,0,0,0,0
2019-06-24 04:00,1,0,1,0,0,0
2019-06-24 04:15,3,0,3,0,0,0
2019-06-24 04:30,2,1,1,0,0,0
2019-06-24 04:45,3,1,2,0,0,0
2019-06-24 05:00,2,2,0,0,0,0
2019-06-24 05:15,2,0,2,0,0,0
2019-06-24 05:30,16,6,10,0,0,0
2019-06-24 05:45,20,11,9,0,0,0
2019-06-24 06:00,13,6,7,0,0,0
2019-06-24 06:15,33,9,24,0,0,0
2019-06-24 06:30,41,8,33,0,0,0
2019-06-24 06:45,57,21,36,0,0,0
2019-06-24 07:00,65,30,35,0,0,0
2019-06-24 07:15,125,60,65,0,0,0
2019-06-24 07:30,150,62,88,0,0,0
2019-06-24 07:45,204,80,124,0,0,0
2019-06-24 08:00,259,73,186,0,0,0
2019-06-24 08:15,172,71,101,0,0,0
2019-06-24 08:30,126,43,83,0,0,0
2019-06-24 08:45,184,86,98,0,0,0
2019-06-24 09:00,156,70,86,0,0,0
2019-06-24 09:15,86,43,43,0,0,0
2019-06-24 09:30,111,46,65,0,0,0
2019-06-24 09:45,208,76,132,0,0,0
2019-06-24 10:00,230,86,144,0,0,0
2019-06-24 10:15,117,43,74,0,0,0
2019-06-24 10:30,71,36,35,0,0,0
2019-06-24 10:45,89,44,45,0,0,0
2019-06-24 11:00,82,42,40,0,0,0
2019-06-24 11:15,90,29,61,0,0,0
2019-06-24 11:30,135,60,75,0,0,0
2019-06-24 11:45,178,79,99,0,0,0
2019-06-24 12:00,162,78,84,0,0,0
2019-06-24 12:15,147,65,82,0,0,0
2019-06-24 12:30,134,35,99,0,0,0
2019-06-24 12:45,131,60,71,0,0,0
2019-06-24 13:00,119,67,52,0,0,0
2019-06-24 13:15,110,55,55,0,0,0
2019-06-24 13:30,143,63,80,0,0,0
2019-06-24 13:45,202,96,106,0,0,0
2019-06-24 14:00,188,110,78,0,0,0
2019-06-24 14:15,127,59,68,0,0,0
2019-06-24 14:30,125,61,64,0,0,0
2019-06-24 14:45,129,61,68,0,0,0
2019-06-24 15:00,112,53,59,0,0,0
2019-06-24 15:15,136,70,66,0,0,0
2019-06-24 15:30,135,72,63,0,0,0
2019-06-24 15:45,259,132,127,0,0,0
2019-06-24 16:00,221,124,97,0,0,0
2019-06-24 16:15,168,111,57,0,0,0
2019-06-24 16:30,184,98,86,0,0,0
2019-06-24 16:45,140,83,57,0,0,0
2019-06-24 17:00,161,99,62,0,0,0
2019-06-24 17:15,146,81,65,0,0,0
2019-06-24 17:30,172,87,85,0,0,0
2019-06-24 17:45,231,131,100,0,0,0
2019-06-24 18:00,162,83,79,0,0,0
2019-06-24 18:15,141,78,63,0,0,0
2019-06-24 18:30,105,46,59,0,0,0
2019-06-24 18:45,112,53,59,0,0,0
2019-06-24 19:00,89,36,53,0,0,0
2019-06-24 19:15,98,39,59,0,0,0
2019-06-24 19:30,109,54,55,0,0,0
2019-06-24 19:45,102,47,55,0,0,0
2019-06-24 20:00,82,27,55,0,0,0
2019-06-24 20:15,76,20,56,0,0,0
2019-06-24 20:30,41,12,29,0,0,0
2019-06-24 20:45,55,23,32,0,0,0
2019-06-24 21:00,55,11,44,0,0,0
2019-06-24 21:15,50,22,28,0,0,0
2019-06-24 21:30,38,3,35,0,0,0
2019-06-24 21:45,60,23,37,0,0,0
2019-06-24 22:00,46,13,33,0,0,0
2019-06-24 22:15,40,12,28,0,0,0
2019-06-24 22:30,32,7,25,0,0,0
2019-06-24 22:45,18,3,15,0,0,0
2019-06-24 23:00,33,3,30,0,0,0
2019-06-24 23:15,17,1,16,0,0,0
2019-06-24 23:30,27,8,19,0,0,0
2019-06-24 23:45,10,0,10,0,0,0
2019-06-25 00:00,16,2,14,0,0,0
2019-06-25 00:15,15,2,13,0,0,0
2019-06-25 00:30,7,4,3,0,0,0
2019-06-25 00:45,6,1,5,0,0,0
2019-06-25 01:00,3,0,3,0,0,0
2019-06-25 01:15,1,0,1,0,0,0
2019-06-25 01:30,7,4,3,0,0,0
2019-06-25 01:45,2,0,2,0,0,0
2019-06-25 02:00,0,0,0,0,0,0
2019-06-25 02:15,1,0,1,0,0,0
2019-06-25 02:30,0,0,0,0,0,0
2019-06-25 02:45,1,1,0,0,0,0
2019-06-25 03:00,0,0,0,0,0,0
2019-06-25 03:15,2,1,1,0,0,0
2019-06-25 03:30,1,0,1,0,0,0
2019-06-25 03:45,0,0,0,0,0,0
2019-06-25 04:00,0,0,0,0,0,0
2019-06-25 04:15,1,1,0,0,0,0
2019-06-25 04:30,2,1,1,0,0,0
2019-06-25 04:45,3,2,1,0,0,0
2019-06-25 05:00,1,0,1,0,0,0
2019-06-25 05:15,3,1,2,0,0,0
2019-06-25 05:30,16,4,12,0,0,0
2019-06-25 05:45,17,7,10,0,0,0
2019-06-25 06:00,16,8,8,0,0,0
2019-06-25 06:15,28,13,15,0,0,0
2019-06-25 06:30,43,12,31,0,0,0
2019-06-25 06:45,63,24,39,0,0,0
2019-06-25 07:00,86,29,57,0,0,0
2019-06-25 07:15,117,53,64,0,0,0
2019-06-25 07:30,239,150,89,0,0,0
2019-06-25 07:45,264,105,159,0,0,0
2019-06-25 08:00,285,100,185,0,0,0
2019-06-25 08:15,189,74,115,0,0,0
2019-06-25 08:30,148,59,89,0,0,0
2019-06-25 08:45,159,71,88,0,0,0
2019-06-25 09:00,173,64,109,0,0,0
2019-06-25 09:15,108,54,54,0,0,0
2019-06-25 09:30,182,59,123,0,0,0
2019-06-25 09:45,229,80,149,0,0,0
2019-06-25 10:00,291,97,194,0,0,0
2019-06-25 10:15,101,42,59,0,0,0
2019-06-25 10:30,93,56,37,0,0,0
2019-06-25 10:45,97,51,46,0,0,0
2019-06-25 11:00,106,48,58,0,0,0
2019-06-25 11:15,93,35,58,0,0,0
2019-06-25 11:30,124,65,59,0,0,0
2019-06-25 11:45,250,143,107,0,0,0
2019-06-25 12:00,208,113,95,0,0,0
2019-06-25 12:15,217,70,147,0,0,0
2019-06-25 12:30,129,54,75,0,0,0
2019-06-25 12:45,188,92,96,0,0,0
2019-06-25 13:00,134,55,79,0,0,0
2019-06-25 13:15,133,52,81,0,0,0
2019-06-25 13:30,154,65,89,0,0,0
2019-06-25 13:45,234,110,124,0,0,0
2019-06-25 14:00,226,94,132,0,0,0
2019-06-25 14:15,134,79,55,0,0,0
2019-06-25 14:30,129,62,67,0,0,0
2019-06-25 14:45,125,61,64,0,0,0
2019-06-25 15:00,133,71,62,0,0,0
2019-06-25 15:15,161,86,75,0,0,0
2019-06-25 15:30,170,100,70,0,0,0
2019-06-25 15:45,194,110,84,0,0,0
2019-06-25 16:00,190,100,90,0,0,0
2019-06-25 16:15,151,75,76,0,0,0
2019-06-25 16:30,174,97,77,0,0,0
2019-06-25 16:45,157,78,79,0,0,0
2019-06-25 17:00,144,85,59,0,0,0
2019-06-25 17:15,162,93,69,0,0,0
2019-06-25 17:30,174,94,80,0,0,0
2019-06-25 17:45,163,82,81,0,0,0
2019-06-25 18:00,126,67,59,0,0,0
2019-06-25 18:15,137,51,86,0,0,0
2019-06-25 18:30,97,34,63,0,0,0
2019-06-25 18:45,156,54,102,0,0,0
2019-06-25 19:00,107,47,60,0,0,0
2019-06-25 19:15,126,45,81,0,0,0
2019-06-25 19:30,79,35,44,0,0,0
2019-06-25 19:45,146,75,71,0,0,0
2019-06-25 20:00,115,39,76,0,0,0
2019-06-25 20:15,84,32,52,0,0,0
2019-06-25 20:30,68,25,43,0,0,0
2019-06-25 20:45,63,27,36,0,0,0
2019-06-25 21:00,63,22,41,0,0,0
2019-06-25 21:15,52,15,37,0,0,0
2019-06-25 21:30,43,18,25,0,0,0
2019-06-25 21:45,46,20,26,0,0,0
2019-06-25 22:00,42,13,29,0,0,0
2019-06-25 22:15,72,19,53,0,0,0
2019-06-25 22:30,59,22,37,0,0,0
2019-06-25 22:45,54,13,41,0,0,0
2019-06-25 23:00,27,7,20,0,0,0
2019-06-25 23:15,19,7,12,0,0,0
2019-06-25 23:30,19,5,14,0,0,0
2019-06-25 23:45,16,5,11,0,0,0
2019-06-26 00:00,15,3,12,0,0,0
2019-06-26 00:15,14,1,13,0,0,0
2019-06-26 00:30,8,3,5,0,0,0
2019-06-26 00:45,7,0,7,0,0,0
2019-06-26 01:00,10,2,8,0,0,0
2019-06-26 01:15,3,2,1,0,0,0
2019-06-26 01:30,7,3,4,0,0,0
2019-06-26 01:45,6,2,4,0,0,0
2019-06-26 02:00,5,4,1,0,0,0
2019-06-26 02:15,1,0,1,0,0,0
2019-06-26 02:30,1,0,1,0,0,0
2019-06-26 02:45,2,1,1,0,0,0
2019-06-26 03:00,0,0,0,0,0,0
2019-06-26 03:15,0,0,0,0,0,0
2019-06-26 03:30,0,0,0,0,0,0
2019-06-26 03:45,2,0,2,0,0,0
2019-06-26 04:00,0,0,0,0,0,0
2019-06-26 04:15,0,0,0,0,0,0
2019-06-26 04:30,3,1,2,0,0,0
2019-06-26 04:45,2,1,1,0,0,0
2019-06-26 05:00,1,0,1,0,0,0
2019-06-26 05:15,2,1,1,0,0,0
2019-06-26 05:30,15,5,10,0,0,0
2019-06-26 05:45,27,8,19,0,0,0
2019-06-26 06:00,18,10,8,0,0,0
2019-06-26 06:15,20,12,8,0,0,0
2019-06-26 06:30,40,12,28,0,0,0
2019-06-26 06:45,75,28,47,0,0,0
2019-06-26 07:00,71,26,45,0,0,0
2019-06-26 07:15,140,69,71,0,0,0
2019-06-26 07:30,247,158,89,0,0,0
2019-06-26 07:45,269,95,174,0,0,0
2019-06-26 08:00,349,114,235,0,0,0
2019-06-26 08:15,211,102,109,0,0,0
2019-06-26 08:30,158,68,90,0,0,0
2019-06-26 08:45,171,76,95,0,0,0
2019-06-26 09:00,179,68,111,0,0,0
2019-06-26 09:15,171,91,80,0,0,0
2019-06-26 09:30,135,68,67,0,0,0
2019-06-26 09:45,228,94,134,0,0,0
2019-06-26 10:00,282,118,164,0,0,0
2019-06-26 10:15,107,59,48,0,0,0
2019-06-26 10:30,96,46,50,0,0,0
2019-06-26 10:45,91,41,50,0,0,0
2019-06-26 11:00,105,43,62,0,0,0
2019-06-26 11:15,103,46,57,0,0,0
2019-06-26 11:30,127,56,71,0,0,0
2019-06-26 11:45,269,126,143,0,0,0
2019-06-26 12:00,190,98,92,0,0,0
2019-06-26 12:15,280,93,187,0,0,0
2019-06-26 12:30,136,52,84,0,0,0
2019-06-26 12:45,158,68,90,0,0,0
2019-06-26 13:00,136,60,76,0,0,0
2019-06-26 13:15,148,75,73,0,0,0
2019-06-26 13:30,165,73,92,0,0,0
2019-06-26 13:45,252,96,156,0,0,0
2019-06-26 14:00,227,104,123,0,0,0
2019-06-26 14:15,122,56,66,0,0,0
2019-06-26 14:30,112,58,54,0,0,0
2019-06-26 14:45,148,75,73,0,0,0
2019-06-26 15:00,125,72,53,0,0,0
2019-06-26 15:15,149,77,72,0,0,0
2019-06-26 15:30,172,93,79,0,0,0
2019-06-26 15:45,236,131,105,0,0,0
2019-06-26 16:00,212,116,96,0,0,0
2019-06-26 16:15,132,69,63,0,0,0
2019-06-26 16:30,178,99,79,0,0,0
2019-06-26 16:45,143,81,62,0,0,0
2019-06-26 17:00,131,67,64,0,0,0
2019-06-26 17:15,152,81,71,0,0,0
2019-06-26 17:30,159,87,72,0,0,0
2019-06-26 17:45,182,101,81,0,0,0
2019-06-26 18:00,169,79,90,0,0,0
2019-06-26 18:15,139,80,59,0,0,0
2019-06-26 18:30,106,41,65,0,0,0
2019-06-26 18:45,121,61,60,0,0,0
2019-06-26 19:00,100,46,54,0,0,0
2019-06-26 19:15,95,46,49,0,0,0
2019-06-26 19:30,109,47,62,0,0,0
2019-06-26 19:45,117,52,65,0,0,0
2019-06-26 20:00,105,39,66,0,0,0
2019-06-26 20:15,67,24,43,0,0,0
2019-06-26 20:30,63,17,46,0,0,0
2019-06-26 20:45,66,24,42,0,0,0
2019-06-26 21:00,75,24,51,0,0,0
2019-06-26 21:15,69,30,39,0,0,0
2019-06-26 21:30,47,23,24,0,0,0
2019-06-26 21:45,82,34,48,0,0,0
2019-06-26 22:00,57,19,38,0,0,0
2019-06-26 22:15,57,22,35,0,0,0
2019-06-26 22:30,48,10,38,0,0,0
2019-06-26 22:45,49,11,38,0,0,0
2019-06-26 23:00,37,10,27,0,0,0
2019-06-26 23:15,19,4,15,0,0,0
2019-06-26 23:30,23,7,16,0,0,0
2019-06-26 23:45,21,8,13,0,0,0
2019-06-27 00:00,30,13,17,0,0,0
2019-06-27 00:15,11,2,9,0,0,0
2019-06-27 00:30,6,1,5,0,0,0
2019-06-27 00:45,10,6,4,0,0,0
2019-06-27 01:00,18,16,2,0,0,0
2019-06-27 01:15,6,1,5,0,0,0
2019-06-27 01:30,3,1,2,0,0,0
2019-06-27 01:45,6,1,5,0,0,0
2019-06-27 02:00,1,0,1,0,0,0
2019-06-27 02:15,1,0,1,0,0,0
2019-06-27 02:30,3,1,2,0,0,0
2019-06-27 02:45,6,1,5,0,0,0
2019-06-27 03:00,12,0,12,0,0,0
2019-06-27 03:15,7,1,6,0,0,0
2019-06-27 03:30,11,0,11,0,0,0
2019-06-27 03:45,6,0,6,0,0,0
2019-06-27 04:00,9,0,9,0,0,0
2019-06-27 04:15,5,0,5,0,0,0
2019-06-27 04:30,5,0,5,0,0,0
2019-06-27 04:45,5,0,5,0,0,0
2019-06-27 05:00,3,2,1,0,0,0
2019-06-27 05:15,4,2,2,0,0,0
2019-06-27 05:30,16,5,11,0,0,0
2019-06-27 05:45,18,8,10,0,0,0
2019-06-27 06:00,20,11,9,0,0,0
2019-06-27 06:15,20,7,13,0,0,0
2019-06-27 06:30,28,13,15,0,0,0
2019-06-27 06:45,59,26,33,0,0,0
2019-06-27 07:00,68,27,41,0,0,0
2019-06-27 07:15,106,41,65,0,0,0
2019-06-27 07:30,188,79,109,0,0,0
2019-06-27 07:45,251,82,169,0,0,0
2019-06-27 08:00,240,65,175,0,0,0
2019-06-27 08:15,178,74,104,0,0,0
2019-06-27 08:30,138,58,80,0,0,0
2019-06-27 08:45,148,70,78,0,0,0
2019-06-27 09:00,154,53,101,0,0,0
2019-06-27 09:15,112,56,56,0,0,0
2019-06-27 09:30,120,51,69,0,0,0
2019-06-27 09:45,226,118,108,0,0,0
2019-06-27 10:00,261,121,140,0,0,0
2019-06-27 10:15,127,56,71,0,0,0
2019-06-27 10:30,80,42,38,0,0,0
2019-06-27 10:45,99,43,56,0,0,0
2019-06-27 11:00,102,44,58,0,0,0
2019-06-27 11:15,95,40,55,0,0,0
2019-06-27 11:30,92,52,40,0,0,0
2019-06-27 11:45,264,124,140,0,0,0
2019-06-27 12:00,187,97,90,0,0,0
2019-06-27 12:15,140,68,72,0,0,0
2019-06-27 12:30,127,52,75,0,0,0
2019-06-27 12:45,139,54,85,0,0,0
2019-06-27 13:00,161,90,71,0,0,0
2019-06-27 13:15,162,59,103,0,0,0
2019-06-27 13:30,151,78,73,0,0,0
2019-06-27 13:45,251,94,157,0,0,0
2019-06-27 14:00,206,92,114,0,0,0
2019-06-27 14:15,151,88,63,0,0,0
2019-06-27 14:30,152,81,71,0,0,0
2019-06-27 14:45,117,53,64,0,0,0
2019-06-27 15:00,138,71,67,0,0,0
2019-06-27 15:15,114,66,48,0,0,0
2019-06-27 15:30,175,94,81,0,0,0
2019-06-27 15:45,266,136,130,0,0,0
2019-06-27 16:00,229,121,108,0,0,0
2019-06-27 16:15,176,103,73,0,0,0
2019-06-27 16:30,174,98,76,0,0,0
2019-06-27 16:45,183,103,80,0,0,0
2019-06-27 17:00,176,81,95,0,0,0
2019-06-27 17:15,168,90,78,0,0,0
2019-06-27 17:30,189,104,85,0,0,0
2019-06-27 17:45,216,99,117,0,0,0
2019-06-27 18:00,169,80,89,0,0,0
2019-06-27 18:15,162,90,72,0,0,0
2019-06-27 18:30,122,62,60,0,0,0
2019-06-27 18:45,160,78,82,0,0,0
2019-06-27 19:00,117,48,69,0,0,0
2019-06-27 19:15,114,47,67,0,0,0
2019-06-27 19:30,133,50,83,0,0,0
2019-06-27 19:45,132,67,65,0,0,0
2019-06-27 20:00,100,32,68,0,0,0
2019-06-27 20:15,68,27,41,0,0,0
2019-06-27 20:30,61,23,38,0,0,0
2019-06-27 20:45,55,17,38,0,0,0
2019-06-27 21:00,59,23,36,0,0,0
2019-06-27 21:15,42,15,27,0,0,0
2019-06-27 21:30,48,22,26,0,0,0
2019-06-27 21:45,71,20,51,0,0,0
2019-06-27 22:00,48,16,32,0,0,0
2019-06-27 22:15,52,15,37,0,0,0
2019-06-27 22:30,40,8,32,0,0,0
2019-06-27 22:45,43,15,28,0,0,0
2019-06-27 23:00,21,7,14,0,0,0
2019-06-27 23:15,25,7,18,0,0,0
2019-06-27 23:30,27,12,15,0,0,0
2019-06-27 23:45,25,9,16,0,0,0
2019-06-28 00:00,12,4,8,0,0,0
2019-06-28 00:15,19,5,14,0,0,0
2019-06-28 00:30,16,6,10,0,0,0
2019-06-28 00:45,5,1,4,0,0,0
2019-06-28 01:00,5,0,5,0,0,0
2019-06-28 01:15,6,1,5,0,0,0
2019-06-28 01:30,2,1,1,0,0,0
2019-06-28 01:45,4,1,3,0,0,0
2019-06-28 02:00,4,0,4,0,0,0
2019-06-28 02:15,4,0,4,0,0,0
2019-06-28 02:30,0,0,0,0,0,0
2019-06-28 02:45,5,1,4,0,0,0
2019-06-28 03:00,1,1,0,0,0,0
2019-06-28 03:15,2,0,2,0,0,0
2019-06-28 03:30,1,0,1,0,0,0
2019-06-28 03:45,7,0,7,0,0,0
2019-06-28 04:00,3,1,2,0,0,0
2019-06-28 04:15,0,0,0,0,0,0
2019-06-28 04:30,0,0,0,0,0,0
2019-06-28 04:45,3,0,3,0,0,0
2019-06-28 05:00,1,1,0,0,0,0
2019-06-28 05:15,1,0,1,0,0,0
2019-06-28 05:30,11,3,8,0,0,0
2019-06-28 05:45,20,8,12,0,0,0
2019-06-28 06:00,11,6,5,0,0,0
2019-06-28 06:15,33,15,18,0,0,0
2019-06-28 06:30,32,15,17,0,0,0
2019-06-28 06:45,50,16,34,0,0,0
2019-06-28 07:00,66,23,43,0,0,0
2019-06-28 07:15,109,49,60,0,0,0
2019-06-28 07:30,227,137,90,0,0,0
2019-06-28 07:45,265,108,157,0,0,0
2019-06-28 08:00,229,73,156,0,0,0
2019-06-28 08:15,146,75,71,0,0,0
2019-06-28 08:30,114,57,57,0,0,0
2019-06-28 08:45,143,58,85,0,0,0
2019-06-28 09:00,131,53,78,0,0,0
2019-06-28 09:15,96,40,56,0,0,0
2019-06-28 09:30,136,80,56,0,0,0
2019-06-28 09:45,284,103,181,0,0,0
2019-06-28 10:00,224,76,148,0,0,0
2019-06-28 10:15,122,62,60,0,0,0
2019-06-28 10:30,90,51,39,0,0,0
2019-06-28 10:45,111,45,66,0,0,0
2019-06-28 11:00,85,46,39,0,0,0
2019-06-28 11:15,104,54,50,0,0,0
2019-06-28 11:30,98,34,64,0,0,0
2019-06-28 11:45,185,117,68,0,0,0
2019-06-28 12:00,191,103,88,0,0,0
2019-06-28 12:15,165,67,98,0,0,0
2019-06-28 12:30,163,74,89,0,0,0
2019-06-28 12:45,138,88,50,0,0,0
2019-06-28 13:00,188,70,118,0,0,0
2019-06-28 13:15,174,64,110,0,0,0
2019-06-28 13:30,149,81,68,0,0,0
2019-06-28 13:45,177,92,85,0,0,0
2019-06-28 14:00,173,75,98,0,0,0
2019-06-28 14:15,164,84,80,0,0,0
2019-06-28 14:30,117,56,61,0,0,0
2019-06-28 14:45,140,76,64,0,0,0
2019-06-28 15:00,123,51,72,0,0,0
2019-06-28 15:15,119,61,58,0,0,0
2019-06-28 15:30,162,84,78,0,0,0
2019-06-28 15:45,142,78,64,0,0,0
2019-06-28 16:00,139,84,55,0,0,0
2019-06-28 16:15,117,70,47,0,0,0
2019-06-28 16:30,89,44,45,0,0,0
2019-06-28 16:45,120,60,60,0,0,0
2019-06-28 17:00,132,70,62,0,0,0
2019-06-28 17:15,118,64,54,0,0,0
2019-06-28 17:30,114,60,54,0,0,0
2019-06-28 17:45,137,77,60,0,0,0
2019-06-28 18:00,110,58,52,0,0,0
2019-06-28 18:15,100,45,55,0,0,0
2019-06-28 18:30,98,40,58,0,0,0
2019-06-28 18:45,117,65,52,0,0,0
2019-06-28 19:00,90,45,45,0,0,0
2019-06-28 19:15,104,47,57,0,0,0
2019-06-28 19:30,80,37,43,0,0,0
2019-06-28 19:45,80,38,42,0,0,0
2019-06-28 20:00,89,38,51,0,0,0
2019-06-28 20:15,57,18,39,0,0,0
2019-06-28 20:30,65,32,33,0,0,0
2019-06-28 20:45,50,24,26,0,0,0
2019-06-28 21:00,55,24,31,0,0,0
2019-06-28 21:15,38,18,20,0,0,0
2019-06-28 21:30,37,13,24,0,0,0
2019-06-28 21:45,63,37,26,0,0,0
2019-06-28 22:00,37,5,32,0,0,0
2019-06-28 22:15,37,12,25,0,0,0
2019-06-28 22:30,36,10,26,0,0,0
2019-06-28 22:45,44,11,33,0,0,0
2019-06-28 23:00,44,11,33,0,0,0
2019-06-28 23:15,44,11,33,0,0,0
2019-06-28 23:30,34,4,30,0,0,0
2019-06-28 23:45,31,9,22,0,0,0
2019-06-29 00:00,30,10,20,0,0,0
2019-06-29 00:15,30,11,19,0,0,0
2019-06-29 00:30,36,15,21,0,0,0
2019-06-29 00:45,23,3,20,0,0,0
2019-06-29 01:00,20,8,12,0,0,0
2019-06-29 01:15,14,2,12,0,0,0
2019-06-29 01:30,10,6,4,0,0,0
2019-06-29 01:45,12,0,12,0,0,0
2019-06-29 02:00,9,2,7,0,0,0
2019-06-29 02:15,12,0,12,0,0,0
2019-06-29 02:30,8,0,8,0,0,0
2019-06-29 02:45,2,0,2,0,0,0
2019-06-29 03:00,9,6,3,0,0,0
2019-06-29 03:15,6,1,5,0,0,0
2019-06-29 03:30,2,2,0,0,0,0
2019-06-29 03:45,7,3,4,0,0,0
2019-06-29 04:00,3,0,3,0,0,0
2019-06-29 04:15,4,1,3,0,0,0
2019-06-29 04:30,4,0,4,0,0,0
2019-06-29 04:45,4,0,4,0,0,0
2019-06-29 05:00,1,0,1,0,0,0
2019-06-29 05:15,5,1,4,0,0,0
2019-06-29 05:30,8,2,6,0,0,0
2019-06-29 05:45,4,1,3,0,0,0
2019-06-29 06:00,5,3,2,0,0,0
2019-06-29 06:15,9,5,4,0,0,0
2019-06-29 06:30,12,8,4,0,0,0
2019-06-29 06:45,14,12,2,0,0,0
2019-06-29 07:00,9,1,8,0,0,0
2019-06-29 07:15,20,14,6,0,0,0
2019-06-29 07:30,11,4,7,0,0,0
2019-06-29 07:45,50,31,19,0,0,0
2019-06-29 08:00,51,28,23,0,0,0
2019-06-29 08:15,49,35,14,0,0,0
2019-06-29 08:30,61,42,19,0,0,0
2019-06-29 08:45,89,62,27,0,0,0
2019-06-29 09:00,48,33,15,0,0,0
2019-06-29 09:15,65,50,15,0,0,0
2019-06-29 09:30,64,50,14,0,0,0
2019-06-29 09:45,117,88,29,0,0,0
2019-06-29 10:00,102,80,22,0,0,0
2019-06-29 10:15,105,74,31,0,0,0
2019-06-29 10:30,106,68,38,0,0,0
2019-06-29 10:45,117,74,43,0,0,0
2019-06-29 11:00,83,54,29,0,0,0
2019-06-29 11:15,87,42,45,0,0,0
2019-06-29 11:30,89,45,44,0,0,0
2019-06-29 11:45,81,51,30,0,0,0
2019-06-29 12:00,101,52,49,0,0,0
2019-06-29 12:15,99,39,60,0,0,0
2019-06-29 12:30,104,34,70,0,0,0
2019-06-29 12:45,101,51,50,0,0,0
2019-06-29 13:00,98,51,47,0,0,0
2019-06-29 13:15,83,48,35,0,0,0
2019-06-29 13:30,122,53,69,0,0,0
2019-06-29 13:45,103,45,58,0,0,0
2019-06-29 14:00,125,50,75,0,0,0
2019-06-29 14:15,104,38,66,0,0,0
2019-06-29 14:30,84,35,49,0,0,0
2019-06-29 14:45,68,24,44,0,0,0
2019-06-29 15:00,94,30,64,0,0,0
2019-06-29 15:15,62,28,34,0,0,0
2019-06-29 15:30,75,30,45,0,0,0
2019-06-29 15:45,73,31,42,0,0,0
2019-06-29 16:00,76,37,39,0,0,0
2019-06-29 16:15,87,29,58,0,0,0
2019-06-29 16:30,73,23,50,0,0,0
2019-06-29 16:45,77,29,48,0,0,0
2019-06-29 17:00,70,28,42,0,0,0
2019-06-29 17:15,56,17,39,0,0,0
2019-06-29 17:30,74,28,46,0,0,0
2019-06-29 17:45,75,27,48,0,0,0
2019-06-29 18:00,65,23,42,0,0,0
2019-06-29 18:15,92,38,54,0,0,0
2019-06-29 18:30,80,34,46,0,0,0
2019-06-29 18:45,60,17,43,0,0,0
2019-06-29 19:00,77,29,48,0,0,0
2019-06-29 19:15,52,12,40,0,0,0
2019-06-29 19:30,50,18,32,0,0,0
2019-06-29 19:45,59,26,33,0,0,0
2019-06-29 20:00,68,23,45,0,0,0
2019-06-29 20:15,56,16,40,0,0,0
2019-06-29 20:30,48,21,27,0,0,0
2019-06-29 20:45,43,19,24,0,0,0
2019-06-29 21:00,44,21,23,0,0,0
2019-06-29 21:15,49,18,31,0,0,0
2019-06-29 21:30,36,17,19,0,0,0
2019-06-29 21:45,45,16,29,0,0,0
2019-06-29 22:00,41,9,32,0,0,0
2019-06-29 22:15,40,19,21,0,0,0
2019-06-29 22:30,30,8,22,0,0,0
2019-06-29 22:45,40,11,29,0,0,0
2019-06-29 23:00,41,6,35,0,0,0
2019-06-29 23:15,25,9,16,0,0,0
2019-06-29 23:30,25,11,14,0,0,0
2019-06-29 23:45,24,10,14,0,0,0
2019-06-30 00:00,39,18,21,0,0,0
2019-06-30 00:15,21,9,12,0,0,0
2019-06-30 00:30,14,1,13,0,0,0
2019-06-30 00:45,22,12,10,0,0,0
2019-06-30 01:00,8,4,4,0,0,0
2019-06-30 01:15,15,2,13,0,0,0
2019-06-30 01:30,15,5,10,0,0,0
2019-06-30 01:45,23,14,9,0,0,0
2019-06-30 02:00,18,8,10,0,0,0
2019-06-30 02:15,8,0,8,0,0,0
2019-06-30 02:30,10,0,10,0,0,0
2019-06-30 02:45,13,8,5,0,0,0
2019-06-30 03:00,7,0,7,0,0,0
2019-06-30 03:15,7,3,4,0,0,0
2019-06-30 03:30,10,1,9,0,0,0
2019-06-30 03:45,6,0,6,0,0,0
2019-06-30 04:00,13,4,9,0,0,0
2019-06-30 04:15,9,0,9,0,0,0
2019-06-30 04:30,5,1,4,0,0,0
2019-06-30 04:45,8,2,6,0,0,0
2019-06-30 05:00,5,1,4,0,0,0
2019-06-30 05:15,6,0,6,0,0,0
2019-06-30 05:30,5,0,5,0,0,0
2019-06-30 05:45,6,1,5,0,0,0
2019-06-30 06:00,5,3,2,0,0,0
2019-06-30 06:15,0,0,0,0,0,0
2019-06-30 06:30,11,9,2,0,0,0
2019-06-30 06:45,8,2,6,0,0,0
2019-06-30 07:00,8,5,3,0,0,0
2019-06-30 07:15,9,4,5,0,0,0
2019-06-30 07:30,17,6,11,0,0,0
2019-06-30 07:45,24,17,7,0,0,0
2019-06-30 08:00,20,13,7,0,0,0
2019-06-30 08:15,19,11,8,0,0,0
2019-06-30 08:30,15,10,5,0,0,0
2019-06-30 08:45,23,10,13,0,0,0
2019-06-30 09:00,22,14,8,0,0,0
2019-06-30 09:15,20,13,7,0,0,0
2019-06-30 09:30,25,14,11,0,0,0
2019-06-30 09:45,42,21,21,0,0,0
2019-06-30 10:00,30,13,17,0,0,0
2019-06-30 10:15,26,12,14,0,0,0
2019-06-30 10:30,37,18,19,0,0,0
2019-06-30 10:45,45,22,23,0,0,0
2019-06-30 11:00,48,20,28,0,0,0
2019-06-30 11:15,37,16,21,0,0,0
2019-06-30 11:30,32,18,14,0,0,0
2019-06-30 11:45,39,19,20,0,0,0
2019-06-30 12:00,38,20,18,0,0,0
2019-06-30 12:15,35,20,15,0,0,0
2019-06-30 12:30,32,10,22,0,0,0
2019-06-30 12:45,31,15,16,0,0,0
2019-06-30 13:00,40,25,15,0,0,0
2019-06-30 13:15,48,23,25,0,0,0
2019-06-30 13:30,47,26,21,0,0,0
2019-06-30 13:45,32,16,16,0,0,0
2019-06-30 14:00,42,26,16,0,0,0
2019-06-30 14:15,31,18,13,0,0,0
2019-06-30 14:30,38,21,17,0,0,0
2019-06-30 14:45,64,32,32,0,0,0
2019-06-30 15:00,45,21,24,0,0,0
2019-06-30 15:15,45,26,19,0,0,0
2019-06-30 15:30,41,22,19,0,0,0
2019-06-30 15:45,35,24,11,0,0,0
2019-06-30 16:00,38,12,26,0,0,0
2019-06-30 16:15,41,22,19,0,0,0
2019-06-30 16:30,62,24,38,0,0,0
2019-06-30 16:45,39,15,24,0,0,0
2019-06-30 17:00,77,37,40,0,0,0
2019-06-30 17:15,41,15,26,0,0,0
2019-06-30 17:30,45,22,23,0,0,0
2019-06-30 17:45,50,25,25,0,0,0
2019-06-30 18:00,58,22,36,0,0,0
2019-06-30 18:15,48,26,22,0,0,0
2019-06-30 18:30,66,23,43,0,0,0
2019-06-30 18:45,44,10,34,0,0,0
2019-06-30 19:00,48,23,25,0,0,0
2019-06-30 19:15,36,18,18,0,0,0
2019-06-30 19:30,43,9,34,0,0,0
2019-06-30 19:45,26,6,20,0,0,0
2019-06-30 20:00,36,11,25,0,0,0
2019-06-30 20:15,45,22,23,0,0,0
2019-06-30 20:30,48,12,36,0,0,0
2019-06-30 20:45,39,7,32,0,0,0
2019-06-30 21:00,36,9,27,0,0,0
2019-06-30 21:15,47,18,29,0,0,0
2019-06-30 21:30,18,8,10,0,0,0
2019-06-30 21:45,20,5,15,0,0,0
2019-06-30 22:00,39,10,29,0,0,0
2019-06-30 22:15,27,10,17,0,0,0
2019-06-30 22:30,17,8,9,0,0,0
2019-06-30 22:45,22,7,15,0,0,0
2019-06-30 23:00,17,7,10,0,0,0
2019-06-30 23:15,28,14,14,0,0,0
2019-06-30 23:30,16,10,6,0,0,0
2019-06-30 23:45,13,5,8,0,0,0
