Datetime,100034982 (Hüfferstraße),101034982 (Hüfferstraße stadteinwärts),102034982 (Hüfferstraße stadtauswärts),100034982-status,101034982-status,102034982-status
2019-04-01 00:00,4,1,3,0,0,0
2019-04-01 00:15,3,0,3,0,0,0
2019-04-01 00:30,6,1,5,0,0,0
2019-04-01 00:45,3,0,3,0,0,0
2019-04-01 01:00,5,0,5,0,0,0
2019-04-01 01:15,7,2,5,0,0,0
2019-04-01 01:30,1,0,1,0,0,0
2019-04-01 01:45,0,0,0,0,0,0
2019-04-01 02:00,0,0,0,0,0,0
2019-04-01 02:15,0,0,0,0,0,0
2019-04-01 02:30,0,0,0,0,0,0
2019-04-01 02:45,0,0,0,0,0,0
2019-04-01 03:00,2,2,0,0,0,0
2019-04-01 03:15,0,0,0,0,0,0
2019-04-01 03:30,2,0,2,0,0,0
2019-04-01 03:45,0,0,0,0,0,0
2019-04-01 04:00,0,0,0,0,0,0
2019-04-01 04:15,0,0,0,0,0,0
2019-04-01 04:30,1,0,1,0,0,0
2019-04-01 04:45,2,0,2,0,0,0
2019-04-01 05:00,1,1,0,0,0,0
2019-04-01 05:15,3,1,2,0,0,0
2019-04-01 05:30,11,2,9,0,0,0
2019-04-01 05:45,8,4,4,0,0,0
2019-04-01 06:00,8,6,2,0,0,0
2019-04-01 06:15,32,15,17,0,0,0
2019-04-01 06:30,41,13,28,0,0,0
2019-04-01 06:45,51,17,34,0,0,0
2019-04-01 07:00,69,24,45,0,0,0
2019-04-01 07:15,112,48,64,0,0,0
2019-04-01 07:30,229,144,85,0,0,0
2019-04-01 07:45,263,87,176,0,0,0
2019-04-01 08:00,204,44,160,0,0,0
2019-04-01 08:15,196,61,135,0,0,0
2019-04-01 08:30,122,60,62,0,0,0
2019-04-01 08:45,188,74,114,0,0,0
2019-04-01 09:00,154,74,80,0,0,0
2019-04-01 09:15,95,64,31,0,0,0
2019-04-01 09:30,130,69,61,0,0,0
2019-04-01 09:45,190,72,118,0,0,0
2019-04-01 10:00,160,52,108,0,0,0
2019-04-01 10:15,97,52,45,0,0,0
2019-04-01 10:30,75,38,37,0,0,0
2019-04-01 10:45,79,40,39,0,0,0
2019-04-01 11:00,87,40,47,0,0,0
2019-04-01 11:15,71,39,32,0,0,0
2019-04-01 11:30,121,52,69,0,0,0
2019-04-01 11:45,173,89,84,0,0,0
2019-04-01 12:00,142,78,64,0,0,0
2019-04-01 12:15,93,48,45,0,0,0
2019-04-01 12:30,102,50,52,0,0,0
2019-04-01 12:45,144,69,75,0,0,0
2019-04-01 13:00,175,93,82,0,0,0
2019-04-01 13:15,146,64,82,0,0,0
2019-04-01 13:30,138,56,82,0,0,0
2019-04-01 13:45,180,86,94,0,0,0
2019-04-01 14:00,199,75,124,0,0,0
2019-04-01 14:15,125,54,71,0,0,0
2019-04-01 14:30,100,42,58,0,0,0
2019-04-01 14:45,146,74,72,0,0,0
2019-04-01 15:00,119,63,56,0,0,0
2019-04-01 15:15,128,80,48,0,0,0
2019-04-01 15:30,135,55,80,0,0,0
2019-04-01 15:45,233,122,111,0,0,0
2019-04-01 16:00,205,108,97,0,0,0
2019-04-01 16:15,184,93,91,0,0,0
2019-04-01 16:30,169,86,83,0,0,0
2019-04-01 16:45,175,101,74,0,0,0
2019-04-01 17:00,159,99,60,0,0,0
2019-04-01 17:15,194,91,103,0,0,0
2019-04-01 17:30,169,97,72,0,0,0
2019-04-01 17:45,185,80,105,0,0,0
2019-04-01 18:00,158,75,83,0,0,0
2019-04-01 18:15,133,46,87,0,0,0
2019-04-01 18:30,90,22,68,0,0,0
2019-04-01 18:45,132,69,63,0,0,0
2019-04-01 19:00,97,45,52,0,0,0
2019-04-01 19:15,87,35,52,0,0,0
2019-04-01 19:30,77,29,48,0,0,0
2019-04-01 19:45,108,41,67,0,0,0
2019-04-01 20:00,95,45,50,0,0,0
2019-04-01 20:15,55,19,36,0,0,0
2019-04-01 20:30,46,15,31,0,0,0
2019-04-01 20:45,38,6,32,0,0,0
2019-04-01 21:00,43,12,31,0,0,0
2019-04-01 21:15,30,5,25,0,0,0
2019-04-01 21:30,30,8,22,0,0,0
2019-04-01 21:45,30,5,25,0,0,0
2019-04-01 22:00,42,10,32,0,0,0
2019-04-01 22:15,31,15,16,0,0,0
2019-04-01 22:30,26,8,18,0,0,0
2019-04-01 22:45,24,6,18,0,0,0
2019-04-01 23:00,22,1,21,0,0,0
2019-04-01 23:15,16,6,10,0,0,0
2019-04-01 23:30,9,3,6,0,0,0
2019-04-01 23:45,10,4,6,0,0,0
2019-04-02 00:00,4,0,4,0,0,0
2019-04-02 00:15,9,4,5,0,0,0
2019-04-02 00:30,7,4,3,0,0,0
2019-04-02 00:45,4,2,2,0,0,0
2019-04-02 01:00,1,0,1,0,0,0
2019-04-02 01:15,0,0,0,0,0,0
2019-04-02 01:30,1,1,0,0,0,0
2019-04-02 01:45,2,0,2,0,0,0
2019-04-02 02:00,5,1,4,0,0,0
2019-04-02 02:15,2,0,2,0,0,0
2019-04-02 02:30,3,1,2,0,0,0
2019-04-02 02:45,6,0,6,0,0,0
2019-04-02 03:00,2,0,2,0,0,0
2019-04-02 03:15,6,1,5,0,0,0
2019-04-02 03:30,5,0,5,0,0,0
2019-04-02 03:45,3,0,3,0,0,0
2019-04-02 04:00,6,0,6,0,0,0
2019-04-02 04:15,2,0,2,0,0,0
2019-04-02 04:30,2,1,1,0,0,0
2019-04-02 04:45,5,1,4,0,0,0
2019-04-02 05:00,2,1,1,0,0,0
2019-04-02 05:15,2,0,2,0,0,0
2019-04-02 05:30,19,4,15,0,0,0
2019-04-02 05:45,18,1,17,0,0,0
2019-04-02 06:00,13,8,5,0,0,0
2019-04-02 06:15,24,15,9,0,0,0
2019-04-02 06:30,21,12,9,0,0,0
2019-04-02 06:45,60,22,38,0,0,0
2019-04-02 07:00,80,22,58,0,0,0
2019-04-02 07:15,115,42,73,0,0,0
2019-04-02 07:30,262,155,107,0,0,0
2019-04-02 07:45,296,121,175,0,0,0
2019-04-02 08:00,275,73,202,0,0,0
2019-04-02 08:15,168,55,113,0,0,0
2019-04-02 08:30,153,64,89,0,0,0
2019-04-02 08:45,200,85,115,0,0,0
2019-04-02 09:00,140,56,84,0,0,0
2019-04-02 09:15,99,60,39,0,0,0
2019-04-02 09:30,143,56,87,0,0,0
2019-04-02 09:45,216,76,140,0,0,0
2019-04-02 10:00,210,76,134,0,0,0
2019-04-02 10:15,92,53,39,0,0,0
2019-04-02 10:30,86,58,28,0,0,0
2019-04-02 10:45,80,40,40,0,0,0
2019-04-02 11:00,77,28,49,0,0,0
2019-04-02 11:15,101,41,60,0,0,0
2019-04-02 11:30,128,55,73,0,0,0
2019-04-02 11:45,218,138,80,0,0,0
2019-04-02 12:00,186,89,97,0,0,0
2019-04-02 12:15,134,71,63,0,0,0
2019-04-02 12:30,148,83,65,0,0,0
2019-04-02 12:45,148,75,73,0,0,0
2019-04-02 13:00,165,62,103,0,0,0
2019-04-02 13:15,179,78,101,0,0,0
2019-04-02 13:30,149,73,76,0,0,0
2019-04-02 13:45,263,107,156,0,0,0
2019-04-02 14:00,205,83,122,0,0,0
2019-04-02 14:15,116,53,63,0,0,0
2019-04-02 14:30,106,63,43,0,0,0
2019-04-02 14:45,103,49,54,0,0,0
2019-04-02 15:00,93,46,47,0,0,0
2019-04-02 15:15,145,100,45,0,0,0
2019-04-02 15:30,157,79,78,0,0,0
2019-04-02 15:45,204,123,81,0,0,0
2019-04-02 16:00,175,113,62,0,0,0
2019-04-02 16:15,165,91,74,0,0,0
2019-04-02 16:30,139,67,72,0,0,0
2019-04-02 16:45,118,69,49,0,0,0
2019-04-02 17:00,158,100,58,0,0,0
2019-04-02 17:15,130,73,57,0,0,0
2019-04-02 17:30,131,55,76,0,0,0
2019-04-02 17:45,166,104,62,0,0,0
2019-04-02 18:00,158,75,83,0,0,0
2019-04-02 18:15,110,37,73,0,0,0
2019-04-02 18:30,91,42,49,0,0,0
2019-04-02 18:45,100,50,50,0,0,0
2019-04-02 19:00,78,40,38,0,0,0
2019-04-02 19:15,72,26,46,0,0,0
2019-04-02 19:30,57,23,34,0,0,0
2019-04-02 19:45,80,31,49,0,0,0
2019-04-02 20:00,74,25,49,0,0,0
2019-04-02 20:15,43,14,29,0,0,0
2019-04-02 20:30,36,18,18,0,0,0
2019-04-02 20:45,38,11,27,0,0,0
2019-04-02 21:00,36,11,25,0,0,0
2019-04-02 21:15,27,9,18,0,0,0
2019-04-02 21:30,39,15,24,0,0,0
2019-04-02 21:45,23,7,16,0,0,0
2019-04-02 22:00,35,5,30,0,0,0
2019-04-02 22:15,42,15,27,0,0,0
2019-04-02 22:30,38,13,25,0,0,0
2019-04-02 22:45,29,13,16,0,0,0
2019-04-02 23:00,23,5,18,0,0,0
2019-04-02 23:15,17,4,13,0,0,0
2019-04-02 23:30,6,2,4,0,0,0
2019-04-02 23:45,10,5,5,0,0,0
2019-04-03 00:00,2,0,2,0,0,0
2019-04-03 00:15,8,2,6,0,0,0
2019-04-03 00:30,3,0,3,0,0,0
2019-04-03 00:45,0,0,0,0,0,0
2019-04-03 01:00,2,0,2,0,0,0
2019-04-03 01:15,4,1,3,0,0,0
2019-04-03 01:30,1,0,1,0,0,0
2019-04-03 01:45,3,0,3,0,0,0
2019-04-03 02:00,0,0,0,0,0,0
2019-04-03 02:15,0,0,0,0,0,0
2019-04-03 02:30,1,0,1,0,0,0
2019-04-03 02:45,3,1,2,0,0,0
2019-04-03 03:00,0,0,0,0,0,0
2019-04-03 03:15,0,0,0,0,0,0
2019-04-03 03:30,1,1,0,0,0,0
2019-04-03 03:45,0,0,0,0,0,0
2019-04-03 04:00,1,0,1,0,0,0
2019-04-03 04:15,0,0,0,0,0,0
2019-04-03 04:30,1,1,0,0,0,0
2019-04-03 04:45,2,0,2,0,0,0
2019-04-03 05:00,1,0,1,0,0,0
2019-04-03 05:15,1,1,0,0,0,0
2019-04-03 05:30,15,5,10,0,0,0
2019-04-03 05:45,15,2,13,0,0,0
2019-04-03 06:00,12,9,3,0,0,0
2019-04-03 06:15,27,16,11,0,0,0
2019-04-03 06:30,41,10,31,0,0,0
2019-04-03 06:45,68,29,39,0,0,0
2019-04-03 07:00,79,30,49,0,0,0
2019-04-03 07:15,132,82,50,0,0,0
2019-04-03 07:30,256,167,89,0,0,0
2019-04-03 07:45,330,126,204,0,0,0
2019-04-03 08:00,281,70,211,0,0,0
2019-04-03 08:15,151,48,103,0,0,0
2019-04-03 08:30,124,63,61,0,0,0
2019-04-03 08:45,146,63,83,0,0,0
2019-04-03 09:00,137,48,89,0,0,0
2019-04-03 09:15,102,46,56,0,0,0
2019-04-03 09:30,111,55,56,0,0,0
2019-04-03 09:45,174,91,83,0,0,0
2019-04-03 10:00,266,93,173,0,0,0
2019-04-03 10:15,92,58,34,0,0,0
2019-04-03 10:30,58,27,31,0,0,0
2019-04-03 10:45,77,29,48,0,0,0
2019-04-03 11:00,68,37,31,0,0,0
2019-04-03 11:15,83,41,42,0,0,0
2019-04-03 11:30,92,39,53,0,0,0
2019-04-03 11:45,164,79,85,0,0,0
2019-04-03 12:00,151,65,86,0,0,0
2019-04-03 12:15,101,44,57,0,0,0
2019-04-03 12:30,128,71,57,0,0,0
2019-04-03 12:45,95,49,46,0,0,0
2019-04-03 13:00,138,57,81,0,0,0
2019-04-03 13:15,122,42,80,0,0,0
2019-04-03 13:30,117,55,62,0,0,0
2019-04-03 13:45,186,95,91,0,0,0
2019-04-03 14:00,173,81,92,0,0,0
2019-04-03 14:15,92,49,43,0,0,0
2019-04-03 14:30,103,57,46,0,0,0
2019-04-03 14:45,137,64,73,0,0,0
2019-04-03 15:00,130,73,57,0,0,0
2019-04-03 15:15,116,63,53,0,0,0
2019-04-03 15:30,157,81,76,0,0,0
2019-04-03 15:45,191,105,86,0,0,0
2019-04-03 16:00,192,129,63,0,0,0
2019-04-03 16:15,126,69,57,0,0,0
2019-04-03 16:30,122,74,48,0,0,0
2019-04-03 16:45,139,76,63,0,0,0
2019-04-03 17:00,124,62,62,0,0,0
2019-04-03 17:15,139,79,60,0,0,0
2019-04-03 17:30,144,80,64,0,0,0
2019-04-03 17:45,193,97,96,0,0,0
2019-04-03 18:00,102,29,73,0,0,0
2019-04-03 18:15,116,53,63,0,0,0
2019-04-03 18:30,87,27,60,0,0,0
2019-04-03 18:45,88,42,46,0,0,0
2019-04-03 19:00,98,48,50,0,0,0
2019-04-03 19:15,85,42,43,0,0,0
2019-04-03 19:30,73,37,36,0,0,0
2019-04-03 19:45,87,33,54,0,0,0
2019-04-03 20:00,71,33,38,0,0,0
2019-04-03 20:15,58,23,35,0,0,0
2019-04-03 20:30,43,14,29,0,0,0
2019-04-03 20:45,46,17,29,0,0,0
2019-04-03 21:00,39,11,28,0,0,0
2019-04-03 21:15,30,13,17,0,0,0
2019-04-03 21:30,49,21,28,0,0,0
2019-04-03 21:45,39,19,20,0,0,0
2019-04-03 22:00,31,9,22,0,0,0
2019-04-03 22:15,30,12,18,0,0,0
2019-04-03 22:30,21,5,16,0,0,0
2019-04-03 22:45,12,2,10,0,0,0
2019-04-03 23:00,27,13,14,0,0,0
2019-04-03 23:15,23,14,9,0,0,0
2019-04-03 23:30,23,4,19,0,0,0
2019-04-03 23:45,26,22,4,0,0,0
2019-04-04 00:00,21,14,7,0,0,0
2019-04-04 00:15,19,6,13,0,0,0
2019-04-04 00:30,4,0,4,0,0,0
2019-04-04 00:45,13,6,7,0,0,0
2019-04-04 01:00,11,0,11,0,0,0
2019-04-04 01:15,10,1,9,0,0,0
2019-04-04 01:30,3,0,3,0,0,0
2019-04-04 01:45,2,2,0,0,0,0
2019-04-04 02:00,2,0,2,0,0,0
2019-04-04 02:15,7,0,7,0,0,0
2019-04-04 02:30,8,0,8,0,0,0
2019-04-04 02:45,10,1,9,0,0,0
2019-04-04 03:00,17,10,7,0,0,0
2019-04-04 03:15,7,1,6,0,0,0
2019-04-04 03:30,8,2,6,0,0,0
2019-04-04 03:45,13,6,7,0,0,0
2019-04-04 04:00,4,3,1,0,0,0
2019-04-04 04:15,7,4,3,0,0,0
2019-04-04 04:30,3,0,3,0,0,0
2019-04-04 04:45,8,0,8,0,0,0
2019-04-04 05:00,6,1,5,0,0,0
2019-04-04 05:15,11,4,7,0,0,0
2019-04-04 05:30,9,2,7,0,0,0
2019-04-04 05:45,11,2,9,0,0,0
2019-04-04 06:00,18,10,8,0,0,0
2019-04-04 06:15,11,5,6,0,0,0
2019-04-04 06:30,33,9,24,0,0,0
2019-04-04 06:45,48,21,27,0,0,0
2019-04-04 07:00,75,19,56,0,0,0
2019-04-04 07:15,97,48,49,0,0,0
2019-04-04 07:30,257,143,114,0,0,0
2019-04-04 07:45,257,101,156,0,0,0
2019-04-04 08:00,295,64,231,0,0,0
2019-04-04 08:15,163,66,97,0,0,0
2019-04-04 08:30,91,34,57,0,0,0
2019-04-04 08:45,137,51,86,0,0,0
2019-04-04 09:00,99,43,56,0,0,0
2019-04-04 09:15,88,51,37,0,0,0
2019-04-04 09:30,93,52,41,0,0,0
2019-04-04 09:45,179,68,111,0,0,0
2019-04-04 10:00,200,90,110,0,0,0
2019-04-04 10:15,58,35,23,0,0,0
2019-04-04 10:30,51,24,27,0,0,0
2019-04-04 10:45,73,39,34,0,0,0
2019-04-04 11:00,52,13,39,0,0,0
2019-04-04 11:15,66,35,31,0,0,0
2019-04-04 11:30,88,35,53,0,0,0
2019-04-04 11:45,162,74,88,0,0,0
2019-04-04 12:00,132,71,61,0,0,0
2019-04-04 12:15,99,46,53,0,0,0
2019-04-04 12:30,77,38,39,0,0,0
2019-04-04 12:45,141,81,60,0,0,0
2019-04-04 13:00,136,65,71,0,0,0
2019-04-04 13:15,116,33,83,0,0,0
2019-04-04 13:30,141,56,85,0,0,0
2019-04-04 13:45,174,87,87,0,0,0
2019-04-04 14:00,173,68,105,0,0,0
2019-04-04 14:15,95,43,52,0,0,0
2019-04-04 14:30,99,54,45,0,0,0
2019-04-04 14:45,102,50,52,0,0,0
2019-04-04 15:00,107,58,49,0,0,0
2019-04-04 15:15,114,73,41,0,0,0
2019-04-04 15:30,147,91,56,0,0,0
2019-04-04 15:45,166,81,85,0,0,0
2019-04-04 16:00,160,91,69,0,0,0
2019-04-04 16:15,136,78,58,0,0,0
2019-04-04 16:30,122,78,44,0,0,0
2019-04-04 16:45,143,89,54,0,0,0
2019-04-04 17:00,132,86,46,0,0,0
2019-04-04 17:15,117,61,56,0,0,0
2019-04-04 17:30,128,69,59,0,0,0
2019-04-04 17:45,138,67,71,0,0,0
2019-04-04 18:00,113,62,51,0,0,0
2019-04-04 18:15,84,36,48,0,0,0
2019-04-04 18:30,69,31,38,0,0,0
2019-04-04 18:45,82,39,43,0,0,0
2019-04-04 19:00,80,37,43,0,0,0
2019-04-04 19:15,58,32,26,0,0,0
2019-04-04 19:30,73,27,46,0,0,0
2019-04-04 19:45,71,34,37,0,0,0
2019-04-04 20:00,55,19,36,0,0,0
2019-04-04 20:15,45,14,31,0,0,0
2019-04-04 20:30,26,13,13,0,0,0
2019-04-04 20:45,40,20,20,0,0,0
2019-04-04 21:00,29,7,22,0,0,0
2019-04-04 21:15,38,10,28,0,0,0
2019-04-04 21:30,29,4,25,0,0,0
2019-04-04 21:45,28,6,22,0,0,0
2019-04-04 22:00,27,10,17,0,0,0
2019-04-04 22:15,24,4,20,0,0,0
2019-04-04 22:30,26,5,21,0,0,0
2019-04-04 22:45,12,4,8,0,0,0
2019-04-04 23:00,9,1,8,0,0,0
2019-04-04 23:15,12,5,7,0,0,0
2019-04-04 23:30,17,5,12,0,0,0
2019-04-04 23:45,4,1,3,0,0,0
2019-04-05 00:00,15,6,9,0,0,0
2019-04-05 00:15,6,5,1,0,0,0
2019-04-05 00:30,8,5,3,0,0,0
2019-04-05 00:45,6,3,3,0,0,0
2019-04-05 01:00,10,3,7,0,0,0
2019-04-05 01:15,1,1,0,0,0,0
2019-04-05 01:30,2,2,0,0,0,0
2019-04-05 01:45,0,0,0,0,0,0
2019-04-05 02:00,1,0,1,0,0,0
2019-04-05 02:15,4,3,1,0,0,0
2019-04-05 02:30,4,3,1,0,0,0
2019-04-05 02:45,1,0,1,0,0,0
2019-04-05 03:00,0,0,0,0,0,0
2019-04-05 03:15,0,0,0,0,0,0
2019-04-05 03:30,2,0,2,0,0,0
2019-04-05 03:45,0,0,0,0,0,0
2019-04-05 04:00,1,0,1,0,0,0
2019-04-05 04:15,2,1,1,0,0,0
2019-04-05 04:30,1,1,0,0,0,0
2019-04-05 04:45,2,1,1,0,0,0
2019-04-05 05:00,2,2,0,0,0,0
2019-04-05 05:15,4,1,3,0,0,0
2019-04-05 05:30,9,2,7,0,0,0
2019-04-05 05:45,9,1,8,0,0,0
2019-04-05 06:00,11,9,2,0,0,0
2019-04-05 06:15,21,9,12,0,0,0
2019-04-05 06:30,19,6,13,0,0,0
2019-04-05 06:45,50,18,32,0,0,0
2019-04-05 07:00,69,22,47,0,0,0
2019-04-05 07:15,95,55,40,0,0,0
2019-04-05 07:30,227,148,79,0,0,0
2019-04-05 07:45,279,110,169,0,0,0
2019-04-05 08:00,238,48,190,0,0,0
2019-04-05 08:15,137,43,94,0,0,0
2019-04-05 08:30,115,55,60,0,0,0
2019-04-05 08:45,126,57,69,0,0,0
2019-04-05 09:00,123,64,59,0,0,0
2019-04-05 09:15,74,42,32,0,0,0
2019-04-05 09:30,70,29,41,0,0,0
2019-04-05 09:45,176,74,102,0,0,0
2019-04-05 10:00,228,60,168,0,0,0
2019-04-05 10:15,95,58,37,0,0,0
2019-04-05 10:30,84,39,45,0,0,0
2019-04-05 10:45,77,39,38,0,0,0
2019-04-05 11:00,83,49,34,0,0,0
2019-04-05 11:15,79,27,52,0,0,0
2019-04-05 11:30,75,37,38,0,0,0
2019-04-05 11:45,205,139,66,0,0,0
2019-04-05 12:00,145,86,59,0,0,0
2019-04-05 12:15,133,70,63,0,0,0
2019-04-05 12:30,157,74,83,0,0,0
2019-04-05 12:45,117,65,52,0,0,0
2019-04-05 13:00,178,86,92,0,0,0
2019-04-05 13:15,146,67,79,0,0,0
2019-04-05 13:30,112,43,69,0,0,0
2019-04-05 13:45,145,74,71,0,0,0
2019-04-05 14:00,139,60,79,0,0,0
2019-04-05 14:15,85,43,42,0,0,0
2019-04-05 14:30,92,51,41,0,0,0
2019-04-05 14:45,111,50,61,0,0,0
2019-04-05 15:00,112,63,49,0,0,0
2019-04-05 15:15,108,59,49,0,0,0
2019-04-05 15:30,112,53,59,0,0,0
2019-04-05 15:45,140,88,52,0,0,0
2019-04-05 16:00,104,57,47,0,0,0
2019-04-05 16:15,82,40,42,0,0,0
2019-04-05 16:30,93,57,36,0,0,0
2019-04-05 16:45,102,58,44,0,0,0
2019-04-05 17:00,87,45,42,0,0,0
2019-04-05 17:15,99,55,44,0,0,0
2019-04-05 17:30,75,40,35,0,0,0
2019-04-05 17:45,94,41,53,0,0,0
2019-04-05 18:00,81,44,37,0,0,0
2019-04-05 18:15,84,34,50,0,0,0
2019-04-05 18:30,66,31,35,0,0,0
2019-04-05 18:45,83,51,32,0,0,0
2019-04-05 19:00,70,37,33,0,0,0
2019-04-05 19:15,73,38,35,0,0,0
2019-04-05 19:30,55,15,40,0,0,0
2019-04-05 19:45,60,24,36,0,0,0
2019-04-05 20:00,67,27,40,0,0,0
2019-04-05 20:15,56,27,29,0,0,0
2019-04-05 20:30,44,24,20,0,0,0
2019-04-05 20:45,50,22,28,0,0,0
2019-04-05 21:00,52,27,25,0,0,0
2019-04-05 21:15,46,13,33,0,0,0
2019-04-05 21:30,42,17,25,0,0,0
2019-04-05 21:45,37,23,14,0,0,0
2019-04-05 22:00,32,8,24,0,0,0
2019-04-05 22:15,33,5,28,0,0,0
2019-04-05 22:30,19,1,18,0,0,0
2019-04-05 22:45,22,5,17,0,0,0
2019-04-05 23:00,23,4,19,0,0,0
2019-04-05 23:15,24,6,18,0,0,0
2019-04-05 23:30,25,9,16,0,0,0
2019-04-05 23:45,25,7,18,0,0,0
2019-04-06 00:00,20,7,13,0,0,0
2019-04-06 00:15,11,0,11,0,0,0
2019-04-06 00:30,17,4,13,0,0,0
2019-04-06 00:45,9,2,7,0,0,0
2019-04-06 01:00,16,10,6,0,0,0
2019-04-06 01:15,11,6,5,0,0,0
2019-04-06 01:30,12,7,5,0,0,0
2019-04-06 01:45,10,0,10,0,0,0
2019-04-06 02:00,19,7,12,0,0,0
2019-04-06 02:15,6,1,5,0,0,0
2019-04-06 02:30,8,1,7,0,0,0
2019-04-06 02:45,12,4,8,0,0,0
2019-04-06 03:00,7,2,5,0,0,0
2019-04-06 03:15,6,2,4,0,0,0
2019-04-06 03:30,4,0,4,0,0,0
2019-04-06 03:45,10,6,4,0,0,0
2019-04-06 04:00,2,0,2,0,0,0
2019-04-06 04:15,5,0,5,0,0,0
2019-04-06 04:30,11,5,6,0,0,0
2019-04-06 04:45,3,0,3,0,0,0
2019-04-06 05:00,4,1,3,0,0,0
2019-04-06 05:15,5,1,4,0,0,0
2019-04-06 05:30,5,0,5,0,0,0
2019-04-06 05:45,9,3,6,0,0,0
2019-04-06 06:00,5,4,1,0,0,0
2019-04-06 06:15,5,5,0,0,0,0
2019-04-06 06:30,8,2,6,0,0,0
2019-04-06 06:45,7,6,1,0,0,0
2019-04-06 07:00,15,11,4,0,0,0
2019-04-06 07:15,11,5,6,0,0,0
2019-04-06 07:30,11,9,2,0,0,0
2019-04-06 07:45,32,15,17,0,0,0
2019-04-06 08:00,13,6,7,0,0,0
2019-04-06 08:15,28,13,15,0,0,0
2019-04-06 08:30,25,12,13,0,0,0
2019-04-06 08:45,54,32,22,0,0,0
2019-04-06 09:00,42,29,13,0,0,0
2019-04-06 09:15,55,40,15,0,0,0
2019-04-06 09:30,31,17,14,0,0,0
2019-04-06 09:45,57,40,17,0,0,0
2019-04-06 10:00,64,49,15,0,0,0
2019-04-06 10:15,61,48,13,0,0,0
2019-04-06 10:30,75,62,13,0,0,0
2019-04-06 10:45,94,65,29,0,0,0
2019-04-06 11:00,87,54,33,0,0,0
2019-04-06 11:15,92,66,26,0,0,0
2019-04-06 11:30,78,50,28,0,0,0
2019-04-06 11:45,118,76,42,0,0,0
2019-04-06 12:00,99,53,46,0,0,0
2019-04-06 12:15,97,52,45,0,0,0
2019-04-06 12:30,90,47,43,0,0,0
2019-04-06 12:45,121,71,50,0,0,0
2019-04-06 13:00,102,67,35,0,0,0
2019-04-06 13:15,102,49,53,0,0,0
2019-04-06 13:30,128,70,58,0,0,0
2019-04-06 13:45,115,49,66,0,0,0
2019-04-06 14:00,120,62,58,0,0,0
2019-04-06 14:15,104,43,61,0,0,0
2019-04-06 14:30,121,43,78,0,0,0
2019-04-06 14:45,114,42,72,0,0,0
2019-04-06 15:00,107,40,67,0,0,0
2019-04-06 15:15,90,35,55,0,0,0
2019-04-06 15:30,89,41,48,0,0,0
2019-04-06 15:45,82,41,41,0,0,0
2019-04-06 16:00,91,37,54,0,0,0
2019-04-06 16:15,77,33,44,0,0,0
2019-04-06 16:30,55,18,37,0,0,0
2019-04-06 16:45,96,47,49,0,0,0
2019-04-06 17:00,82,33,49,0,0,0
2019-04-06 17:15,88,37,51,0,0,0
2019-04-06 17:30,95,34,61,0,0,0
2019-04-06 17:45,103,37,66,0,0,0
2019-04-06 18:00,87,38,49,0,0,0
2019-04-06 18:15,81,33,48,0,0,0
2019-04-06 18:30,83,38,45,0,0,0
2019-04-06 18:45,82,56,26,0,0,0
2019-04-06 19:00,95,44,51,0,0,0
2019-04-06 19:15,85,53,32,0,0,0
2019-04-06 19:30,88,53,35,0,0,0
2019-04-06 19:45,65,35,30,0,0,0
2019-04-06 20:00,77,30,47,0,0,0
2019-04-06 20:15,90,39,51,0,0,0
2019-04-06 20:30,65,28,37,0,0,0
2019-04-06 20:45,67,30,37,0,0,0
2019-04-06 21:00,60,24,36,0,0,0
2019-04-06 21:15,67,28,39,0,0,0
2019-04-06 21:30,41,12,29,0,0,0
2019-04-06 21:45,69,13,56,0,0,0
2019-04-06 22:00,49,6,43,0,0,0
2019-04-06 22:15,52,18,34,0,0,0
2019-04-06 22:30,55,17,38,0,0,0
2019-04-06 22:45,36,2,34,0,0,0
2019-04-06 23:00,21,2,19,0,0,0
2019-04-06 23:15,25,5,20,0,0,0
2019-04-06 23:30,29,8,21,0,0,0
2019-04-06 23:45,28,5,23,0,0,0
2019-04-07 00:00,12,5,7,0,0,0
2019-04-07 00:15,22,5,17,0,0,0
2019-04-07 00:30,21,8,13,0,0,0
2019-04-07 00:45,24,10,14,0,0,0
2019-04-07 01:00,24,5,19,0,0,0
2019-04-07 01:15,17,3,14,0,0,0
2019-04-07 01:30,18,7,11,0,0,0
2019-04-07 01:45,17,1,16,0,0,0
2019-04-07 02:00,10,0,10,0,0,0
2019-04-07 02:15,9,2,7,0,0,0
2019-04-07 02:30,10,6,4,0,0,0
2019-04-07 02:45,10,2,8,0,0,0
2019-04-07 03:00,6,1,5,0,0,0
2019-04-07 03:15,14,10,4,0,0,0
2019-04-07 03:30,7,0,7,0,0,0
2019-04-07 03:45,8,1,7,0,0,0
2019-04-07 04:00,7,1,6,0,0,0
2019-04-07 04:15,3,1,2,0,0,0
2019-04-07 04:30,1,0,1,0,0,0
2019-04-07 04:45,6,0,6,0,0,0
2019-04-07 05:00,2,0,2,0,0,0
2019-04-07 05:15,3,0,3,0,0,0
2019-04-07 05:30,3,0,3,0,0,0
2019-04-07 05:45,5,0,5,0,0,0
2019-04-07 06:00,8,6,2,0,0,0
2019-04-07 06:15,4,4,0,0,0,0
2019-04-07 06:30,1,1,0,0,0,0
2019-04-07 06:45,6,1,5,0,0,0
2019-04-07 07:00,6,2,4,0,0,0
2019-04-07 07:15,4,3,1,0,0,0
2019-04-07 07:30,6,3,3,0,0,0
2019-04-07 07:45,8,3,5,0,0,0
2019-04-07 08:00,8,4,4,0,0,0
2019-04-07 08:15,13,7,6,0,0,0
2019-04-07 08:30,13,8,5,0,0,0
2019-04-07 08:45,14,9,5,0,0,0
2019-04-07 09:00,14,6,8,0,0,0
2019-04-07 09:15,17,11,6,0,0,0
2019-04-07 09:30,34,17,17,0,0,0
2019-04-07 09:45,53,40,13,0,0,0
2019-04-07 10:00,25,18,7,0,0,0
2019-04-07 10:15,22,12,10,0,0,0
2019-04-07 10:30,31,11,20,0,0,0
2019-04-07 10:45,63,33,30,0,0,0
2019-04-07 11:00,27,15,12,0,0,0
2019-04-07 11:15,31,15,16,0,0,0
2019-04-07 11:30,43,28,15,0,0,0
2019-04-07 11:45,68,43,25,0,0,0
2019-04-07 12:00,27,15,12,0,0,0
2019-04-07 12:15,60,28,32,0,0,0
2019-04-07 12:30,71,30,41,0,0,0
2019-04-07 12:45,70,22,48,0,0,0
2019-04-07 13:00,57,27,30,0,0,0
2019-04-07 13:15,63,23,40,0,0,0
2019-04-07 13:30,78,38,40,0,0,0
2019-04-07 13:45,87,30,57,0,0,0
2019-04-07 14:00,61,18,43,0,0,0
2019-04-07 14:15,64,40,24,0,0,0
2019-04-07 14:30,88,31,57,0,0,0
2019-04-07 14:45,94,47,47,0,0,0
2019-04-07 15:00,78,38,40,0,0,0
2019-04-07 15:15,121,67,54,0,0,0
2019-04-07 15:30,79,43,36,0,0,0
2019-04-07 15:45,122,64,58,0,0,0
2019-04-07 16:00,74,30,44,0,0,0
2019-04-07 16:15,52,21,31,0,0,0
2019-04-07 16:30,59,16,43,0,0,0
2019-04-07 16:45,80,21,59,0,0,0
2019-04-07 17:00,69,29,40,0,0,0
2019-04-07 17:15,79,32,47,0,0,0
2019-04-07 17:30,91,44,47,0,0,0
2019-04-07 17:45,96,52,44,0,0,0
2019-04-07 18:00,80,26,54,0,0,0
2019-04-07 18:15,93,43,50,0,0,0
2019-04-07 18:30,85,26,59,0,0,0
2019-04-07 18:45,77,26,51,0,0,0
2019-04-07 19:00,69,27,42,0,0,0
2019-04-07 19:15,58,26,32,0,0,0
2019-04-07 19:30,55,23,32,0,0,0
2019-04-07 19:45,89,35,54,0,0,0
2019-04-07 20:00,107,52,55,0,0,0
2019-04-07 20:15,52,17,35,0,0,0
2019-04-07 20:30,34,6,28,0,0,0
2019-04-07 20:45,49,25,24,0,0,0
2019-04-07 21:00,51,9,42,0,0,0
2019-04-07 21:15,38,13,25,0,0,0
2019-04-07 21:30,23,8,15,0,0,0
2019-04-07 21:45,40,6,34,0,0,0
2019-04-07 22:00,28,7,21,0,0,0
2019-04-07 22:15,28,7,21,0,0,0
2019-04-07 22:30,15,2,13,0,0,0
2019-04-07 22:45,17,6,11,0,0,0
2019-04-07 23:00,15,3,12,0,0,0
2019-04-07 23:15,5,1,4,0,0,0
2019-04-07 23:30,3,1,2,0,0,0
2019-04-07 23:45,6,1,5,0,0,0
2019-04-08 00:00,7,3,4,0,0,0
2019-04-08 00:15,6,3,3,0,0,0
2019-04-08 00:30,7,0,7,0,0,0
2019-04-08 00:45,4,0,4,0,0,0
2019-04-08 01:00,0,0,0,0,0,0
2019-04-08 01:15,0,0,0,0,0,0
2019-04-08 01:30,1,0,1,0,0,0
2019-04-08 01:45,1,1,0,0,0,0
2019-04-08 02:00,0,0,0,0,0,0
2019-04-08 02:15,1,0,1,0,0,0
2019-04-08 02:30,1,0,1,0,0,0
2019-04-08 02:45,0,0,0,0,0,0
2019-04-08 03:00,2,1,1,0,0,0
2019-04-08 03:15,2,0,2,0,0,0
2019-04-08 03:30,0,0,0,0,0,0
2019-04-08 03:45,1,1,0,0,0,0
2019-04-08 04:00,0,0,0,0,0,0
2019-04-08 04:15,0,0,0,0,0,0
2019-04-08 04:30,1,0,1,0,0,0
2019-04-08 04:45,2,0,2,0,0,0
2019-04-08 05:00,0,0,0,0,0,0
2019-04-08 05:15,4,3,1,0,0,0
2019-04-08 05:30,13,2,11,0,0,0
2019-04-08 05:45,17,7,10,0,0,0
2019-04-08 06:00,12,4,8,0,0,0
2019-04-08 06:15,29,14,15,0,0,0
2019-04-08 06:30,43,16,27,0,0,0
2019-04-08 06:45,59,23,36,0,0,0
2019-04-08 07:00,94,34,60,0,0,0
2019-04-08 07:15,143,77,66,0,0,0
2019-04-08 07:30,277,185,92,0,0,0
2019-04-08 07:45,262,108,154,0,0,0
2019-04-08 08:00,303,77,226,0,0,0
2019-04-08 08:15,169,55,114,0,0,0
2019-04-08 08:30,139,47,92,0,0,0
2019-04-08 08:45,184,66,118,0,0,0
2019-04-08 09:00,200,90,110,0,0,0
2019-04-08 09:15,125,71,54,0,0,0
2019-04-08 09:30,131,54,77,0,0,0
2019-04-08 09:45,227,96,131,0,0,0
2019-04-08 10:00,235,87,148,0,0,0
2019-04-08 10:15,125,54,71,0,0,0
2019-04-08 10:30,73,26,47,0,0,0
2019-04-08 10:45,80,40,40,0,0,0
2019-04-08 11:00,88,38,50,0,0,0
2019-04-08 11:15,109,58,51,0,0,0
2019-04-08 11:30,137,68,69,0,0,0
2019-04-08 11:45,263,129,134,0,0,0
2019-04-08 12:00,223,133,90,0,0,0
2019-04-08 12:15,159,77,82,0,0,0
2019-04-08 12:30,169,84,85,0,0,0
2019-04-08 12:45,124,66,58,0,0,0
2019-04-08 13:00,189,82,107,0,0,0
2019-04-08 13:15,185,60,125,0,0,0
2019-04-08 13:30,138,62,76,0,0,0
2019-04-08 13:45,271,134,137,0,0,0
2019-04-08 14:00,269,123,146,0,0,0
2019-04-08 14:15,131,78,53,0,0,0
2019-04-08 14:30,161,92,69,0,0,0
2019-04-08 14:45,170,82,88,0,0,0
2019-04-08 15:00,156,91,65,0,0,0
2019-04-08 15:15,150,61,89,0,0,0
2019-04-08 15:30,178,88,90,0,0,0
2019-04-08 15:45,306,157,149,0,0,0
2019-04-08 16:00,246,145,101,0,0,0
2019-04-08 16:15,184,114,70,0,0,0
2019-04-08 16:30,171,109,62,0,0,0
2019-04-08 16:45,159,81,78,0,0,0
2019-04-08 17:00,202,115,87,0,0,0
2019-04-08 17:15,184,106,78,0,0,0
2019-04-08 17:30,233,142,91,0,0,0
2019-04-08 17:45,305,171,134,0,0,0
2019-04-08 18:00,207,93,114,0,0,0
2019-04-08 18:15,149,68,81,0,0,0
2019-04-08 18:30,139,62,77,0,0,0
2019-04-08 18:45,127,58,69,0,0,0
2019-04-08 19:00,119,38,81,0,0,0
2019-04-08 19:15,117,46,71,0,0,0
2019-04-08 19:30,97,37,60,0,0,0
2019-04-08 19:45,136,60,76,0,0,0
2019-04-08 20:00,103,23,80,0,0,0
2019-04-08 20:15,110,35,75,0,0,0
2019-04-08 20:30,68,21,47,0,0,0
2019-04-08 20:45,56,16,40,0,0,0
2019-04-08 21:00,48,13,35,0,0,0
2019-04-08 21:15,57,18,39,0,0,0
2019-04-08 21:30,81,46,35,0,0,0
2019-04-08 21:45,47,13,34,0,0,0
2019-04-08 22:00,51,18,33,0,0,0
2019-04-08 22:15,33,21,12,0,0,0
2019-04-08 22:30,33,10,23,0,0,0
2019-04-08 22:45,29,9,20,0,0,0
2019-04-08 23:00,20,10,10,0,0,0
2019-04-08 23:15,19,11,8,0,0,0
2019-04-08 23:30,21,13,8,0,0,0
2019-04-08 23:45,23,7,16,0,0,0
2019-04-09 00:00,12,3,9,0,0,0
2019-04-09 00:15,10,1,9,0,0,0
2019-04-09 00:30,7,1,6,0,0,0
2019-04-09 00:45,9,0,9,0,0,0
2019-04-09 01:00,5,1,4,0,0,0
2019-04-09 01:15,5,1,4,0,0,0
2019-04-09 01:30,11,5,6,0,0,0
2019-04-09 01:45,1,0,1,0,0,0
2019-04-09 02:00,2,1,1,0,0,0
2019-04-09 02:15,1,0,1,0,0,0
2019-04-09 02:30,3,2,1,0,0,0
2019-04-09 02:45,1,1,0,0,0,0
2019-04-09 03:00,0,0,0,0,0,0
2019-04-09 03:15,0,0,0,0,0,0
2019-04-09 03:30,0,0,0,0,0,0
2019-04-09 03:45,0,0,0,0,0,0
2019-04-09 04:00,0,0,0,0,0,0
2019-04-09 04:15,1,0,1,0,0,0
2019-04-09 04:30,1,1,0,0,0,0
2019-04-09 04:45,4,2,2,0,0,0
2019-04-09 05:00,0,0,0,0,0,0
2019-04-09 05:15,5,4,1,0,0,0
2019-04-09 05:30,15,4,11,0,0,0
2019-04-09 05:45,15,5,10,0,0,0
2019-04-09 06:00,9,4,5,0,0,0
2019-04-09 06:15,21,11,10,0,0,0
2019-04-09 06:30,33,11,22,0,0,0
2019-04-09 06:45,61,18,43,0,0,0
2019-04-09 07:00,89,28,61,0,0,0
2019-04-09 07:15,132,65,67,0,0,0
2019-04-09 07:30,317,197,120,0,0,0
2019-04-09 07:45,326,139,187,0,0,0
2019-04-09 08:00,400,111,289,0,0,0
2019-04-09 08:15,212,81,131,0,0,0
2019-04-09 08:30,147,69,78,0,0,0
2019-04-09 08:45,177,81,96,0,0,0
2019-04-09 09:00,247,78,169,0,0,0
2019-04-09 09:15,131,49,82,0,0,0
2019-04-09 09:30,139,54,85,0,0,0
2019-04-09 09:45,279,123,156,0,0,0
2019-04-09 10:00,312,135,177,0,0,0
2019-04-09 10:15,100,45,55,0,0,0
2019-04-09 10:30,66,29,37,0,0,0
2019-04-09 10:45,80,35,45,0,0,0
2019-04-09 11:00,117,40,77,0,0,0
2019-04-09 11:15,111,54,57,0,0,0
2019-04-09 11:30,133,64,69,0,0,0
2019-04-09 11:45,328,198,130,0,0,0
2019-04-09 12:00,243,143,100,0,0,0
2019-04-09 12:15,134,56,78,0,0,0
2019-04-09 12:30,143,80,63,0,0,0
2019-04-09 12:45,144,64,80,0,0,0
2019-04-09 13:00,169,66,103,0,0,0
2019-04-09 13:15,171,73,98,0,0,0
2019-04-09 13:30,159,82,77,0,0,0
2019-04-09 13:45,335,167,168,0,0,0
2019-04-09 14:00,218,98,120,0,0,0
2019-04-09 14:15,134,62,72,0,0,0
2019-04-09 14:30,145,67,78,0,0,0
2019-04-09 14:45,132,65,67,0,0,0
2019-04-09 15:00,118,48,70,0,0,0
2019-04-09 15:15,144,77,67,0,0,0
2019-04-09 15:30,183,99,84,0,0,0
2019-04-09 15:45,325,198,127,0,0,0
2019-04-09 16:00,249,156,93,0,0,0
2019-04-09 16:15,162,94,68,0,0,0
2019-04-09 16:30,149,77,72,0,0,0
2019-04-09 16:45,168,80,88,0,0,0
2019-04-09 17:00,190,103,87,0,0,0
2019-04-09 17:15,162,95,67,0,0,0
2019-04-09 17:30,178,93,85,0,0,0
2019-04-09 17:45,256,131,125,0,0,0
2019-04-09 18:00,215,117,98,0,0,0
2019-04-09 18:15,147,63,84,0,0,0
2019-04-09 18:30,115,54,61,0,0,0
2019-04-09 18:45,155,65,90,0,0,0
2019-04-09 19:00,118,53,65,0,0,0
2019-04-09 19:15,122,59,63,0,0,0
2019-04-09 19:30,111,43,68,0,0,0
2019-04-09 19:45,158,56,102,0,0,0
2019-04-09 20:00,115,37,78,0,0,0
2019-04-09 20:15,90,38,52,0,0,0
2019-04-09 20:30,64,26,38,0,0,0
2019-04-09 20:45,53,17,36,0,0,0
2019-04-09 21:00,58,28,30,0,0,0
2019-04-09 21:15,46,23,23,0,0,0
2019-04-09 21:30,38,12,26,0,0,0
2019-04-09 21:45,34,14,20,0,0,0
2019-04-09 22:00,47,14,33,0,0,0
2019-04-09 22:15,58,23,35,0,0,0
2019-04-09 22:30,33,5,28,0,0,0
2019-04-09 22:45,39,8,31,0,0,0
2019-04-09 23:00,29,4,25,0,0,0
2019-04-09 23:15,18,6,12,0,0,0
2019-04-09 23:30,14,10,4,0,0,0
2019-04-09 23:45,23,14,9,0,0,0
2019-04-10 00:00,10,4,6,0,0,0
2019-04-10 00:15,20,15,5,0,0,0
2019-04-10 00:30,22,16,6,0,0,0
2019-04-10 00:45,17,13,4,0,0,0
2019-04-10 01:00,4,0,4,0,0,0
2019-04-10 01:15,6,1,5,0,0,0
2019-04-10 01:30,3,1,2,0,0,0
2019-04-10 01:45,2,0,2,0,0,0
2019-04-10 02:00,2,0,2,0,0,0
2019-04-10 02:15,12,1,11,0,0,0
2019-04-10 02:30,5,0,5,0,0,0
2019-04-10 02:45,12,0,12,0,0,0
2019-04-10 03:00,3,0,3,0,0,0
2019-04-10 03:15,5,0,5,0,0,0
2019-04-10 03:30,17,0,17,0,0,0
2019-04-10 03:45,10,0,10,0,0,0
2019-04-10 04:00,9,0,9,0,0,0
2019-04-10 04:15,17,1,16,0,0,0
2019-04-10 04:30,8,1,7,0,0,0
2019-04-10 04:45,6,1,5,0,0,0
2019-04-10 05:00,4,0,4,0,0,0
2019-04-10 05:15,2,1,1,0,0,0
2019-04-10 05:30,10,1,9,0,0,0
2019-04-10 05:45,8,1,7,0,0,0
2019-04-10 06:00,12,6,6,0,0,0
2019-04-10 06:15,19,10,9,0,0,0
2019-04-10 06:30,38,6,32,0,0,0
2019-04-10 06:45,60,23,37,0,0,0
2019-04-10 07:00,87,30,57,0,0,0
2019-04-10 07:15,177,113,64,0,0,0
2019-04-10 07:30,289,180,109,0,0,0
2019-04-10 07:45,351,157,194,0,0,0
2019-04-10 08:00,334,98,236,0,0,0
2019-04-10 08:15,170,58,112,0,0,0
2019-04-10 08:30,153,69,84,0,0,0
2019-04-10 08:45,190,81,109,0,0,0
2019-04-10 09:00,148,52,96,0,0,0
2019-04-10 09:15,112,65,47,0,0,0
2019-04-10 09:30,142,66,76,0,0,0
2019-04-10 09:45,317,97,220,0,0,0
2019-04-10 10:00,329,136,193,0,0,0
2019-04-10 10:15,101,59,42,0,0,0
2019-04-10 10:30,80,35,45,0,0,0
2019-04-10 10:45,91,45,46,0,0,0
2019-04-10 11:00,94,35,59,0,0,0
2019-04-10 11:15,118,59,59,0,0,0
2019-04-10 11:30,142,76,66,0,0,0
2019-04-10 11:45,320,128,192,0,0,0
2019-04-10 12:00,239,115,124,0,0,0
2019-04-10 12:15,164,67,97,0,0,0
2019-04-10 12:30,142,56,86,0,0,0
2019-04-10 12:45,152,57,95,0,0,0
2019-04-10 13:00,169,89,80,0,0,0
2019-04-10 13:15,166,69,97,0,0,0
2019-04-10 13:30,142,70,72,0,0,0
2019-04-10 13:45,291,127,164,0,0,0
2019-04-10 14:00,249,92,157,0,0,0
2019-04-10 14:15,125,57,68,0,0,0
2019-04-10 14:30,127,64,63,0,0,0
2019-04-10 14:45,182,76,106,0,0,0
2019-04-10 15:00,137,72,65,0,0,0
2019-04-10 15:15,155,88,67,0,0,0
2019-04-10 15:30,186,88,98,0,0,0
2019-04-10 15:45,348,189,159,0,0,0
2019-04-10 16:00,263,143,120,0,0,0
2019-04-10 16:15,149,72,77,0,0,0
2019-04-10 16:30,159,74,85,0,0,0
2019-04-10 16:45,171,111,60,0,0,0
2019-04-10 17:00,158,82,76,0,0,0
2019-04-10 17:15,165,84,81,0,0,0
2019-04-10 17:30,197,105,92,0,0,0
2019-04-10 17:45,289,143,146,0,0,0
2019-04-10 18:00,180,84,96,0,0,0
2019-04-10 18:15,138,54,84,0,0,0
2019-04-10 18:30,118,47,71,0,0,0
2019-04-10 18:45,132,48,84,0,0,0
2019-04-10 19:00,106,51,55,0,0,0
2019-04-10 19:15,91,41,50,0,0,0
2019-04-10 19:30,112,30,82,0,0,0
2019-04-10 19:45,119,41,78,0,0,0
2019-04-10 20:00,111,52,59,0,0,0
2019-04-10 20:15,74,22,52,0,0,0
2019-04-10 20:30,69,24,45,0,0,0
2019-04-10 20:45,56,18,38,0,0,0
2019-04-10 21:00,68,28,40,0,0,0
2019-04-10 21:15,50,18,32,0,0,0
2019-04-10 21:30,36,13,23,0,0,0
2019-04-10 21:45,58,24,34,0,0,0
2019-04-10 22:00,40,8,32,0,0,0
2019-04-10 22:15,37,14,23,0,0,0
2019-04-10 22:30,46,10,36,0,0,0
2019-04-10 22:45,16,4,12,0,0,0
2019-04-10 23:00,31,12,19,0,0,0
2019-04-10 23:15,30,10,20,0,0,0
2019-04-10 23:30,16,10,6,0,0,0
2019-04-10 23:45,9,4,5,0,0,0
2019-04-11 00:00,37,19,18,0,0,0
2019-04-11 00:15,22,10,12,0,0,0
2019-04-11 00:30,16,12,4,0,0,0
2019-04-11 00:45,7,6,1,0,0,0
2019-04-11 01:00,3,0,3,0,0,0
2019-04-11 01:15,5,3,2,0,0,0
2019-04-11 01:30,6,0,6,0,0,0
2019-04-11 01:45,3,0,3,0,0,0
2019-04-11 02:00,5,0,5,0,0,0
2019-04-11 02:15,14,0,14,0,0,0
2019-04-11 02:30,4,2,2,0,0,0
2019-04-11 02:45,9,1,8,0,0,0
2019-04-11 03:00,3,0,3,0,0,0
2019-04-11 03:15,6,0,6,0,0,0
2019-04-11 03:30,3,0,3,0,0,0
2019-04-11 03:45,7,0,7,0,0,0
2019-04-11 04:00,3,0,3,0,0,0
2019-04-11 04:15,1,0,1,0,0,0
2019-04-11 04:30,5,1,4,0,0,0
2019-04-11 04:45,6,0,6,0,0,0
2019-04-11 05:00,1,1,0,0,0,0
2019-04-11 05:15,5,3,2,0,0,0
2019-04-11 05:30,10,2,8,0,0,0
2019-04-11 05:45,15,3,12,0,0,0
2019-04-11 06:00,11,5,6,0,0,0
2019-04-11 06:15,16,8,8,0,0,0
2019-04-11 06:30,41,10,31,0,0,0
2019-04-11 06:45,57,25,32,0,0,0
2019-04-11 07:00,67,17,50,0,0,0
2019-04-11 07:15,137,63,74,0,0,0
2019-04-11 07:30,233,96,137,0,0,0
2019-04-11 07:45,292,99,193,0,0,0
2019-04-11 08:00,352,97,255,0,0,0
2019-04-11 08:15,202,83,119,0,0,0
2019-04-11 08:30,177,99,78,0,0,0
2019-04-11 08:45,176,51,125,0,0,0
2019-04-11 09:00,164,60,104,0,0,0
2019-04-11 09:15,101,58,43,0,0,0
2019-04-11 09:30,132,63,69,0,0,0
2019-04-11 09:45,268,144,124,0,0,0
2019-04-11 10:00,266,137,129,0,0,0
2019-04-11 10:15,89,40,49,0,0,0
2019-04-11 10:30,85,37,48,0,0,0
2019-04-11 10:45,105,50,55,0,0,0
2019-04-11 11:00,85,36,49,0,0,0
2019-04-11 11:15,104,46,58,0,0,0
2019-04-11 11:30,148,69,79,0,0,0
2019-04-11 11:45,254,134,120,0,0,0
2019-04-11 12:00,232,119,113,0,0,0
2019-04-11 12:15,126,47,79,0,0,0
2019-04-11 12:30,101,40,61,0,0,0
2019-04-11 12:45,144,76,68,0,0,0
2019-04-11 13:00,157,63,94,0,0,0
2019-04-11 13:15,134,53,81,0,0,0
2019-04-11 13:30,160,71,89,0,0,0
2019-04-11 13:45,271,131,140,0,0,0
2019-04-11 14:00,203,93,110,0,0,0
2019-04-11 14:15,119,62,57,0,0,0
2019-04-11 14:30,131,72,59,0,0,0
2019-04-11 14:45,150,91,59,0,0,0
2019-04-11 15:00,168,88,80,0,0,0
2019-04-11 15:15,132,82,50,0,0,0
2019-04-11 15:30,185,80,105,0,0,0
2019-04-11 15:45,322,176,146,0,0,0
2019-04-11 16:00,238,129,109,0,0,0
2019-04-11 16:15,161,95,66,0,0,0
2019-04-11 16:30,150,78,72,0,0,0
2019-04-11 16:45,192,102,90,0,0,0
2019-04-11 17:00,184,107,77,0,0,0
2019-04-11 17:15,205,101,104,0,0,0
2019-04-11 17:30,146,76,70,0,0,0
2019-04-11 17:45,222,124,98,0,0,0
2019-04-11 18:00,168,85,83,0,0,0
2019-04-11 18:15,149,78,71,0,0,0
2019-04-11 18:30,91,38,53,0,0,0
2019-04-11 18:45,106,47,59,0,0,0
2019-04-11 19:00,110,50,60,0,0,0
2019-04-11 19:15,92,48,44,0,0,0
2019-04-11 19:30,84,34,50,0,0,0
2019-04-11 19:45,112,50,62,0,0,0
2019-04-11 20:00,83,35,48,0,0,0
2019-04-11 20:15,84,35,49,0,0,0
2019-04-11 20:30,35,7,28,0,0,0
2019-04-11 20:45,53,26,27,0,0,0
2019-04-11 21:00,47,12,35,0,0,0
2019-04-11 21:15,58,12,46,0,0,0
2019-04-11 21:30,32,7,25,0,0,0
2019-04-11 21:45,46,18,28,0,0,0
2019-04-11 22:00,45,9,36,0,0,0
2019-04-11 22:15,43,15,28,0,0,0
2019-04-11 22:30,34,8,26,0,0,0
2019-04-11 22:45,29,3,26,0,0,0
2019-04-11 23:00,21,4,17,0,0,0
2019-04-11 23:15,21,7,14,0,0,0
2019-04-11 23:30,22,7,15,0,0,0
2019-04-11 23:45,14,6,8,0,0,0
2019-04-12 00:00,12,2,10,0,0,0
2019-04-12 00:15,17,7,10,0,0,0
2019-04-12 00:30,10,4,6,0,0,0
2019-04-12 00:45,11,3,8,0,0,0
2019-04-12 01:00,15,3,12,0,0,0
2019-04-12 01:15,13,1,12,0,0,0
2019-04-12 01:30,4,0,4,0,0,0
2019-04-12 01:45,11,6,5,0,0,0
2019-04-12 02:00,12,3,9,0,0,0
2019-04-12 02:15,3,1,2,0,0,0
2019-04-12 02:30,4,2,2,0,0,0
2019-04-12 02:45,7,1,6,0,0,0
2019-04-12 03:00,12,3,9,0,0,0
2019-04-12 03:15,4,1,3,0,0,0
2019-04-12 03:30,5,3,2,0,0,0
2019-04-12 03:45,5,3,2,0,0,0
2019-04-12 04:00,3,2,1,0,0,0
2019-04-12 04:15,9,7,2,0,0,0
2019-04-12 04:30,1,0,1,0,0,0
2019-04-12 04:45,4,1,3,0,0,0
2019-04-12 05:00,1,0,1,0,0,0
2019-04-12 05:15,4,3,1,0,0,0
2019-04-12 05:30,10,6,4,0,0,0
2019-04-12 05:45,8,1,7,0,0,0
2019-04-12 06:00,5,2,3,0,0,0
2019-04-12 06:15,23,9,14,0,0,0
2019-04-12 06:30,34,13,21,0,0,0
2019-04-12 06:45,62,25,37,0,0,0
2019-04-12 07:00,105,57,48,0,0,0
2019-04-12 07:15,129,69,60,0,0,0
2019-04-12 07:30,184,101,83,0,0,0
2019-04-12 07:45,254,98,156,0,0,0
2019-04-12 08:00,308,71,237,0,0,0
2019-04-12 08:15,146,56,90,0,0,0
2019-04-12 08:30,129,58,71,0,0,0
2019-04-12 08:45,145,74,71,0,0,0
2019-04-12 09:00,110,41,69,0,0,0
2019-04-12 09:15,84,43,41,0,0,0
2019-04-12 09:30,105,48,57,0,0,0
2019-04-12 09:45,191,73,118,0,0,0
2019-04-12 10:00,275,83,192,0,0,0
2019-04-12 10:15,78,40,38,0,0,0
2019-04-12 10:30,90,52,38,0,0,0
2019-04-12 10:45,78,30,48,0,0,0
2019-04-12 11:00,123,64,59,0,0,0
2019-04-12 11:15,80,41,39,0,0,0
2019-04-12 11:30,111,61,50,0,0,0
2019-04-12 11:45,182,124,58,0,0,0
2019-04-12 12:00,170,114,56,0,0,0
2019-04-12 12:15,122,72,50,0,0,0
2019-04-12 12:30,143,63,80,0,0,0
2019-04-12 12:45,161,87,74,0,0,0
2019-04-12 13:00,162,52,110,0,0,0
2019-04-12 13:15,160,59,101,0,0,0
2019-04-12 13:30,116,50,66,0,0,0
2019-04-12 13:45,158,70,88,0,0,0
2019-04-12 14:00,116,56,60,0,0,0
2019-04-12 14:15,114,59,55,0,0,0
2019-04-12 14:30,122,52,70,0,0,0
2019-04-12 14:45,129,52,77,0,0,0
2019-04-12 15:00,113,56,57,0,0,0
2019-04-12 15:15,137,86,51,0,0,0
2019-04-12 15:30,137,76,61,0,0,0
2019-04-12 15:45,129,78,51,0,0,0
2019-04-12 16:00,112,57,55,0,0,0
2019-04-12 16:15,110,78,32,0,0,0
2019-04-12 16:30,109,58,51,0,0,0
2019-04-12 16:45,123,81,42,0,0,0
2019-04-12 17:00,98,47,51,0,0,0
2019-04-12 17:15,93,51,42,0,0,0
2019-04-12 17:30,111,43,68,0,0,0
2019-04-12 17:45,84,33,51,0,0,0
2019-04-12 18:00,88,37,51,0,0,0
2019-04-12 18:15,70,38,32,0,0,0
2019-04-12 18:30,62,27,35,0,0,0
2019-04-12 18:45,86,45,41,0,0,0
2019-04-12 19:00,60,31,29,0,0,0
2019-04-12 19:15,75,38,37,0,0,0
2019-04-12 19:30,61,28,33,0,0,0
2019-04-12 19:45,56,29,27,0,0,0
2019-04-12 20:00,57,21,36,0,0,0
2019-04-12 20:15,61,24,37,0,0,0
2019-04-12 20:30,43,24,19,0,0,0
2019-04-12 20:45,56,28,28,0,0,0
2019-04-12 21:00,44,24,20,0,0,0
2019-04-12 21:15,42,10,32,0,0,0
2019-04-12 21:30,23,6,17,0,0,0
2019-04-12 21:45,28,11,17,0,0,0
2019-04-12 22:00,38,3,35,0,0,0
2019-04-12 22:15,20,9,11,0,0,0
2019-04-12 22:30,32,16,16,0,0,0
2019-04-12 22:45,17,3,14,0,0,0
2019-04-12 23:00,21,3,18,0,0,0
2019-04-12 23:15,14,4,10,0,0,0
2019-04-12 23:30,15,5,10,0,0,0
2019-04-12 23:45,21,8,13,0,0,0
2019-04-13 00:00,19,8,11,0,0,0
2019-04-13 00:15,21,7,14,0,0,0
2019-04-13 00:30,9,3,6,0,0,0
2019-04-13 00:45,17,5,12,0,0,0
2019-04-13 01:00,19,6,13,0,0,0
2019-04-13 01:15,14,0,14,0,0,0
2019-04-13 01:30,6,1,5,0,0,0
2019-04-13 01:45,8,1,7,0,0,0
2019-04-13 02:00,4,0,4,0,0,0
2019-04-13 02:15,6,0,6,0,0,0
2019-04-13 02:30,12,7,5,0,0,0
2019-04-13 02:45,8,1,7,0,0,0
2019-04-13 03:00,18,7,11,0,0,0
2019-04-13 03:15,7,0,7,0,0,0
2019-04-13 03:30,9,5,4,0,0,0
2019-04-13 03:45,5,0,5,0,0,0
2019-04-13 04:00,5,3,2,0,0,0
2019-04-13 04:15,5,2,3,0,0,0
2019-04-13 04:30,2,0,2,0,0,0
2019-04-13 04:45,6,1,5,0,0,0
2019-04-13 05:00,1,0,1,0,0,0
2019-04-13 05:15,3,3,0,0,0,0
2019-04-13 05:30,9,3,6,0,0,0
2019-04-13 05:45,6,1,5,0,0,0
2019-04-13 06:00,7,4,3,0,0,0
2019-04-13 06:15,6,2,4,0,0,0
2019-04-13 06:30,12,4,8,0,0,0
2019-04-13 06:45,16,10,6,0,0,0
2019-04-13 07:00,5,5,0,0,0,0
2019-04-13 07:15,10,6,4,0,0,0
2019-04-13 07:30,13,7,6,0,0,0
2019-04-13 07:45,14,6,8,0,0,0
2019-04-13 08:00,33,13,20,0,0,0
2019-04-13 08:15,18,12,6,0,0,0
2019-04-13 08:30,16,8,8,0,0,0
2019-04-13 08:45,36,21,15,0,0,0
2019-04-13 09:00,24,13,11,0,0,0
2019-04-13 09:15,41,26,15,0,0,0
2019-04-13 09:30,39,30,9,0,0,0
2019-04-13 09:45,68,53,15,0,0,0
2019-04-13 10:00,39,35,4,0,0,0
2019-04-13 10:15,60,43,17,0,0,0
2019-04-13 10:30,60,41,19,0,0,0
2019-04-13 10:45,61,36,25,0,0,0
2019-04-13 11:00,70,35,35,0,0,0
2019-04-13 11:15,67,41,26,0,0,0
2019-04-13 11:30,79,48,31,0,0,0
2019-04-13 11:45,94,58,36,0,0,0
2019-04-13 12:00,78,36,42,0,0,0
2019-04-13 12:15,95,51,44,0,0,0
2019-04-13 12:30,76,30,46,0,0,0
2019-04-13 12:45,87,41,46,0,0,0
2019-04-13 13:00,67,29,38,0,0,0
2019-04-13 13:15,57,27,30,0,0,0
2019-04-13 13:30,64,28,36,0,0,0
2019-04-13 13:45,77,37,40,0,0,0
2019-04-13 14:00,80,25,55,0,0,0
2019-04-13 14:15,65,34,31,0,0,0
2019-04-13 14:30,71,27,44,0,0,0
2019-04-13 14:45,59,21,38,0,0,0
2019-04-13 15:00,34,12,22,0,0,0
2019-04-13 15:15,53,27,26,0,0,0
2019-04-13 15:30,44,17,27,0,0,0
2019-04-13 15:45,49,15,34,0,0,0
2019-04-13 16:00,46,19,27,0,0,0
2019-04-13 16:15,37,12,25,0,0,0
2019-04-13 16:30,48,15,33,0,0,0
2019-04-13 16:45,62,24,38,0,0,0
2019-04-13 17:00,43,21,22,0,0,0
2019-04-13 17:15,48,21,27,0,0,0
2019-04-13 17:30,49,19,30,0,0,0
2019-04-13 17:45,63,25,38,0,0,0
2019-04-13 18:00,26,6,20,0,0,0
2019-04-13 18:15,53,11,42,0,0,0
2019-04-13 18:30,49,30,19,0,0,0
2019-04-13 18:45,33,11,22,0,0,0
2019-04-13 19:00,43,8,35,0,0,0
2019-04-13 19:15,54,24,30,0,0,0
2019-04-13 19:30,22,6,16,0,0,0
2019-04-13 19:45,36,11,25,0,0,0
2019-04-13 20:00,44,17,27,0,0,0
2019-04-13 20:15,40,17,23,0,0,0
2019-04-13 20:30,21,15,6,0,0,0
2019-04-13 20:45,35,22,13,0,0,0
2019-04-13 21:00,36,21,15,0,0,0
2019-04-13 21:15,8,2,6,0,0,0
2019-04-13 21:30,23,11,12,0,0,0
2019-04-13 21:45,34,11,23,0,0,0
2019-04-13 22:00,22,10,12,0,0,0
2019-04-13 22:15,26,11,15,0,0,0
2019-04-13 22:30,24,11,13,0,0,0
2019-04-13 22:45,14,5,9,0,0,0
2019-04-13 23:00,19,6,13,0,0,0
2019-04-13 23:15,15,5,10,0,0,0
2019-04-13 23:30,11,5,6,0,0,0
2019-04-13 23:45,14,5,9,0,0,0
2019-04-14 00:00,17,4,13,0,0,0
2019-04-14 00:15,16,3,13,0,0,0
2019-04-14 00:30,33,15,18,0,0,0
2019-04-14 00:45,13,0,13,0,0,0
2019-04-14 01:00,10,5,5,0,0,0
2019-04-14 01:15,14,2,12,0,0,0
2019-04-14 01:30,18,6,12,0,0,0
2019-04-14 01:45,11,6,5,0,0,0
2019-04-14 02:00,8,4,4,0,0,0
2019-04-14 02:15,17,5,12,0,0,0
2019-04-14 02:30,12,3,9,0,0,0
2019-04-14 02:45,9,1,8,0,0,0
2019-04-14 03:00,14,5,9,0,0,0
2019-04-14 03:15,5,1,4,0,0,0
2019-04-14 03:30,4,0,4,0,0,0
2019-04-14 03:45,7,1,6,0,0,0
2019-04-14 04:00,5,3,2,0,0,0
2019-04-14 04:15,6,2,4,0,0,0
2019-04-14 04:30,7,3,4,0,0,0
2019-04-14 04:45,0,0,0,0,0,0
2019-04-14 05:00,4,0,4,0,0,0
2019-04-14 05:15,2,0,2,0,0,0
2019-04-14 05:30,4,0,4,0,0,0
2019-04-14 05:45,8,0,8,0,0,0
2019-04-14 06:00,0,0,0,0,0,0
2019-04-14 06:15,7,3,4,0,0,0
2019-04-14 06:30,10,5,5,0,0,0
2019-04-14 06:45,5,2,3,0,0,0
2019-04-14 07:00,4,4,0,0,0,0
2019-04-14 07:15,3,2,1,0,0,0
2019-04-14 07:30,4,0,4,0,0,0
2019-04-14 07:45,4,1,3,0,0,0
2019-04-14 08:00,3,3,0,0,0,0
2019-04-14 08:15,13,8,5,0,0,0
2019-04-14 08:30,7,1,6,0,0,0
2019-04-14 08:45,20,12,8,0,0,0
2019-04-14 09:00,13,3,10,0,0,0
2019-04-14 09:15,17,11,6,0,0,0
2019-04-14 09:30,17,9,8,0,0,0
2019-04-14 09:45,43,29,14,0,0,0
2019-04-14 10:00,23,14,9,0,0,0
2019-04-14 10:15,14,7,7,0,0,0
2019-04-14 10:30,20,11,9,0,0,0
2019-04-14 10:45,37,23,14,0,0,0
2019-04-14 11:00,20,10,10,0,0,0
2019-04-14 11:15,27,12,15,0,0,0
2019-04-14 11:30,43,15,28,0,0,0
2019-04-14 11:45,53,11,42,0,0,0
2019-04-14 12:00,38,22,16,0,0,0
2019-04-14 12:15,49,22,27,0,0,0
2019-04-14 12:30,55,12,43,0,0,0
2019-04-14 12:45,51,14,37,0,0,0
2019-04-14 13:00,62,17,45,0,0,0
2019-04-14 13:15,41,13,28,0,0,0
2019-04-14 13:30,48,16,32,0,0,0
2019-04-14 13:45,50,28,22,0,0,0
2019-04-14 14:00,69,38,31,0,0,0
2019-04-14 14:15,45,27,18,0,0,0
2019-04-14 14:30,54,27,27,0,0,0
2019-04-14 14:45,59,39,20,0,0,0
2019-04-14 15:00,38,28,10,0,0,0
2019-04-14 15:15,49,11,38,0,0,0
2019-04-14 15:30,32,17,15,0,0,0
2019-04-14 15:45,56,28,28,0,0,0
2019-04-14 16:00,42,17,25,0,0,0
2019-04-14 16:15,38,17,21,0,0,0
2019-04-14 16:30,52,24,28,0,0,0
2019-04-14 16:45,73,41,32,0,0,0
2019-04-14 17:00,38,13,25,0,0,0
2019-04-14 17:15,40,11,29,0,0,0
2019-04-14 17:30,38,23,15,0,0,0
2019-04-14 17:45,49,23,26,0,0,0
2019-04-14 18:00,56,32,24,0,0,0
2019-04-14 18:15,33,16,17,0,0,0
2019-04-14 18:30,18,5,13,0,0,0
2019-04-14 18:45,37,18,19,0,0,0
2019-04-14 19:00,40,10,30,0,0,0
2019-04-14 19:15,31,10,21,0,0,0
2019-04-14 19:30,23,3,20,0,0,0
2019-04-14 19:45,31,17,14,0,0,0
2019-04-14 20:00,27,9,18,0,0,0
2019-04-14 20:15,23,11,12,0,0,0
2019-04-14 20:30,28,12,16,0,0,0
2019-04-14 20:45,25,13,12,0,0,0
2019-04-14 21:00,29,9,20,0,0,0
2019-04-14 21:15,18,5,13,0,0,0
2019-04-14 21:30,13,6,7,0,0,0
2019-04-14 21:45,18,7,11,0,0,0
2019-04-14 22:00,9,5,4,0,0,0
2019-04-14 22:15,15,4,11,0,0,0
2019-04-14 22:30,13,5,8,0,0,0
2019-04-14 22:45,11,3,8,0,0,0
2019-04-14 23:00,18,5,13,0,0,0
2019-04-14 23:15,11,6,5,0,0,0
2019-04-14 23:30,6,3,3,0,0,0
2019-04-14 23:45,8,1,7,0,0,0
2019-04-15 00:00,5,1,4,0,0,0
2019-04-15 00:15,0,0,0,0,0,0
2019-04-15 00:30,13,7,6,0,0,0
2019-04-15 00:45,5,0,5,0,0,0
2019-04-15 01:00,2,0,2,0,0,0
2019-04-15 01:15,5,2,3,0,0,0
2019-04-15 01:30,0,0,0,0,0,0
2019-04-15 01:45,1,0,1,0,0,0
2019-04-15 02:00,0,0,0,0,0,0
2019-04-15 02:15,3,0,3,0,0,0
2019-04-15 02:30,0,0,0,0,0,0
2019-04-15 02:45,2,0,2,0,0,0
2019-04-15 03:00,1,0,1,0,0,0
2019-04-15 03:15,0,0,0,0,0,0
2019-04-15 03:30,0,0,0,0,0,0
2019-04-15 03:45,0,0,0,0,0,0
2019-04-15 04:00,1,0,1,0,0,0
2019-04-15 04:15,0,0,0,0,0,0
2019-04-15 04:30,1,1,0,0,0,0
2019-04-15 04:45,2,0,2,0,0,0
2019-04-15 05:00,0,0,0,0,0,0
2019-04-15 05:15,1,0,1,0,0,0
2019-04-15 05:30,12,5,7,0,0,0
2019-04-15 05:45,8,1,7,0,0,0
2019-04-15 06:00,14,6,8,0,0,0
2019-04-15 06:15,26,6,20,0,0,0
2019-04-15 06:30,39,11,28,0,0,0
2019-04-15 06:45,48,19,29,0,0,0
2019-04-15 07:00,75,23,52,0,0,0
2019-04-15 07:15,72,23,49,0,0,0
2019-04-15 07:30,119,31,88,0,0,0
2019-04-15 07:45,191,56,135,0,0,0
2019-04-15 08:00,236,50,186,0,0,0
2019-04-15 08:15,147,48,99,0,0,0
2019-04-15 08:30,108,33,75,0,0,0
2019-04-15 08:45,137,49,88,0,0,0
2019-04-15 09:00,137,54,83,0,0,0
2019-04-15 09:15,83,48,35,0,0,0
2019-04-15 09:30,117,43,74,0,0,0
2019-04-15 09:45,249,96,153,0,0,0
2019-04-15 10:00,264,112,152,0,0,0
2019-04-15 10:15,85,37,48,0,0,0
2019-04-15 10:30,66,34,32,0,0,0
2019-04-15 10:45,85,55,30,0,0,0
2019-04-15 11:00,85,47,38,0,0,0
2019-04-15 11:15,83,40,43,0,0,0
2019-04-15 11:30,108,53,55,0,0,0
2019-04-15 11:45,234,130,104,0,0,0
2019-04-15 12:00,221,139,82,0,0,0
2019-04-15 12:15,130,76,54,0,0,0
2019-04-15 12:30,131,56,75,0,0,0
2019-04-15 12:45,79,38,41,0,0,0
2019-04-15 13:00,115,54,61,0,0,0
2019-04-15 13:15,76,33,43,0,0,0
2019-04-15 13:30,107,43,64,0,0,0
2019-04-15 13:45,248,105,143,0,0,0
2019-04-15 14:00,211,107,104,0,0,0
2019-04-15 14:15,133,67,66,0,0,0
2019-04-15 14:30,124,66,58,0,0,0
2019-04-15 14:45,124,66,58,0,0,0
2019-04-15 15:00,162,80,82,0,0,0
2019-04-15 15:15,103,57,46,0,0,0
2019-04-15 15:30,156,77,79,0,0,0
2019-04-15 15:45,269,150,119,0,0,0
2019-04-15 16:00,240,111,129,0,0,0
2019-04-15 16:15,158,96,62,0,0,0
2019-04-15 16:30,166,96,70,0,0,0
2019-04-15 16:45,162,98,64,0,0,0
2019-04-15 17:00,191,95,96,0,0,0
2019-04-15 17:15,169,74,95,0,0,0
2019-04-15 17:30,212,116,96,0,0,0
2019-04-15 17:45,280,145,135,0,0,0
2019-04-15 18:00,205,109,96,0,0,0
2019-04-15 18:15,129,55,74,0,0,0
2019-04-15 18:30,128,49,79,0,0,0
2019-04-15 18:45,90,42,48,0,0,0
2019-04-15 19:00,98,49,49,0,0,0
2019-04-15 19:15,100,46,54,0,0,0
2019-04-15 19:30,76,33,43,0,0,0
2019-04-15 19:45,120,47,73,0,0,0
2019-04-15 20:00,83,30,53,0,0,0
2019-04-15 20:15,57,23,34,0,0,0
2019-04-15 20:30,37,11,26,0,0,0
2019-04-15 20:45,39,12,27,0,0,0
2019-04-15 21:00,37,15,22,0,0,0
2019-04-15 21:15,47,22,25,0,0,0
2019-04-15 21:30,30,8,22,0,0,0
2019-04-15 21:45,35,9,26,0,0,0
2019-04-15 22:00,29,7,22,0,0,0
2019-04-15 22:15,25,11,14,0,0,0
2019-04-15 22:30,34,9,25,0,0,0
2019-04-15 22:45,24,10,14,0,0,0
2019-04-15 23:00,14,3,11,0,0,0
2019-04-15 23:15,26,16,10,0,0,0
2019-04-15 23:30,9,1,8,0,0,0
2019-04-15 23:45,4,1,3,0,0,0
2019-04-16 00:00,11,4,7,0,0,0
2019-04-16 00:15,7,1,6,0,0,0
2019-04-16 00:30,11,7,4,0,0,0
2019-04-16 00:45,3,0,3,0,0,0
2019-04-16 01:00,4,1,3,0,0,0
2019-04-16 01:15,3,1,2,0,0,0
2019-04-16 01:30,0,0,0,0,0,0
2019-04-16 01:45,2,0,2,0,0,0
2019-04-16 02:00,0,0,0,0,0,0
2019-04-16 02:15,1,1,0,0,0,0
2019-04-16 02:30,0,0,0,0,0,0
2019-04-16 02:45,1,0,1,0,0,0
2019-04-16 03:00,1,0,1,0,0,0
2019-04-16 03:15,0,0,0,0,0,0
2019-04-16 03:30,0,0,0,0,0,0
2019-04-16 03:45,2,0,2,0,0,0
2019-04-16 04:00,0,0,0,0,0,0
2019-04-16 04:15,0,0,0,0,0,0
2019-04-16 04:30,1,1,0,0,0,0
2019-04-16 04:45,2,0,2,0,0,0
2019-04-16 05:00,0,0,0,0,0,0
2019-04-16 05:15,1,0,1,0,0,0
2019-04-16 05:30,15,4,11,0,0,0
2019-04-16 05:45,13,4,9,0,0,0
2019-04-16 06:00,10,1,9,0,0,0
2019-04-16 06:15,28,12,16,0,0,0
2019-04-16 06:30,32,8,24,0,0,0
2019-04-16 06:45,43,12,31,0,0,0
2019-04-16 07:00,66,17,49,0,0,0
2019-04-16 07:15,84,28,56,0,0,0
2019-04-16 07:30,131,36,95,0,0,0
2019-04-16 07:45,227,69,158,0,0,0
2019-04-16 08:00,305,92,213,0,0,0
2019-04-16 08:15,166,52,114,0,0,0
2019-04-16 08:30,135,41,94,0,0,0
2019-04-16 08:45,158,50,108,0,0,0
2019-04-16 09:00,178,75,103,0,0,0
2019-04-16 09:15,135,52,83,0,0,0
2019-04-16 09:30,153,40,113,0,0,0
2019-04-16 09:45,247,90,157,0,0,0
2019-04-16 10:00,287,110,177,0,0,0
2019-04-16 10:15,102,57,45,0,0,0
2019-04-16 10:30,90,51,39,0,0,0
2019-04-16 10:45,101,52,49,0,0,0
2019-04-16 11:00,63,36,27,0,0,0
2019-04-16 11:15,81,40,41,0,0,0
2019-04-16 11:30,116,71,45,0,0,0
2019-04-16 11:45,409,239,170,0,0,0
2019-04-16 12:00,225,100,125,0,0,0
2019-04-16 12:15,120,42,78,0,0,0
2019-04-16 12:30,118,56,62,0,0,0
2019-04-16 12:45,127,61,66,0,0,0
2019-04-16 13:00,162,92,70,0,0,0
2019-04-16 13:15,107,56,51,0,0,0
2019-04-16 13:30,124,64,60,0,0,0
2019-04-16 13:45,292,136,156,0,0,0
2019-04-16 14:00,245,132,113,0,0,0
2019-04-16 14:15,121,57,64,0,0,0
2019-04-16 14:30,113,51,62,0,0,0
2019-04-16 14:45,137,66,71,0,0,0
2019-04-16 15:00,130,81,49,0,0,0
2019-04-16 15:15,138,77,61,0,0,0
2019-04-16 15:30,208,118,90,0,0,0
2019-04-16 15:45,278,154,124,0,0,0
2019-04-16 16:00,225,111,114,0,0,0
2019-04-16 16:15,153,81,72,0,0,0
2019-04-16 16:30,197,131,66,0,0,0
2019-04-16 16:45,160,87,73,0,0,0
2019-04-16 17:00,157,97,60,0,0,0
2019-04-16 17:15,166,100,66,0,0,0
2019-04-16 17:30,174,83,91,0,0,0
2019-04-16 17:45,229,108,121,0,0,0
2019-04-16 18:00,183,91,92,0,0,0
2019-04-16 18:15,159,74,85,0,0,0
2019-04-16 18:30,107,44,63,0,0,0
2019-04-16 18:45,116,45,71,0,0,0
2019-04-16 19:00,92,46,46,0,0,0
2019-04-16 19:15,127,62,65,0,0,0
2019-04-16 19:30,105,38,67,0,0,0
2019-04-16 19:45,107,33,74,0,0,0
2019-04-16 20:00,116,46,70,0,0,0
2019-04-16 20:15,62,31,31,0,0,0
2019-04-16 20:30,51,23,28,0,0,0
2019-04-16 20:45,66,20,46,0,0,0
2019-04-16 21:00,44,22,22,0,0,0
2019-04-16 21:15,32,12,20,0,0,0
2019-04-16 21:30,39,8,31,0,0,0
2019-04-16 21:45,28,12,16,0,0,0
2019-04-16 22:00,37,6,31,0,0,0
2019-04-16 22:15,31,9,22,0,0,0
2019-04-16 22:30,34,16,18,0,0,0
2019-04-16 22:45,25,10,15,0,0,0
2019-04-16 23:00,18,6,12,0,0,0
2019-04-16 23:15,17,9,8,0,0,0
2019-04-16 23:30,19,6,13,0,0,0
2019-04-16 23:45,14,3,11,0,0,0
2019-04-17 00:00,10,2,8,0,0,0
2019-04-17 00:15,12,1,11,0,0,0
2019-04-17 00:30,7,5,2,0,0,0
2019-04-17 00:45,10,2,8,0,0,0
2019-04-17 01:00,5,1,4,0,0,0
2019-04-17 01:15,6,1,5,0,0,0
2019-04-17 01:30,3,1,2,0,0,0
2019-04-17 01:45,4,0,4,0,0,0
2019-04-17 02:00,5,1,4,0,0,0
2019-04-17 02:15,2,1,1,0,0,0
2019-04-17 02:30,1,1,0,0,0,0
2019-04-17 02:45,0,0,0,0,0,0
2019-04-17 03:00,2,0,2,0,0,0
2019-04-17 03:15,2,1,1,0,0,0
2019-04-17 03:30,3,0,3,0,0,0
2019-04-17 03:45,3,0,3,0,0,0
2019-04-17 04:00,0,0,0,0,0,0
2019-04-17 04:15,0,0,0,0,0,0
2019-04-17 04:30,3,1,2,0,0,0
2019-04-17 04:45,1,0,1,0,0,0
2019-04-17 05:00,2,1,1,0,0,0
2019-04-17 05:15,4,2,2,0,0,0
2019-04-17 05:30,9,1,8,0,0,0
2019-04-17 05:45,8,1,7,0,0,0
2019-04-17 06:00,7,4,3,0,0,0
2019-04-17 06:15,36,16,20,0,0,0
2019-04-17 06:30,39,17,22,0,0,0
2019-04-17 06:45,49,24,25,0,0,0
2019-04-17 07:00,79,27,52,0,0,0
2019-04-17 07:15,134,60,74,0,0,0
2019-04-17 07:30,135,53,82,0,0,0
2019-04-17 07:45,241,67,174,0,0,0
2019-04-17 08:00,314,87,227,0,0,0
2019-04-17 08:15,183,73,110,0,0,0
2019-04-17 08:30,113,52,61,0,0,0
2019-04-17 08:45,168,63,105,0,0,0
2019-04-17 09:00,163,47,116,0,0,0
2019-04-17 09:15,95,51,44,0,0,0
2019-04-17 09:30,135,67,68,0,0,0
2019-04-17 09:45,371,128,243,0,0,0
2019-04-17 10:00,282,130,152,0,0,0
2019-04-17 10:15,104,46,58,0,0,0
2019-04-17 10:30,108,45,63,0,0,0
2019-04-17 10:45,132,60,72,0,0,0
2019-04-17 11:00,132,77,55,0,0,0
2019-04-17 11:15,112,63,49,0,0,0
2019-04-17 11:30,153,81,72,0,0,0
2019-04-17 11:45,304,127,177,0,0,0
2019-04-17 12:00,250,133,117,0,0,0
2019-04-17 12:15,164,60,104,0,0,0
2019-04-17 12:30,131,63,68,0,0,0
2019-04-17 12:45,181,83,98,0,0,0
2019-04-17 13:00,159,76,83,0,0,0
2019-04-17 13:15,134,69,65,0,0,0
2019-04-17 13:30,175,100,75,0,0,0
2019-04-17 13:45,273,111,162,0,0,0
2019-04-17 14:00,248,95,153,0,0,0
2019-04-17 14:15,155,66,89,0,0,0
2019-04-17 14:30,127,54,73,0,0,0
2019-04-17 14:45,144,77,67,0,0,0
2019-04-17 15:00,154,73,81,0,0,0
2019-04-17 15:15,190,131,59,0,0,0
2019-04-17 15:30,183,89,94,0,0,0
2019-04-17 15:45,349,168,181,0,0,0
2019-04-17 16:00,239,131,108,0,0,0
2019-04-17 16:15,170,98,72,0,0,0
2019-04-17 16:30,150,88,62,0,0,0
2019-04-17 16:45,153,82,71,0,0,0
2019-04-17 17:00,181,101,80,0,0,0
2019-04-17 17:15,147,68,79,0,0,0
2019-04-17 17:30,161,76,85,0,0,0
2019-04-17 17:45,206,109,97,0,0,0
2019-04-17 18:00,209,105,104,0,0,0
2019-04-17 18:15,133,69,64,0,0,0
2019-04-17 18:30,107,57,50,0,0,0
2019-04-17 18:45,133,60,73,0,0,0
2019-04-17 19:00,120,55,65,0,0,0
2019-04-17 19:15,76,45,31,0,0,0
2019-04-17 19:30,73,40,33,0,0,0
2019-04-17 19:45,109,49,60,0,0,0
2019-04-17 20:00,71,27,44,0,0,0
2019-04-17 20:15,81,25,56,0,0,0
2019-04-17 20:30,42,13,29,0,0,0
2019-04-17 20:45,51,23,28,0,0,0
2019-04-17 21:00,63,19,44,0,0,0
2019-04-17 21:15,49,15,34,0,0,0
2019-04-17 21:30,41,22,19,0,0,0
2019-04-17 21:45,34,13,21,0,0,0
2019-04-17 22:00,73,15,58,0,0,0
2019-04-17 22:15,34,5,29,0,0,0
2019-04-17 22:30,28,6,22,0,0,0
2019-04-17 22:45,35,7,28,0,0,0
2019-04-17 23:00,34,10,24,0,0,0
2019-04-17 23:15,17,7,10,0,0,0
2019-04-17 23:30,17,10,7,0,0,0
2019-04-17 23:45,22,9,13,0,0,0
2019-04-18 00:00,20,11,9,0,0,0
2019-04-18 00:15,15,8,7,0,0,0
2019-04-18 00:30,12,6,6,0,0,0
2019-04-18 00:45,16,4,12,0,0,0
2019-04-18 01:00,6,3,3,0,0,0
2019-04-18 01:15,4,2,2,0,0,0
2019-04-18 01:30,7,1,6,0,0,0
2019-04-18 01:45,4,0,4,0,0,0
2019-04-18 02:00,2,0,2,0,0,0
2019-04-18 02:15,2,1,1,0,0,0
2019-04-18 02:30,12,0,12,0,0,0
2019-04-18 02:45,4,0,4,0,0,0
2019-04-18 03:00,8,0,8,0,0,0
2019-04-18 03:15,8,2,6,0,0,0
2019-04-18 03:30,12,0,12,0,0,0
2019-04-18 03:45,4,0,4,0,0,0
2019-04-18 04:00,8,0,8,0,0,0
2019-04-18 04:15,6,0,6,0,0,0
2019-04-18 04:30,2,1,1,0,0,0
2019-04-18 04:45,2,0,2,0,0,0
2019-04-18 05:00,1,0,1,0,0,0
2019-04-18 05:15,1,0,1,0,0,0
2019-04-18 05:30,18,4,14,0,0,0
2019-04-18 05:45,14,2,12,0,0,0
2019-04-18 06:00,12,3,9,0,0,0
2019-04-18 06:15,26,10,16,0,0,0
2019-04-18 06:30,29,11,18,0,0,0
2019-04-18 06:45,40,14,26,0,0,0
2019-04-18 07:00,50,14,36,0,0,0
2019-04-18 07:15,92,29,63,0,0,0
2019-04-18 07:30,123,35,88,0,0,0
2019-04-18 07:45,206,47,159,0,0,0
2019-04-18 08:00,310,53,257,0,0,0
2019-04-18 08:15,170,68,102,0,0,0
2019-04-18 08:30,89,39,50,0,0,0
2019-04-18 08:45,137,53,84,0,0,0
2019-04-18 09:00,115,49,66,0,0,0
2019-04-18 09:15,76,36,40,0,0,0
2019-04-18 09:30,96,43,53,0,0,0
2019-04-18 09:45,234,104,130,0,0,0
2019-04-18 10:00,269,135,134,0,0,0
2019-04-18 10:15,99,56,43,0,0,0
2019-04-18 10:30,61,26,35,0,0,0
2019-04-18 10:45,85,43,42,0,0,0
2019-04-18 11:00,111,66,45,0,0,0
2019-04-18 11:15,76,44,32,0,0,0
2019-04-18 11:30,127,67,60,0,0,0
2019-04-18 11:45,255,127,128,0,0,0
2019-04-18 12:00,225,132,93,0,0,0
2019-04-18 12:15,132,49,83,0,0,0
2019-04-18 12:30,98,46,52,0,0,0
2019-04-18 12:45,131,75,56,0,0,0
2019-04-18 13:00,103,57,46,0,0,0
2019-04-18 13:15,104,54,50,0,0,0
2019-04-18 13:30,120,47,73,0,0,0
2019-04-18 13:45,258,91,167,0,0,0
2019-04-18 14:00,201,85,116,0,0,0
2019-04-18 14:15,116,80,36,0,0,0
2019-04-18 14:30,88,42,46,0,0,0
2019-04-18 14:45,163,83,80,0,0,0
2019-04-18 15:00,119,57,62,0,0,0
2019-04-18 15:15,124,65,59,0,0,0
2019-04-18 15:30,148,77,71,0,0,0
2019-04-18 15:45,223,131,92,0,0,0
2019-04-18 16:00,211,138,73,0,0,0
2019-04-18 16:15,122,76,46,0,0,0
2019-04-18 16:30,161,94,67,0,0,0
2019-04-18 16:45,121,69,52,0,0,0
2019-04-18 17:00,123,77,46,0,0,0
2019-04-18 17:15,129,61,68,0,0,0
2019-04-18 17:30,137,72,65,0,0,0
2019-04-18 17:45,137,68,69,0,0,0
2019-04-18 18:00,114,58,56,0,0,0
2019-04-18 18:15,127,62,65,0,0,0
2019-04-18 18:30,126,50,76,0,0,0
2019-04-18 18:45,85,35,50,0,0,0
2019-04-18 19:00,87,52,35,0,0,0
2019-04-18 19:15,79,37,42,0,0,0
2019-04-18 19:30,68,21,47,0,0,0
2019-04-18 19:45,81,41,40,0,0,0
2019-04-18 20:00,60,29,31,0,0,0
2019-04-18 20:15,61,15,46,0,0,0
2019-04-18 20:30,43,19,24,0,0,0
2019-04-18 20:45,45,8,37,0,0,0
2019-04-18 21:00,38,18,20,0,0,0
2019-04-18 21:15,42,24,18,0,0,0
2019-04-18 21:30,32,10,22,0,0,0
2019-04-18 21:45,33,18,15,0,0,0
2019-04-18 22:00,21,4,17,0,0,0
2019-04-18 22:15,27,5,22,0,0,0
2019-04-18 22:30,38,10,28,0,0,0
2019-04-18 22:45,24,2,22,0,0,0
2019-04-18 23:00,11,4,7,0,0,0
2019-04-18 23:15,23,15,8,0,0,0
2019-04-18 23:30,15,3,12,0,0,0
2019-04-18 23:45,15,2,13,0,0,0
2019-04-19 00:00,5,0,5,0,0,0
2019-04-19 00:15,11,1,10,0,0,0
2019-04-19 00:30,10,0,10,0,0,0
2019-04-19 00:45,11,2,9,0,0,0
2019-04-19 01:00,12,4,8,0,0,0
2019-04-19 01:15,14,5,9,0,0,0
2019-04-19 01:30,11,0,11,0,0,0
2019-04-19 01:45,2,0,2,0,0,0
2019-04-19 02:00,6,5,1,0,0,0
2019-04-19 02:15,4,0,4,0,0,0
2019-04-19 02:30,7,3,4,0,0,0
2019-04-19 02:45,2,2,0,0,0,0
2019-04-19 03:00,1,0,1,0,0,0
2019-04-19 03:15,3,2,1,0,0,0
2019-04-19 03:30,3,0,3,0,0,0
2019-04-19 03:45,1,1,0,0,0,0
2019-04-19 04:00,0,0,0,0,0,0
2019-04-19 04:15,5,3,2,0,0,0
2019-04-19 04:30,3,1,2,0,0,0
2019-04-19 04:45,1,1,0,0,0,0
2019-04-19 05:00,0,0,0,0,0,0
2019-04-19 05:15,0,0,0,0,0,0
2019-04-19 05:30,7,1,6,0,0,0
2019-04-19 05:45,4,0,4,0,0,0
2019-04-19 06:00,1,1,0,0,0,0
2019-04-19 06:15,8,4,4,0,0,0
2019-04-19 06:30,7,4,3,0,0,0
2019-04-19 06:45,10,8,2,0,0,0
2019-04-19 07:00,7,5,2,0,0,0
2019-04-19 07:15,6,4,2,0,0,0
2019-04-19 07:30,6,4,2,0,0,0
2019-04-19 07:45,6,2,4,0,0,0
2019-04-19 08:00,7,5,2,0,0,0
2019-04-19 08:15,5,5,0,0,0,0
2019-04-19 08:30,7,4,3,0,0,0
2019-04-19 08:45,13,5,8,0,0,0
2019-04-19 09:00,15,10,5,0,0,0
2019-04-19 09:15,8,5,3,0,0,0
2019-04-19 09:30,11,6,5,0,0,0
2019-04-19 09:45,28,15,13,0,0,0
2019-04-19 10:00,29,15,14,0,0,0
2019-04-19 10:15,20,13,7,0,0,0
2019-04-19 10:30,13,7,6,0,0,0
2019-04-19 10:45,37,21,16,0,0,0
2019-04-19 11:00,20,5,15,0,0,0
2019-04-19 11:15,35,12,23,0,0,0
2019-04-19 11:30,24,18,6,0,0,0
2019-04-19 11:45,31,22,9,0,0,0
2019-04-19 12:00,38,17,21,0,0,0
2019-04-19 12:15,25,11,14,0,0,0
2019-04-19 12:30,53,13,40,0,0,0
2019-04-19 12:45,61,31,30,0,0,0
2019-04-19 13:00,32,9,23,0,0,0
2019-04-19 13:15,45,15,30,0,0,0
2019-04-19 13:30,43,26,17,0,0,0
2019-04-19 13:45,47,17,30,0,0,0
2019-04-19 14:00,47,23,24,0,0,0
2019-04-19 14:15,66,33,33,0,0,0
2019-04-19 14:30,45,18,27,0,0,0
2019-04-19 14:45,74,33,41,0,0,0
2019-04-19 15:00,40,22,18,0,0,0
2019-04-19 15:15,62,35,27,0,0,0
2019-04-19 15:30,41,20,21,0,0,0
2019-04-19 15:45,49,30,19,0,0,0
2019-04-19 16:00,43,15,28,0,0,0
2019-04-19 16:15,51,16,35,0,0,0
2019-04-19 16:30,69,21,48,0,0,0
2019-04-19 16:45,69,23,46,0,0,0
2019-04-19 17:00,73,36,37,0,0,0
2019-04-19 17:15,47,18,29,0,0,0
2019-04-19 17:30,53,21,32,0,0,0
2019-04-19 17:45,51,26,25,0,0,0
2019-04-19 18:00,36,15,21,0,0,0
2019-04-19 18:15,34,9,25,0,0,0
2019-04-19 18:30,31,10,21,0,0,0
2019-04-19 18:45,37,11,26,0,0,0
2019-04-19 19:00,34,7,27,0,0,0
2019-04-19 19:15,35,10,25,0,0,0
2019-04-19 19:30,46,22,24,0,0,0
2019-04-19 19:45,29,18,11,0,0,0
2019-04-19 20:00,37,13,24,0,0,0
2019-04-19 20:15,20,7,13,0,0,0
2019-04-19 20:30,23,9,14,0,0,0
2019-04-19 20:45,17,9,8,0,0,0
2019-04-19 21:00,31,14,17,0,0,0
2019-04-19 21:15,16,6,10,0,0,0
2019-04-19 21:30,14,5,9,0,0,0
2019-04-19 21:45,25,13,12,0,0,0
2019-04-19 22:00,15,4,11,0,0,0
2019-04-19 22:15,11,2,9,0,0,0
2019-04-19 22:30,7,2,5,0,0,0
2019-04-19 22:45,6,2,4,0,0,0
2019-04-19 23:00,10,1,9,0,0,0
2019-04-19 23:15,4,2,2,0,0,0
2019-04-19 23:30,13,3,10,0,0,0
2019-04-19 23:45,4,0,4,0,0,0
2019-04-20 00:00,8,2,6,0,0,0
2019-04-20 00:15,6,1,5,0,0,0
2019-04-20 00:30,4,2,2,0,0,0
2019-04-20 00:45,5,0,5,0,0,0
2019-04-20 01:00,11,4,7,0,0,0
2019-04-20 01:15,4,0,4,0,0,0
2019-04-20 01:30,2,2,0,0,0,0
2019-04-20 01:45,7,4,3,0,0,0
2019-04-20 02:00,5,2,3,0,0,0
2019-04-20 02:15,1,0,1,0,0,0
2019-04-20 02:30,2,0,2,0,0,0
2019-04-20 02:45,3,0,3,0,0,0
2019-04-20 03:00,2,2,0,0,0,0
2019-04-20 03:15,2,0,2,0,0,0
2019-04-20 03:30,0,0,0,0,0,0
2019-04-20 03:45,5,0,5,0,0,0
2019-04-20 04:00,0,0,0,0,0,0
2019-04-20 04:15,0,0,0,0,0,0
2019-04-20 04:30,1,1,0,0,0,0
2019-04-20 04:45,0,0,0,0,0,0
2019-04-20 05:00,0,0,0,0,0,0
2019-04-20 05:15,0,0,0,0,0,0
2019-04-20 05:30,8,2,6,0,0,0
2019-04-20 05:45,1,0,1,0,0,0
2019-04-20 06:00,10,7,3,0,0,0
2019-04-20 06:15,8,4,4,0,0,0
2019-04-20 06:30,14,8,6,0,0,0
2019-04-20 06:45,12,8,4,0,0,0
2019-04-20 07:00,17,12,5,0,0,0
2019-04-20 07:15,18,10,8,0,0,0
2019-04-20 07:30,22,14,8,0,0,0
2019-04-20 07:45,29,14,15,0,0,0
2019-04-20 08:00,20,15,5,0,0,0
2019-04-20 08:15,40,27,13,0,0,0
2019-04-20 08:30,41,27,14,0,0,0
2019-04-20 08:45,38,23,15,0,0,0
2019-04-20 09:00,47,31,16,0,0,0
2019-04-20 09:15,51,37,14,0,0,0
2019-04-20 09:30,57,43,14,0,0,0
2019-04-20 09:45,101,87,14,0,0,0
2019-04-20 10:00,77,51,26,0,0,0
2019-04-20 10:15,105,71,34,0,0,0
2019-04-20 10:30,86,61,25,0,0,0
2019-04-20 10:45,76,45,31,0,0,0
2019-04-20 11:00,124,80,44,0,0,0
2019-04-20 11:15,87,48,39,0,0,0
2019-04-20 11:30,114,70,44,0,0,0
2019-04-20 11:45,131,84,47,0,0,0
2019-04-20 12:00,106,66,40,0,0,0
2019-04-20 12:15,112,60,52,0,0,0
2019-04-20 12:30,94,36,58,0,0,0
2019-04-20 12:45,106,47,59,0,0,0
2019-04-20 13:00,94,35,59,0,0,0
2019-04-20 13:15,110,54,56,0,0,0
2019-04-20 13:30,143,53,90,0,0,0
2019-04-20 13:45,119,49,70,0,0,0
2019-04-20 14:00,99,30,69,0,0,0
2019-04-20 14:15,96,36,60,0,0,0
2019-04-20 14:30,70,18,52,0,0,0
2019-04-20 14:45,92,30,62,0,0,0
2019-04-20 15:00,87,29,58,0,0,0
2019-04-20 15:15,74,21,53,0,0,0
2019-04-20 15:30,63,29,34,0,0,0
2019-04-20 15:45,71,25,46,0,0,0
2019-04-20 16:00,65,31,34,0,0,0
2019-04-20 16:15,72,20,52,0,0,0
2019-04-20 16:30,59,20,39,0,0,0
2019-04-20 16:45,48,15,33,0,0,0
2019-04-20 17:00,64,17,47,0,0,0
2019-04-20 17:15,32,12,20,0,0,0
2019-04-20 17:30,47,13,34,0,0,0
2019-04-20 17:45,71,27,44,0,0,0
2019-04-20 18:00,79,22,57,0,0,0
2019-04-20 18:15,49,17,32,0,0,0
2019-04-20 18:30,31,15,16,0,0,0
2019-04-20 18:45,75,40,35,0,0,0
2019-04-20 19:00,43,16,27,0,0,0
2019-04-20 19:15,39,19,20,0,0,0
2019-04-20 19:30,35,16,19,0,0,0
2019-04-20 19:45,24,14,10,0,0,0
2019-04-20 20:00,30,12,18,0,0,0
2019-04-20 20:15,24,13,11,0,0,0
2019-04-20 20:30,34,18,16,0,0,0
2019-04-20 20:45,51,29,22,0,0,0
2019-04-20 21:00,31,24,7,0,0,0
2019-04-20 21:15,20,10,10,0,0,0
2019-04-20 21:30,23,10,13,0,0,0
2019-04-20 21:45,18,8,10,0,0,0
2019-04-20 22:00,20,3,17,0,0,0
2019-04-20 22:15,25,5,20,0,0,0
2019-04-20 22:30,34,3,31,0,0,0
2019-04-20 22:45,20,5,15,0,0,0
2019-04-20 23:00,17,7,10,0,0,0
2019-04-20 23:15,15,1,14,0,0,0
2019-04-20 23:30,20,5,15,0,0,0
2019-04-20 23:45,15,6,9,0,0,0
2019-04-21 00:00,13,1,12,0,0,0
2019-04-21 00:15,13,5,8,0,0,0
2019-04-21 00:30,6,1,5,0,0,0
2019-04-21 00:45,15,4,11,0,0,0
2019-04-21 01:00,7,0,7,0,0,0
2019-04-21 01:15,17,6,11,0,0,0
2019-04-21 01:30,18,3,15,0,0,0
2019-04-21 01:45,1,0,1,0,0,0
2019-04-21 02:00,7,4,3,0,0,0
2019-04-21 02:15,5,1,4,0,0,0
2019-04-21 02:30,2,0,2,0,0,0
2019-04-21 02:45,2,0,2,0,0,0
2019-04-21 03:00,7,1,6,0,0,0
2019-04-21 03:15,2,2,0,0,0,0
2019-04-21 03:30,2,0,2,0,0,0
2019-04-21 03:45,1,0,1,0,0,0
2019-04-21 04:00,1,0,1,0,0,0
2019-04-21 04:15,1,0,1,0,0,0
2019-04-21 04:30,8,0,8,0,0,0
2019-04-21 04:45,4,0,4,0,0,0
2019-04-21 05:00,1,0,1,0,0,0
2019-04-21 05:15,1,1,0,0,0,0
2019-04-21 05:30,8,1,7,0,0,0
2019-04-21 05:45,4,1,3,0,0,0
2019-04-21 06:00,3,1,2,0,0,0
2019-04-21 06:15,2,1,1,0,0,0
2019-04-21 06:30,1,1,0,0,0,0
2019-04-21 06:45,9,6,3,0,0,0
2019-04-21 07:00,1,0,1,0,0,0
2019-04-21 07:15,3,1,2,0,0,0
2019-04-21 07:30,3,0,3,0,0,0
2019-04-21 07:45,7,2,5,0,0,0
2019-04-21 08:00,6,6,0,0,0,0
2019-04-21 08:15,10,5,5,0,0,0
2019-04-21 08:30,9,5,4,0,0,0
2019-04-21 08:45,11,7,4,0,0,0
2019-04-21 09:00,7,3,4,0,0,0
2019-04-21 09:15,12,9,3,0,0,0
2019-04-21 09:30,20,12,8,0,0,0
2019-04-21 09:45,22,17,5,0,0,0
2019-04-21 10:00,28,12,16,0,0,0
2019-04-21 10:15,18,10,8,0,0,0
2019-04-21 10:30,25,16,9,0,0,0
2019-04-21 10:45,29,16,13,0,0,0
2019-04-21 11:00,20,12,8,0,0,0
2019-04-21 11:15,33,20,13,0,0,0
2019-04-21 11:30,31,13,18,0,0,0
2019-04-21 11:45,41,14,27,0,0,0
2019-04-21 12:00,40,5,35,0,0,0
2019-04-21 12:15,38,15,23,0,0,0
2019-04-21 12:30,38,18,20,0,0,0
2019-04-21 12:45,36,10,26,0,0,0
2019-04-21 13:00,25,12,13,0,0,0
2019-04-21 13:15,18,9,9,0,0,0
2019-04-21 13:30,48,8,40,0,0,0
2019-04-21 13:45,32,17,15,0,0,0
2019-04-21 14:00,27,19,8,0,0,0
2019-04-21 14:15,44,27,17,0,0,0
2019-04-21 14:30,33,13,20,0,0,0
2019-04-21 14:45,38,17,21,0,0,0
2019-04-21 15:00,32,15,17,0,0,0
2019-04-21 15:15,40,22,18,0,0,0
2019-04-21 15:30,26,7,19,0,0,0
2019-04-21 15:45,41,13,28,0,0,0
2019-04-21 16:00,37,11,26,0,0,0
2019-04-21 16:15,38,20,18,0,0,0
2019-04-21 16:30,40,17,23,0,0,0
2019-04-21 16:45,25,10,15,0,0,0
2019-04-21 17:00,32,14,18,0,0,0
2019-04-21 17:15,44,19,25,0,0,0
2019-04-21 17:30,43,28,15,0,0,0
2019-04-21 17:45,44,17,27,0,0,0
2019-04-21 18:00,33,11,22,0,0,0
2019-04-21 18:15,35,18,17,0,0,0
2019-04-21 18:30,24,5,19,0,0,0
2019-04-21 18:45,23,5,18,0,0,0
2019-04-21 19:00,27,8,19,0,0,0
2019-04-21 19:15,31,11,20,0,0,0
2019-04-21 19:30,29,9,20,0,0,0
2019-04-21 19:45,30,11,19,0,0,0
2019-04-21 20:00,14,3,11,0,0,0
2019-04-21 20:15,13,4,9,0,0,0
2019-04-21 20:30,17,5,12,0,0,0
2019-04-21 20:45,18,11,7,0,0,0
2019-04-21 21:00,14,11,3,0,0,0
2019-04-21 21:15,20,8,12,0,0,0
2019-04-21 21:30,24,8,16,0,0,0
2019-04-21 21:45,10,3,7,0,0,0
2019-04-21 22:00,5,0,5,0,0,0
2019-04-21 22:15,12,9,3,0,0,0
2019-04-21 22:30,14,5,9,0,0,0
2019-04-21 22:45,8,2,6,0,0,0
2019-04-21 23:00,7,2,5,0,0,0
2019-04-21 23:15,11,5,6,0,0,0
2019-04-21 23:30,11,3,8,0,0,0
2019-04-21 23:45,6,4,2,0,0,0
2019-04-22 00:00,5,2,3,0,0,0
2019-04-22 00:15,1,0,1,0,0,0
2019-04-22 00:30,2,0,2,0,0,0
2019-04-22 00:45,1,0,1,0,0,0
2019-04-22 01:00,5,2,3,0,0,0
2019-04-22 01:15,5,4,1,0,0,0
2019-04-22 01:30,9,4,5,0,0,0
2019-04-22 01:45,5,0,5,0,0,0
2019-04-22 02:00,3,1,2,0,0,0
2019-04-22 02:15,1,0,1,0,0,0
2019-04-22 02:30,0,0,0,0,0,0
2019-04-22 02:45,0,0,0,0,0,0
2019-04-22 03:00,0,0,0,0,0,0
2019-04-22 03:15,5,0,5,0,0,0
2019-04-22 03:30,7,2,5,0,0,0
2019-04-22 03:45,2,0,2,0,0,0
2019-04-22 04:00,3,0,3,0,0,0
2019-04-22 04:15,1,0,1,0,0,0
2019-04-22 04:30,0,0,0,0,0,0
2019-04-22 04:45,0,0,0,0,0,0
2019-04-22 05:00,1,0,1,0,0,0
2019-04-22 05:15,4,2,2,0,0,0
2019-04-22 05:30,4,2,2,0,0,0
2019-04-22 05:45,5,0,5,0,0,0
2019-04-22 06:00,1,1,0,0,0,0
2019-04-22 06:15,4,1,3,0,0,0
2019-04-22 06:30,9,7,2,0,0,0
2019-04-22 06:45,3,1,2,0,0,0
2019-04-22 07:00,7,6,1,0,0,0
2019-04-22 07:15,2,1,1,0,0,0
2019-04-22 07:30,4,2,2,0,0,0
2019-04-22 07:45,13,4,9,0,0,0
2019-04-22 08:00,1,0,1,0,0,0
2019-04-22 08:15,2,1,1,0,0,0
2019-04-22 08:30,6,2,4,0,0,0
2019-04-22 08:45,10,4,6,0,0,0
2019-04-22 09:00,11,7,4,0,0,0
2019-04-22 09:15,15,7,8,0,0,0
2019-04-22 09:30,20,13,7,0,0,0
2019-04-22 09:45,14,11,3,0,0,0
2019-04-22 10:00,29,17,12,0,0,0
2019-04-22 10:15,48,41,7,0,0,0
2019-04-22 10:30,24,14,10,0,0,0
2019-04-22 10:45,77,61,16,0,0,0
2019-04-22 11:00,55,31,24,0,0,0
2019-04-22 11:15,39,21,18,0,0,0
2019-04-22 11:30,40,17,23,0,0,0
2019-04-22 11:45,40,14,26,0,0,0
2019-04-22 12:00,70,21,49,0,0,0
2019-04-22 12:15,85,28,57,0,0,0
2019-04-22 12:30,73,14,59,0,0,0
2019-04-22 12:45,54,21,33,0,0,0
2019-04-22 13:00,47,25,22,0,0,0
2019-04-22 13:15,58,18,40,0,0,0
2019-04-22 13:30,67,23,44,0,0,0
2019-04-22 13:45,81,35,46,0,0,0
2019-04-22 14:00,38,20,18,0,0,0
2019-04-22 14:15,45,23,22,0,0,0
2019-04-22 14:30,58,25,33,0,0,0
2019-04-22 14:45,67,45,22,0,0,0
2019-04-22 15:00,33,16,17,0,0,0
2019-04-22 15:15,47,22,25,0,0,0
2019-04-22 15:30,60,22,38,0,0,0
2019-04-22 15:45,60,22,38,0,0,0
2019-04-22 16:00,41,15,26,0,0,0
2019-04-22 16:15,32,8,24,0,0,0
2019-04-22 16:30,52,20,32,0,0,0
2019-04-22 16:45,49,25,24,0,0,0
2019-04-22 17:00,51,33,18,0,0,0
2019-04-22 17:15,47,15,32,0,0,0
2019-04-22 17:30,43,13,30,0,0,0
2019-04-22 17:45,54,18,36,0,0,0
2019-04-22 18:00,70,16,54,0,0,0
2019-04-22 18:15,48,20,28,0,0,0
2019-04-22 18:30,42,17,25,0,0,0
2019-04-22 18:45,35,13,22,0,0,0
2019-04-22 19:00,37,14,23,0,0,0
2019-04-22 19:15,37,15,22,0,0,0
2019-04-22 19:30,28,14,14,0,0,0
2019-04-22 19:45,42,10,32,0,0,0
2019-04-22 20:00,37,15,22,0,0,0
2019-04-22 20:15,31,17,14,0,0,0
2019-04-22 20:30,25,7,18,0,0,0
2019-04-22 20:45,18,8,10,0,0,0
2019-04-22 21:00,29,9,20,0,0,0
2019-04-22 21:15,21,2,19,0,0,0
2019-04-22 21:30,14,4,10,0,0,0
2019-04-22 21:45,13,9,4,0,0,0
2019-04-22 22:00,14,4,10,0,0,0
2019-04-22 22:15,20,5,15,0,0,0
2019-04-22 22:30,17,2,15,0,0,0
2019-04-22 22:45,17,3,14,0,0,0
2019-04-22 23:00,11,2,9,0,0,0
2019-04-22 23:15,11,3,8,0,0,0
2019-04-22 23:30,6,1,5,0,0,0
2019-04-22 23:45,11,5,6,0,0,0
2019-04-23 00:00,4,2,2,0,0,0
2019-04-23 00:15,8,2,6,0,0,0
2019-04-23 00:30,9,2,7,0,0,0
2019-04-23 00:45,4,1,3,0,0,0
2019-04-23 01:00,6,1,5,0,0,0
2019-04-23 01:15,2,1,1,0,0,0
2019-04-23 01:30,5,2,3,0,0,0
2019-04-23 01:45,2,2,0,0,0,0
2019-04-23 02:00,0,0,0,0,0,0
2019-04-23 02:15,2,2,0,0,0,0
2019-04-23 02:30,2,1,1,0,0,0
2019-04-23 02:45,1,1,0,0,0,0
2019-04-23 03:00,0,0,0,0,0,0
2019-04-23 03:15,1,1,0,0,0,0
2019-04-23 03:30,0,0,0,0,0,0
2019-04-23 03:45,0,0,0,0,0,0
2019-04-23 04:00,0,0,0,0,0,0
2019-04-23 04:15,0,0,0,0,0,0
2019-04-23 04:30,1,1,0,0,0,0
2019-04-23 04:45,4,2,2,0,0,0
2019-04-23 05:00,1,0,1,0,0,0
2019-04-23 05:15,3,2,1,0,0,0
2019-04-23 05:30,17,6,11,0,0,0
2019-04-23 05:45,8,3,5,0,0,0
2019-04-23 06:00,22,5,17,0,0,0
2019-04-23 06:15,20,6,14,0,0,0
2019-04-23 06:30,28,12,16,0,0,0
2019-04-23 06:45,53,26,27,0,0,0
2019-04-23 07:00,68,19,49,0,0,0
2019-04-23 07:15,79,28,51,0,0,0
2019-04-23 07:30,122,34,88,0,0,0
2019-04-23 07:45,207,61,146,0,0,0
2019-04-23 08:00,274,49,225,0,0,0
2019-04-23 08:15,159,49,110,0,0,0
2019-04-23 08:30,113,47,66,0,0,0
2019-04-23 08:45,130,51,79,0,0,0
2019-04-23 09:00,123,52,71,0,0,0
2019-04-23 09:15,84,45,39,0,0,0
2019-04-23 09:30,125,44,81,0,0,0
2019-04-23 09:45,254,98,156,0,0,0
2019-04-23 10:00,286,94,192,0,0,0
2019-04-23 10:15,115,49,66,0,0,0
2019-04-23 10:30,62,35,27,0,0,0
2019-04-23 10:45,70,38,32,0,0,0
2019-04-23 11:00,76,41,35,0,0,0
2019-04-23 11:15,86,46,40,0,0,0
2019-04-23 11:30,159,80,79,0,0,0
2019-04-23 11:45,303,159,144,0,0,0
2019-04-23 12:00,209,107,102,0,0,0
2019-04-23 12:15,126,58,68,0,0,0
2019-04-23 12:30,111,40,71,0,0,0
2019-04-23 12:45,110,52,58,0,0,0
2019-04-23 13:00,122,57,65,0,0,0
2019-04-23 13:15,106,41,65,0,0,0
2019-04-23 13:30,128,58,70,0,0,0
2019-04-23 13:45,274,151,123,0,0,0
2019-04-23 14:00,189,94,95,0,0,0
2019-04-23 14:15,137,81,56,0,0,0
2019-04-23 14:30,112,62,50,0,0,0
2019-04-23 14:45,108,55,53,0,0,0
2019-04-23 15:00,118,66,52,0,0,0
2019-04-23 15:15,126,67,59,0,0,0
2019-04-23 15:30,179,114,65,0,0,0
2019-04-23 15:45,293,171,122,0,0,0
2019-04-23 16:00,207,111,96,0,0,0
2019-04-23 16:15,154,75,79,0,0,0
2019-04-23 16:30,139,76,63,0,0,0
2019-04-23 16:45,156,77,79,0,0,0
2019-04-23 17:00,194,105,89,0,0,0
2019-04-23 17:15,130,74,56,0,0,0
2019-04-23 17:30,165,71,94,0,0,0
2019-04-23 17:45,207,129,78,0,0,0
2019-04-23 18:00,175,87,88,0,0,0
2019-04-23 18:15,131,50,81,0,0,0
2019-04-23 18:30,106,46,60,0,0,0
2019-04-23 18:45,98,40,58,0,0,0
2019-04-23 19:00,90,35,55,0,0,0
2019-04-23 19:15,111,60,51,0,0,0
2019-04-23 19:30,114,63,51,0,0,0
2019-04-23 19:45,135,60,75,0,0,0
2019-04-23 20:00,82,32,50,0,0,0
2019-04-23 20:15,59,16,43,0,0,0
2019-04-23 20:30,49,22,27,0,0,0
2019-04-23 20:45,48,18,30,0,0,0
2019-04-23 21:00,48,20,28,0,0,0
2019-04-23 21:15,55,26,29,0,0,0
2019-04-23 21:30,56,11,45,0,0,0
2019-04-23 21:45,43,7,36,0,0,0
2019-04-23 22:00,42,18,24,0,0,0
2019-04-23 22:15,23,6,17,0,0,0
2019-04-23 22:30,42,10,32,0,0,0
2019-04-23 22:45,27,9,18,0,0,0
2019-04-23 23:00,31,15,16,0,0,0
2019-04-23 23:15,26,5,21,0,0,0
2019-04-23 23:30,21,8,13,0,0,0
2019-04-23 23:45,22,9,13,0,0,0
2019-04-24 00:00,8,2,6,0,0,0
2019-04-24 00:15,6,0,6,0,0,0
2019-04-24 00:30,3,1,2,0,0,0
2019-04-24 00:45,3,0,3,0,0,0
2019-04-24 01:00,7,3,4,0,0,0
2019-04-24 01:15,4,2,2,0,0,0
2019-04-24 01:30,2,1,1,0,0,0
2019-04-24 01:45,3,0,3,0,0,0
2019-04-24 02:00,4,2,2,0,0,0
2019-04-24 02:15,0,0,0,0,0,0
2019-04-24 02:30,1,0,1,0,0,0
2019-04-24 02:45,0,0,0,0,0,0
2019-04-24 03:00,0,0,0,0,0,0
2019-04-24 03:15,4,0,4,0,0,0
2019-04-24 03:30,13,0,13,0,0,0
2019-04-24 03:45,4,2,2,0,0,0
2019-04-24 04:00,0,0,0,0,0,0
2019-04-24 04:15,0,0,0,0,0,0
2019-04-24 04:30,0,0,0,0,0,0
2019-04-24 04:45,2,1,1,0,0,0
2019-04-24 05:00,0,0,0,0,0,0
2019-04-24 05:15,6,2,4,0,0,0
2019-04-24 05:30,14,4,10,0,0,0
2019-04-24 05:45,8,3,5,0,0,0
2019-04-24 06:00,8,3,5,0,0,0
2019-04-24 06:15,30,16,14,0,0,0
2019-04-24 06:30,48,19,29,0,0,0
2019-04-24 06:45,56,35,21,0,0,0
2019-04-24 07:00,65,18,47,0,0,0
2019-04-24 07:15,127,67,60,0,0,0
2019-04-24 07:30,127,36,91,0,0,0
2019-04-24 07:45,232,85,147,0,0,0
2019-04-24 08:00,286,82,204,0,0,0
2019-04-24 08:15,159,53,106,0,0,0
2019-04-24 08:30,104,38,66,0,0,0
2019-04-24 08:45,161,58,103,0,0,0
2019-04-24 09:00,150,52,98,0,0,0
2019-04-24 09:15,105,60,45,0,0,0
2019-04-24 09:30,135,63,72,0,0,0
2019-04-24 09:45,269,137,132,0,0,0
2019-04-24 10:00,376,130,246,0,0,0
2019-04-24 10:15,142,84,58,0,0,0
2019-04-24 10:30,81,40,41,0,0,0
2019-04-24 10:45,141,69,72,0,0,0
2019-04-24 11:00,105,59,46,0,0,0
2019-04-24 11:15,119,70,49,0,0,0
2019-04-24 11:30,166,82,84,0,0,0
2019-04-24 11:45,270,132,138,0,0,0
2019-04-24 12:00,274,127,147,0,0,0
2019-04-24 12:15,179,63,116,0,0,0
2019-04-24 12:30,141,54,87,0,0,0
2019-04-24 12:45,140,64,76,0,0,0
2019-04-24 13:00,195,124,71,0,0,0
2019-04-24 13:15,127,60,67,0,0,0
2019-04-24 13:30,157,68,89,0,0,0
2019-04-24 13:45,309,126,183,0,0,0
2019-04-24 14:00,194,93,101,0,0,0
2019-04-24 14:15,92,38,54,0,0,0
2019-04-24 14:30,71,31,40,0,0,0
2019-04-24 14:45,110,46,64,0,0,0
2019-04-24 15:00,134,72,62,0,0,0
2019-04-24 15:15,138,67,71,0,0,0
2019-04-24 15:30,169,93,76,0,0,0
2019-04-24 15:45,247,135,112,0,0,0
2019-04-24 16:00,230,136,94,0,0,0
2019-04-24 16:15,164,91,73,0,0,0
2019-04-24 16:30,143,65,78,0,0,0
2019-04-24 16:45,167,76,91,0,0,0
2019-04-24 17:00,140,76,64,0,0,0
2019-04-24 17:15,159,101,58,0,0,0
2019-04-24 17:30,169,98,71,0,0,0
2019-04-24 17:45,199,91,108,0,0,0
2019-04-24 18:00,175,86,89,0,0,0
2019-04-24 18:15,150,64,86,0,0,0
2019-04-24 18:30,124,65,59,0,0,0
2019-04-24 18:45,92,42,50,0,0,0
2019-04-24 19:00,107,50,57,0,0,0
2019-04-24 19:15,141,67,74,0,0,0
2019-04-24 19:30,110,55,55,0,0,0
2019-04-24 19:45,135,63,72,0,0,0
2019-04-24 20:00,88,38,50,0,0,0
2019-04-24 20:15,68,32,36,0,0,0
2019-04-24 20:30,57,30,27,0,0,0
2019-04-24 20:45,39,10,29,0,0,0
2019-04-24 21:00,41,14,27,0,0,0
2019-04-24 21:15,46,25,21,0,0,0
2019-04-24 21:30,29,14,15,0,0,0
2019-04-24 21:45,26,10,16,0,0,0
2019-04-24 22:00,34,11,23,0,0,0
2019-04-24 22:15,39,9,30,0,0,0
2019-04-24 22:30,25,3,22,0,0,0
2019-04-24 22:45,38,14,24,0,0,0
2019-04-24 23:00,26,12,14,0,0,0
2019-04-24 23:15,20,5,15,0,0,0
2019-04-24 23:30,15,5,10,0,0,0
2019-04-24 23:45,21,3,18,0,0,0
2019-04-25 00:00,21,3,18,0,0,0
2019-04-25 00:15,10,6,4,0,0,0
2019-04-25 00:30,9,6,3,0,0,0
2019-04-25 00:45,13,1,12,0,0,0
2019-04-25 01:00,7,0,7,0,0,0
2019-04-25 01:15,12,9,3,0,0,0
2019-04-25 01:30,3,0,3,0,0,0
2019-04-25 01:45,3,0,3,0,0,0
2019-04-25 02:00,6,0,6,0,0,0
2019-04-25 02:15,2,0,2,0,0,0
2019-04-25 02:30,6,0,6,0,0,0
2019-04-25 02:45,3,0,3,0,0,0
2019-04-25 03:00,3,0,3,0,0,0
2019-04-25 03:15,2,0,2,0,0,0
2019-04-25 03:30,3,0,3,0,0,0
2019-04-25 03:45,2,2,0,0,0,0
2019-04-25 04:00,0,0,0,0,0,0
2019-04-25 04:15,0,0,0,0,0,0
2019-04-25 04:30,4,0,4,0,0,0
2019-04-25 04:45,5,0,5,0,0,0
2019-04-25 05:00,5,0,5,0,0,0
2019-04-25 05:15,6,3,3,0,0,0
2019-04-25 05:30,10,2,8,0,0,0
2019-04-25 05:45,8,2,6,0,0,0
2019-04-25 06:00,10,5,5,0,0,0
2019-04-25 06:15,18,12,6,0,0,0
2019-04-25 06:30,27,10,17,0,0,0
2019-04-25 06:45,64,32,32,0,0,0
2019-04-25 07:00,53,19,34,0,0,0
2019-04-25 07:15,77,26,51,0,0,0
2019-04-25 07:30,119,31,88,0,0,0
2019-04-25 07:45,216,56,160,0,0,0
2019-04-25 08:00,292,78,214,0,0,0
2019-04-25 08:15,138,59,79,0,0,0
2019-04-25 08:30,98,39,59,0,0,0
2019-04-25 08:45,133,61,72,0,0,0
2019-04-25 09:00,150,55,95,0,0,0
2019-04-25 09:15,77,37,40,0,0,0
2019-04-25 09:30,99,58,41,0,0,0
2019-04-25 09:45,252,122,130,0,0,0
2019-04-25 10:00,245,117,128,0,0,0
2019-04-25 10:15,114,58,56,0,0,0
2019-04-25 10:30,111,52,59,0,0,0
2019-04-25 10:45,73,35,38,0,0,0
2019-04-25 11:00,81,40,41,0,0,0
2019-04-25 11:15,98,55,43,0,0,0
2019-04-25 11:30,114,64,50,0,0,0
2019-04-25 11:45,249,111,138,0,0,0
2019-04-25 12:00,203,120,83,0,0,0
2019-04-25 12:15,132,73,59,0,0,0
2019-04-25 12:30,98,50,48,0,0,0
2019-04-25 12:45,116,47,69,0,0,0
2019-04-25 13:00,115,66,49,0,0,0
2019-04-25 13:15,95,44,51,0,0,0
2019-04-25 13:30,160,73,87,0,0,0
2019-04-25 13:45,231,91,140,0,0,0
2019-04-25 14:00,197,79,118,0,0,0
2019-04-25 14:15,134,83,51,0,0,0
2019-04-25 14:30,111,55,56,0,0,0
2019-04-25 14:45,128,70,58,0,0,0
2019-04-25 15:00,107,42,65,0,0,0
2019-04-25 15:15,130,77,53,0,0,0
2019-04-25 15:30,155,104,51,0,0,0
2019-04-25 15:45,274,175,99,0,0,0
2019-04-25 16:00,223,139,84,0,0,0
2019-04-25 16:15,149,102,47,0,0,0
2019-04-25 16:30,130,79,51,0,0,0
2019-04-25 16:45,131,66,65,0,0,0
2019-04-25 17:00,150,80,70,0,0,0
2019-04-25 17:15,131,70,61,0,0,0
2019-04-25 17:30,174,102,72,0,0,0
2019-04-25 17:45,201,114,87,0,0,0
2019-04-25 18:00,158,61,97,0,0,0
2019-04-25 18:15,112,47,65,0,0,0
2019-04-25 18:30,117,43,74,0,0,0
2019-04-25 18:45,125,63,62,0,0,0
2019-04-25 19:00,115,54,61,0,0,0
2019-04-25 19:15,98,43,55,0,0,0
2019-04-25 19:30,96,50,46,0,0,0
2019-04-25 19:45,70,28,42,0,0,0
2019-04-25 20:00,78,26,52,0,0,0
2019-04-25 20:15,56,26,30,0,0,0
2019-04-25 20:30,50,19,31,0,0,0
2019-04-25 20:45,44,17,27,0,0,0
2019-04-25 21:00,57,20,37,0,0,0
2019-04-25 21:15,39,15,24,0,0,0
2019-04-25 21:30,42,15,27,0,0,0
2019-04-25 21:45,28,8,20,0,0,0
2019-04-25 22:00,41,6,35,0,0,0
2019-04-25 22:15,22,11,11,0,0,0
2019-04-25 22:30,26,8,18,0,0,0
2019-04-25 22:45,44,10,34,0,0,0
2019-04-25 23:00,20,14,6,0,0,0
2019-04-25 23:15,26,11,15,0,0,0
2019-04-25 23:30,18,5,13,0,0,0
2019-04-25 23:45,17,6,11,0,0,0
2019-04-26 00:00,12,2,10,0,0,0
2019-04-26 00:15,14,4,10,0,0,0
2019-04-26 00:30,13,7,6,0,0,0
2019-04-26 00:45,11,2,9,0,0,0
2019-04-26 01:00,5,1,4,0,0,0
2019-04-26 01:15,4,0,4,0,0,0
2019-04-26 01:30,4,0,4,0,0,0
2019-04-26 01:45,3,3,0,0,0,0
2019-04-26 02:00,2,2,0,0,0,0
2019-04-26 02:15,5,4,1,0,0,0
2019-04-26 02:30,3,1,2,0,0,0
2019-04-26 02:45,2,0,2,0,0,0
2019-04-26 03:00,1,0,1,0,0,0
2019-04-26 03:15,1,1,0,0,0,0
2019-04-26 03:30,0,0,0,0,0,0
2019-04-26 03:45,0,0,0,0,0,0
2019-04-26 04:00,4,3,1,0,0,0
2019-04-26 04:15,0,0,0,0,0,0
2019-04-26 04:30,1,0,1,0,0,0
2019-04-26 04:45,3,2,1,0,0,0
2019-04-26 05:00,0,0,0,0,0,0
2019-04-26 05:15,3,2,1,0,0,0
2019-04-26 05:30,7,4,3,0,0,0
2019-04-26 05:45,5,0,5,0,0,0
2019-04-26 06:00,13,6,7,0,0,0
2019-04-26 06:15,20,13,7,0,0,0
2019-04-26 06:30,27,15,12,0,0,0
2019-04-26 06:45,48,20,28,0,0,0
2019-04-26 07:00,51,23,28,0,0,0
2019-04-26 07:15,79,24,55,0,0,0
2019-04-26 07:30,93,28,65,0,0,0
2019-04-26 07:45,177,48,129,0,0,0
2019-04-26 08:00,257,56,201,0,0,0
2019-04-26 08:15,100,25,75,0,0,0
2019-04-26 08:30,90,42,48,0,0,0
2019-04-26 08:45,112,31,81,0,0,0
2019-04-26 09:00,89,31,58,0,0,0
2019-04-26 09:15,46,19,27,0,0,0
2019-04-26 09:30,66,35,31,0,0,0
2019-04-26 09:45,199,71,128,0,0,0
2019-04-26 10:00,292,116,176,0,0,0
2019-04-26 10:15,67,28,39,0,0,0
2019-04-26 10:30,62,25,37,0,0,0
2019-04-26 10:45,71,42,29,0,0,0
2019-04-26 11:00,71,38,33,0,0,0
2019-04-26 11:15,96,68,28,0,0,0
2019-04-26 11:30,79,42,37,0,0,0
2019-04-26 11:45,162,102,60,0,0,0
2019-04-26 12:00,155,93,62,0,0,0
2019-04-26 12:15,106,53,53,0,0,0
2019-04-26 12:30,128,73,55,0,0,0
2019-04-26 12:45,106,57,49,0,0,0
2019-04-26 13:00,150,69,81,0,0,0
2019-04-26 13:15,117,72,45,0,0,0
2019-04-26 13:30,98,51,47,0,0,0
2019-04-26 13:45,176,96,80,0,0,0
2019-04-26 14:00,141,80,61,0,0,0
2019-04-26 14:15,99,44,55,0,0,0
2019-04-26 14:30,91,43,48,0,0,0
2019-04-26 14:45,112,55,57,0,0,0
2019-04-26 15:00,113,65,48,0,0,0
2019-04-26 15:15,117,80,37,0,0,0
2019-04-26 15:30,95,54,41,0,0,0
2019-04-26 15:45,110,68,42,0,0,0
2019-04-26 16:00,138,75,63,0,0,0
2019-04-26 16:15,83,38,45,0,0,0
2019-04-26 16:30,119,68,51,0,0,0
2019-04-26 16:45,104,53,51,0,0,0
2019-04-26 17:00,113,64,49,0,0,0
2019-04-26 17:15,83,38,45,0,0,0
2019-04-26 17:30,100,56,44,0,0,0
2019-04-26 17:45,110,55,55,0,0,0
2019-04-26 18:00,99,56,43,0,0,0
2019-04-26 18:15,74,37,37,0,0,0
2019-04-26 18:30,89,32,57,0,0,0
2019-04-26 18:45,95,41,54,0,0,0
2019-04-26 19:00,74,33,41,0,0,0
2019-04-26 19:15,79,30,49,0,0,0
2019-04-26 19:30,65,37,28,0,0,0
2019-04-26 19:45,49,28,21,0,0,0
2019-04-26 20:00,73,23,50,0,0,0
2019-04-26 20:15,60,35,25,0,0,0
2019-04-26 20:30,37,16,21,0,0,0
2019-04-26 20:45,38,20,18,0,0,0
2019-04-26 21:00,35,14,21,0,0,0
2019-04-26 21:15,24,11,13,0,0,0
2019-04-26 21:30,36,11,25,0,0,0
2019-04-26 21:45,26,14,12,0,0,0
2019-04-26 22:00,36,8,28,0,0,0
2019-04-26 22:15,21,11,10,0,0,0
2019-04-26 22:30,14,3,11,0,0,0
2019-04-26 22:45,20,3,17,0,0,0
2019-04-26 23:00,20,5,15,0,0,0
2019-04-26 23:15,29,16,13,0,0,0
2019-04-26 23:30,22,5,17,0,0,0
2019-04-26 23:45,10,3,7,0,0,0
2019-04-27 00:00,28,8,20,0,0,0
2019-04-27 00:15,12,4,8,0,0,0
2019-04-27 00:30,13,5,8,0,0,0
2019-04-27 00:45,16,6,10,0,0,0
2019-04-27 01:00,16,3,13,0,0,0
2019-04-27 01:15,8,0,8,0,0,0
2019-04-27 01:30,6,0,6,0,0,0
2019-04-27 01:45,5,0,5,0,0,0
2019-04-27 02:00,11,1,10,0,0,0
2019-04-27 02:15,9,5,4,0,0,0
2019-04-27 02:30,9,1,8,0,0,0
2019-04-27 02:45,12,3,9,0,0,0
2019-04-27 03:00,10,4,6,0,0,0
2019-04-27 03:15,6,0,6,0,0,0
2019-04-27 03:30,4,3,1,0,0,0
2019-04-27 03:45,4,1,3,0,0,0
2019-04-27 04:00,1,0,1,0,0,0
2019-04-27 04:15,3,0,3,0,0,0
2019-04-27 04:30,5,0,5,0,0,0
2019-04-27 04:45,11,3,8,0,0,0
2019-04-27 05:00,2,0,2,0,0,0
2019-04-27 05:15,7,4,3,0,0,0
2019-04-27 05:30,7,1,6,0,0,0
2019-04-27 05:45,9,2,7,0,0,0
2019-04-27 06:00,4,3,1,0,0,0
2019-04-27 06:15,5,5,0,0,0,0
2019-04-27 06:30,6,4,2,0,0,0
2019-04-27 06:45,12,7,5,0,0,0
2019-04-27 07:00,9,5,4,0,0,0
2019-04-27 07:15,8,2,6,0,0,0
2019-04-27 07:30,18,6,12,0,0,0
2019-04-27 07:45,28,18,10,0,0,0
2019-04-27 08:00,20,9,11,0,0,0
2019-04-27 08:15,22,12,10,0,0,0
2019-04-27 08:30,41,27,14,0,0,0
2019-04-27 08:45,60,24,36,0,0,0
2019-04-27 09:00,38,20,18,0,0,0
2019-04-27 09:15,57,29,28,0,0,0
2019-04-27 09:30,61,35,26,0,0,0
2019-04-27 09:45,84,59,25,0,0,0
2019-04-27 10:00,40,24,16,0,0,0
2019-04-27 10:15,49,31,18,0,0,0
2019-04-27 10:30,44,24,20,0,0,0
2019-04-27 10:45,54,26,28,0,0,0
2019-04-27 11:00,39,23,16,0,0,0
2019-04-27 11:15,39,28,11,0,0,0
2019-04-27 11:30,29,16,13,0,0,0
2019-04-27 11:45,52,30,22,0,0,0
2019-04-27 12:00,53,18,35,0,0,0
2019-04-27 12:15,41,15,26,0,0,0
2019-04-27 12:30,42,15,27,0,0,0
2019-04-27 12:45,50,25,25,0,0,0
2019-04-27 13:00,53,26,27,0,0,0
2019-04-27 13:15,46,19,27,0,0,0
2019-04-27 13:30,52,24,28,0,0,0
2019-04-27 13:45,49,22,27,0,0,0
2019-04-27 14:00,53,22,31,0,0,0
2019-04-27 14:15,53,16,37,0,0,0
2019-04-27 14:30,45,21,24,0,0,0
2019-04-27 14:45,42,23,19,0,0,0
2019-04-27 15:00,37,12,25,0,0,0
2019-04-27 15:15,40,25,15,0,0,0
2019-04-27 15:30,40,26,14,0,0,0
2019-04-27 15:45,44,18,26,0,0,0
2019-04-27 16:00,30,13,17,0,0,0
2019-04-27 16:15,51,27,24,0,0,0
2019-04-27 16:30,46,24,22,0,0,0
2019-04-27 16:45,44,20,24,0,0,0
2019-04-27 17:00,54,21,33,0,0,0
2019-04-27 17:15,46,22,24,0,0,0
2019-04-27 17:30,58,32,26,0,0,0
2019-04-27 17:45,55,17,38,0,0,0
2019-04-27 18:00,44,12,32,0,0,0
2019-04-27 18:15,19,7,12,0,0,0
2019-04-27 18:30,27,7,20,0,0,0
2019-04-27 18:45,52,25,27,0,0,0
2019-04-27 19:00,32,12,20,0,0,0
2019-04-27 19:15,36,15,21,0,0,0
2019-04-27 19:30,27,13,14,0,0,0
2019-04-27 19:45,37,18,19,0,0,0
2019-04-27 20:00,48,20,28,0,0,0
2019-04-27 20:15,31,17,14,0,0,0
2019-04-27 20:30,14,8,6,0,0,0
2019-04-27 20:45,44,24,20,0,0,0
2019-04-27 21:00,21,3,18,0,0,0
2019-04-27 21:15,42,18,24,0,0,0
2019-04-27 21:30,26,11,15,0,0,0
2019-04-27 21:45,12,6,6,0,0,0
2019-04-27 22:00,27,5,22,0,0,0
2019-04-27 22:15,35,17,18,0,0,0
2019-04-27 22:30,12,4,8,0,0,0
2019-04-27 22:45,21,11,10,0,0,0
2019-04-27 23:00,14,4,10,0,0,0
2019-04-27 23:15,11,4,7,0,0,0
2019-04-27 23:30,19,2,17,0,0,0
2019-04-27 23:45,17,2,15,0,0,0
2019-04-28 00:00,12,3,9,0,0,0
2019-04-28 00:15,16,5,11,0,0,0
2019-04-28 00:30,16,5,11,0,0,0
2019-04-28 00:45,19,0,19,0,0,0
2019-04-28 01:00,18,6,12,0,0,0
2019-04-28 01:15,17,5,12,0,0,0
2019-04-28 01:30,15,7,8,0,0,0
2019-04-28 01:45,14,6,8,0,0,0
2019-04-28 02:00,5,2,3,0,0,0
2019-04-28 02:15,12,7,5,0,0,0
2019-04-28 02:30,11,1,10,0,0,0
2019-04-28 02:45,8,6,2,0,0,0
2019-04-28 03:00,14,5,9,0,0,0
2019-04-28 03:15,9,7,2,0,0,0
2019-04-28 03:30,6,1,5,0,0,0
2019-04-28 03:45,8,2,6,0,0,0
2019-04-28 04:00,1,0,1,0,0,0
2019-04-28 04:15,7,1,6,0,0,0
2019-04-28 04:30,4,0,4,0,0,0
2019-04-28 04:45,1,0,1,0,0,0
2019-04-28 05:00,2,0,2,0,0,0
2019-04-28 05:15,7,2,5,0,0,0
2019-04-28 05:30,7,2,5,0,0,0
2019-04-28 05:45,6,0,6,0,0,0
2019-04-28 06:00,3,1,2,0,0,0
2019-04-28 06:15,7,2,5,0,0,0
2019-04-28 06:30,13,9,4,0,0,0
2019-04-28 06:45,3,1,2,0,0,0
2019-04-28 07:00,3,3,0,0,0,0
2019-04-28 07:15,5,0,5,0,0,0
2019-04-28 07:30,2,0,2,0,0,0
2019-04-28 07:45,11,5,6,0,0,0
2019-04-28 08:00,13,7,6,0,0,0
2019-04-28 08:15,7,1,6,0,0,0
2019-04-28 08:30,3,1,2,0,0,0
2019-04-28 08:45,23,7,16,0,0,0
2019-04-28 09:00,12,3,9,0,0,0
2019-04-28 09:15,23,11,12,0,0,0
2019-04-28 09:30,15,7,8,0,0,0
2019-04-28 09:45,39,29,10,0,0,0
2019-04-28 10:00,31,23,8,0,0,0
2019-04-28 10:15,22,9,13,0,0,0
2019-04-28 10:30,22,11,11,0,0,0
2019-04-28 10:45,30,14,16,0,0,0
2019-04-28 11:00,19,9,10,0,0,0
2019-04-28 11:15,31,11,20,0,0,0
2019-04-28 11:30,24,14,10,0,0,0
2019-04-28 11:45,24,14,10,0,0,0
2019-04-28 12:00,31,22,9,0,0,0
2019-04-28 12:15,39,25,14,0,0,0
2019-04-28 12:30,41,18,23,0,0,0
2019-04-28 12:45,68,23,45,0,0,0
2019-04-28 13:00,24,10,14,0,0,0
2019-04-28 13:15,26,14,12,0,0,0
2019-04-28 13:30,49,19,30,0,0,0
2019-04-28 13:45,34,20,14,0,0,0
2019-04-28 14:00,25,15,10,0,0,0
2019-04-28 14:15,45,21,24,0,0,0
2019-04-28 14:30,30,13,17,0,0,0
2019-04-28 14:45,48,32,16,0,0,0
2019-04-28 15:00,33,23,10,0,0,0
2019-04-28 15:15,35,13,22,0,0,0
2019-04-28 15:30,43,17,26,0,0,0
2019-04-28 15:45,43,17,26,0,0,0
2019-04-28 16:00,40,16,24,0,0,0
2019-04-28 16:15,41,18,23,0,0,0
2019-04-28 16:30,29,13,16,0,0,0
2019-04-28 16:45,48,24,24,0,0,0
2019-04-28 17:00,20,5,15,0,0,0
2019-04-28 17:15,43,16,27,0,0,0
2019-04-28 17:30,40,16,24,0,0,0
2019-04-28 17:45,52,18,34,0,0,0
2019-04-28 18:00,43,16,27,0,0,0
2019-04-28 18:15,46,23,23,0,0,0
2019-04-28 18:30,35,10,25,0,0,0
2019-04-28 18:45,28,11,17,0,0,0
2019-04-28 19:00,57,21,36,0,0,0
2019-04-28 19:15,48,24,24,0,0,0
2019-04-28 19:30,36,13,23,0,0,0
2019-04-28 19:45,23,4,19,0,0,0
2019-04-28 20:00,50,16,34,0,0,0
2019-04-28 20:15,54,18,36,0,0,0
2019-04-28 20:30,24,8,16,0,0,0
2019-04-28 20:45,32,11,21,0,0,0
2019-04-28 21:00,18,9,9,0,0,0
2019-04-28 21:15,15,5,10,0,0,0
2019-04-28 21:30,14,3,11,0,0,0
2019-04-28 21:45,12,5,7,0,0,0
2019-04-28 22:00,19,8,11,0,0,0
2019-04-28 22:15,17,10,7,0,0,0
2019-04-28 22:30,12,6,6,0,0,0
2019-04-28 22:45,10,7,3,0,0,0
2019-04-28 23:00,15,4,11,0,0,0
2019-04-28 23:15,15,11,4,0,0,0
2019-04-28 23:30,7,3,4,0,0,0
2019-04-28 23:45,4,2,2,0,0,0
2019-04-29 00:00,6,1,5,0,0,0
2019-04-29 00:15,5,0,5,0,0,0
2019-04-29 00:30,4,0,4,0,0,0
2019-04-29 00:45,5,0,5,0,0,0
2019-04-29 01:00,2,1,1,0,0,0
2019-04-29 01:15,0,0,0,0,0,0
2019-04-29 01:30,1,0,1,0,0,0
2019-04-29 01:45,0,0,0,0,0,0
2019-04-29 02:00,0,0,0,0,0,0
2019-04-29 02:15,1,0,1,0,0,0
2019-04-29 02:30,0,0,0,0,0,0
2019-04-29 02:45,0,0,0,0,0,0
2019-04-29 03:00,0,0,0,0,0,0
2019-04-29 03:15,2,2,0,0,0,0
2019-04-29 03:30,0,0,0,0,0,0
2019-04-29 03:45,2,0,2,0,0,0
2019-04-29 04:00,0,0,0,0,0,0
2019-04-29 04:15,0,0,0,0,0,0
2019-04-29 04:30,4,0,4,0,0,0
2019-04-29 04:45,2,1,1,0,0,0
2019-04-29 05:00,0,0,0,0,0,0
2019-04-29 05:15,4,0,4,0,0,0
2019-04-29 05:30,14,1,13,0,0,0
2019-04-29 05:45,13,2,11,0,0,0
2019-04-29 06:00,5,5,0,0,0,0
2019-04-29 06:15,26,10,16,0,0,0
2019-04-29 06:30,37,14,23,0,0,0
2019-04-29 06:45,46,12,34,0,0,0
2019-04-29 07:00,80,31,49,0,0,0
2019-04-29 07:15,114,64,50,0,0,0
2019-04-29 07:30,283,186,97,0,0,0
2019-04-29 07:45,209,74,135,0,0,0
2019-04-29 08:00,284,75,209,0,0,0
2019-04-29 08:15,176,61,115,0,0,0
2019-04-29 08:30,136,55,81,0,0,0
2019-04-29 08:45,163,64,99,0,0,0
2019-04-29 09:00,167,74,93,0,0,0
2019-04-29 09:15,112,63,49,0,0,0
2019-04-29 09:30,111,63,48,0,0,0
2019-04-29 09:45,198,89,109,0,0,0
2019-04-29 10:00,251,107,144,0,0,0
2019-04-29 10:15,97,53,44,0,0,0
2019-04-29 10:30,61,34,27,0,0,0
2019-04-29 10:45,76,29,47,0,0,0
2019-04-29 11:00,103,53,50,0,0,0
2019-04-29 11:15,105,55,50,0,0,0
2019-04-29 11:30,113,42,71,0,0,0
2019-04-29 11:45,241,133,108,0,0,0
2019-04-29 12:00,197,96,101,0,0,0
2019-04-29 12:15,165,72,93,0,0,0
2019-04-29 12:30,130,51,79,0,0,0
2019-04-29 12:45,93,35,58,0,0,0
2019-04-29 13:00,140,60,80,0,0,0
2019-04-29 13:15,156,53,103,0,0,0
2019-04-29 13:30,137,58,79,0,0,0
2019-04-29 13:45,257,115,142,0,0,0
2019-04-29 14:00,203,82,121,0,0,0
2019-04-29 14:15,111,54,57,0,0,0
2019-04-29 14:30,114,44,70,0,0,0
2019-04-29 14:45,141,57,84,0,0,0
2019-04-29 15:00,129,59,70,0,0,0
2019-04-29 15:15,138,79,59,0,0,0
2019-04-29 15:30,137,71,66,0,0,0
2019-04-29 15:45,301,166,135,0,0,0
2019-04-29 16:00,239,145,94,0,0,0
2019-04-29 16:15,137,81,56,0,0,0
2019-04-29 16:30,143,64,79,0,0,0
2019-04-29 16:45,194,112,82,0,0,0
2019-04-29 17:00,143,68,75,0,0,0
2019-04-29 17:15,156,77,79,0,0,0
2019-04-29 17:30,149,81,68,0,0,0
2019-04-29 17:45,262,156,106,0,0,0
2019-04-29 18:00,205,105,100,0,0,0
2019-04-29 18:15,134,47,87,0,0,0
2019-04-29 18:30,98,42,56,0,0,0
2019-04-29 18:45,113,49,64,0,0,0
2019-04-29 19:00,100,41,59,0,0,0
2019-04-29 19:15,81,35,46,0,0,0
2019-04-29 19:30,87,35,52,0,0,0
2019-04-29 19:45,109,47,62,0,0,0
2019-04-29 20:00,80,33,47,0,0,0
2019-04-29 20:15,79,31,48,0,0,0
2019-04-29 20:30,56,24,32,0,0,0
2019-04-29 20:45,51,18,33,0,0,0
2019-04-29 21:00,42,14,28,0,0,0
2019-04-29 21:15,36,18,18,0,0,0
2019-04-29 21:30,27,6,21,0,0,0
2019-04-29 21:45,39,14,25,0,0,0
2019-04-29 22:00,44,13,31,0,0,0
2019-04-29 22:15,29,10,19,0,0,0
2019-04-29 22:30,23,4,19,0,0,0
2019-04-29 22:45,20,4,16,0,0,0
2019-04-29 23:00,15,8,7,0,0,0
2019-04-29 23:15,21,4,17,0,0,0
2019-04-29 23:30,16,3,13,0,0,0
2019-04-29 23:45,10,4,6,0,0,0
2019-04-30 00:00,10,1,9,0,0,0
2019-04-30 00:15,6,6,0,0,0,0
2019-04-30 00:30,7,5,2,0,0,0
2019-04-30 00:45,12,3,9,0,0,0
2019-04-30 01:00,3,3,0,0,0,0
2019-04-30 01:15,2,1,1,0,0,0
2019-04-30 01:30,1,0,1,0,0,0
2019-04-30 01:45,0,0,0,0,0,0
2019-04-30 02:00,1,1,0,0,0,0
2019-04-30 02:15,1,0,1,0,0,0
2019-04-30 02:30,0,0,0,0,0,0
2019-04-30 02:45,0,0,0,0,0,0
2019-04-30 03:00,0,0,0,0,0,0
2019-04-30 03:15,1,1,0,0,0,0
2019-04-30 03:30,1,0,1,0,0,0
2019-04-30 03:45,0,0,0,0,0,0
2019-04-30 04:00,0,0,0,0,0,0
2019-04-30 04:15,0,0,0,0,0,0
2019-04-30 04:30,3,1,2,0,0,0
2019-04-30 04:45,1,0,1,0,0,0
2019-04-30 05:00,0,0,0,0,0,0
2019-04-30 05:15,5,0,5,0,0,0
2019-04-30 05:30,9,0,9,0,0,0
2019-04-30 05:45,10,2,8,0,0,0
2019-04-30 06:00,11,7,4,0,0,0
2019-04-30 06:15,24,14,10,0,0,0
2019-04-30 06:30,34,12,22,0,0,0
2019-04-30 06:45,44,15,29,0,0,0
2019-04-30 07:00,80,29,51,0,0,0
2019-04-30 07:15,106,41,65,0,0,0
2019-04-30 07:30,236,164,72,0,0,0
2019-04-30 07:45,294,107,187,0,0,0
2019-04-30 08:00,339,98,241,0,0,0
2019-04-30 08:15,195,72,123,0,0,0
2019-04-30 08:30,131,49,82,0,0,0
2019-04-30 08:45,162,63,99,0,0,0
2019-04-30 09:00,181,65,116,0,0,0
2019-04-30 09:15,109,57,52,0,0,0
2019-04-30 09:30,139,40,99,0,0,0
2019-04-30 09:45,264,86,178,0,0,0
2019-04-30 10:00,310,118,192,0,0,0
2019-04-30 10:15,121,69,52,0,0,0
2019-04-30 10:30,88,38,50,0,0,0
2019-04-30 10:45,128,67,61,0,0,0
2019-04-30 11:00,104,52,52,0,0,0
2019-04-30 11:15,113,51,62,0,0,0
2019-04-30 11:30,125,65,60,0,0,0
2019-04-30 11:45,302,156,146,0,0,0
2019-04-30 12:00,277,133,144,0,0,0
2019-04-30 12:15,140,63,77,0,0,0
2019-04-30 12:30,126,65,61,0,0,0
2019-04-30 12:45,170,75,95,0,0,0
2019-04-30 13:00,194,88,106,0,0,0
2019-04-30 13:15,204,58,146,0,0,0
2019-04-30 13:30,176,82,94,0,0,0
2019-04-30 13:45,320,163,157,0,0,0
2019-04-30 14:00,274,118,156,0,0,0
2019-04-30 14:15,146,73,73,0,0,0
2019-04-30 14:30,131,63,68,0,0,0
2019-04-30 14:45,130,70,60,0,0,0
2019-04-30 15:00,108,50,58,0,0,0
2019-04-30 15:15,137,77,60,0,0,0
2019-04-30 15:30,203,101,102,0,0,0
2019-04-30 15:45,301,159,142,0,0,0
2019-04-30 16:00,231,118,113,0,0,0
2019-04-30 16:15,179,101,78,0,0,0
2019-04-30 16:30,158,84,74,0,0,0
2019-04-30 16:45,159,89,70,0,0,0
2019-04-30 17:00,167,97,70,0,0,0
2019-04-30 17:15,171,91,80,0,0,0
2019-04-30 17:30,159,87,72,0,0,0
2019-04-30 17:45,259,142,117,0,0,0
2019-04-30 18:00,195,91,104,0,0,0
2019-04-30 18:15,128,58,70,0,0,0
2019-04-30 18:30,108,40,68,0,0,0
2019-04-30 18:45,112,57,55,0,0,0
2019-04-30 19:00,86,30,56,0,0,0
2019-04-30 19:15,119,76,43,0,0,0
2019-04-30 19:30,126,57,69,0,0,0
2019-04-30 19:45,158,96,62,0,0,0
2019-04-30 20:00,101,39,62,0,0,0
2019-04-30 20:15,71,36,35,0,0,0
2019-04-30 20:30,68,39,29,0,0,0
2019-04-30 20:45,73,52,21,0,0,0
2019-04-30 21:00,74,40,34,0,0,0
2019-04-30 21:15,50,14,36,0,0,0
2019-04-30 21:30,43,15,28,0,0,0
2019-04-30 21:45,58,24,34,0,0,0
2019-04-30 22:00,69,42,27,0,0,0
2019-04-30 22:15,43,15,28,0,0,0
2019-04-30 22:30,26,11,15,0,0,0
2019-04-30 22:45,32,13,19,0,0,0
2019-04-30 23:00,33,11,22,0,0,0
2019-04-30 23:15,31,15,16,0,0,0
2019-04-30 23:30,27,14,13,0,0,0
2019-04-30 23:45,19,7,12,0,0,0
