Datetime,100034982 (Hüfferstraße),101034982 (Hüfferstraße stadteinwärts),102034982 (Hüfferstraße stadtauswärts),100034982-status,101034982-status,102034982-status
2021-12-01 00:00,4,1,3,0,0,0
2021-12-01 00:15,2,1,1,0,0,0
2021-12-01 00:30,2,0,2,0,0,0
2021-12-01 00:45,3,0,3,0,0,0
2021-12-01 01:00,1,0,1,0,0,0
2021-12-01 01:15,3,1,2,0,0,0
2021-12-01 01:30,1,0,1,0,0,0
2021-12-01 01:45,0,0,0,0,0,0
2021-12-01 02:00,0,0,0,0,0,0
2021-12-01 02:15,0,0,0,0,0,0
2021-12-01 02:30,1,1,0,0,0,0
2021-12-01 02:45,0,0,0,0,0,0
2021-12-01 03:00,0,0,0,0,0,0
2021-12-01 03:15,2,2,0,0,0,0
2021-12-01 03:30,0,0,0,0,0,0
2021-12-01 03:45,0,0,0,0,0,0
2021-12-01 04:00,2,0,2,0,0,0
2021-12-01 04:15,0,0,0,0,0,0
2021-12-01 04:30,1,0,1,0,0,0
2021-12-01 04:45,0,0,0,0,0,0
2021-12-01 05:00,0,0,0,0,0,0
2021-12-01 05:15,1,1,0,0,0,0
2021-12-01 05:30,9,1,8,0,0,0
2021-12-01 05:45,7,5,2,0,0,0
2021-12-01 06:00,4,0,4,0,0,0
2021-12-01 06:15,11,6,5,0,0,0
2021-12-01 06:30,29,13,16,0,0,0
2021-12-01 06:45,45,18,27,0,0,0
2021-12-01 07:00,42,12,30,0,0,0
2021-12-01 07:15,58,25,33,0,0,0
2021-12-01 07:30,103,53,50,0,0,0
2021-12-01 07:45,218,100,118,0,0,0
2021-12-01 08:00,278,151,127,0,0,0
2021-12-01 08:15,110,50,60,0,0,0
2021-12-01 08:30,96,39,57,0,0,0
2021-12-01 08:45,112,62,50,0,0,0
2021-12-01 09:00,103,47,56,0,0,0
2021-12-01 09:15,72,31,41,0,0,0
2021-12-01 09:30,63,33,30,0,0,0
2021-12-01 09:45,137,63,74,0,0,0
2021-12-01 10:00,183,73,110,0,0,0
2021-12-01 10:15,58,31,27,0,0,0
2021-12-01 10:30,42,20,22,0,0,0
2021-12-01 10:45,68,34,34,0,0,0
2021-12-01 11:00,53,35,18,0,0,0
2021-12-01 11:15,61,22,39,0,0,0
2021-12-01 11:30,82,50,32,0,0,0
2021-12-01 11:45,150,74,76,0,0,0
2021-12-01 12:00,167,86,81,0,0,0
2021-12-01 12:15,78,34,44,0,0,0
2021-12-01 12:30,83,35,48,0,0,0
2021-12-01 12:45,102,53,49,0,0,0
2021-12-01 13:00,115,44,71,0,0,0
2021-12-01 13:15,70,28,42,0,0,0
2021-12-01 13:30,127,46,81,0,0,0
2021-12-01 13:45,154,71,83,0,0,0
2021-12-01 14:00,159,60,99,0,0,0
2021-12-01 14:15,118,64,54,0,0,0
2021-12-01 14:30,115,50,65,0,0,0
2021-12-01 14:45,94,55,39,0,0,0
2021-12-01 15:00,93,50,43,0,0,0
2021-12-01 15:15,100,52,48,0,0,0
2021-12-01 15:30,135,75,60,0,0,0
2021-12-01 15:45,157,86,71,0,0,0
2021-12-01 16:00,156,82,74,0,0,0
2021-12-01 16:15,126,65,61,0,0,0
2021-12-01 16:30,103,60,43,0,0,0
2021-12-01 16:45,96,55,41,0,0,0
2021-12-01 17:00,112,73,39,0,0,0
2021-12-01 17:15,92,42,50,0,0,0
2021-12-01 17:30,105,62,43,0,0,0
2021-12-01 17:45,173,119,54,0,0,0
2021-12-01 18:00,154,97,57,0,0,0
2021-12-01 18:15,86,41,45,0,0,0
2021-12-01 18:30,57,22,35,0,0,0
2021-12-01 18:45,97,48,49,0,0,0
2021-12-01 19:00,62,37,25,0,0,0
2021-12-01 19:15,59,28,31,0,0,0
2021-12-01 19:30,62,20,42,0,0,0
2021-12-01 19:45,84,35,49,0,0,0
2021-12-01 20:00,58,18,40,0,0,0
2021-12-01 20:15,66,28,38,0,0,0
2021-12-01 20:30,49,28,21,0,0,0
2021-12-01 20:45,24,10,14,0,0,0
2021-12-01 21:00,30,11,19,0,0,0
2021-12-01 21:15,15,8,7,0,0,0
2021-12-01 21:30,14,7,7,0,0,0
2021-12-01 21:45,26,9,17,0,0,0
2021-12-01 22:00,17,2,15,0,0,0
2021-12-01 22:15,21,10,11,0,0,0
2021-12-01 22:30,12,7,5,0,0,0
2021-12-01 22:45,15,7,8,0,0,0
2021-12-01 23:00,10,0,10,0,0,0
2021-12-01 23:15,10,4,6,0,0,0
2021-12-01 23:30,13,7,6,0,0,0
2021-12-01 23:45,21,7,14,0,0,0
2021-12-02 00:00,7,2,5,0,0,0
2021-12-02 00:15,5,0,5,0,0,0
2021-12-02 00:30,7,0,7,0,0,0
2021-12-02 00:45,10,1,9,0,0,0
2021-12-02 01:00,4,0,4,0,0,0
2021-12-02 01:15,4,1,3,0,0,0
2021-12-02 01:30,3,1,2,0,0,0
2021-12-02 01:45,2,0,2,0,0,0
2021-12-02 02:00,1,0,1,0,0,0
2021-12-02 02:15,4,1,3,0,0,0
2021-12-02 02:30,0,0,0,0,0,0
2021-12-02 02:45,2,0,2,0,0,0
2021-12-02 03:00,4,1,3,0,0,0
2021-12-02 03:15,3,0,3,0,0,0
2021-12-02 03:30,1,1,0,0,0,0
2021-12-02 03:45,2,0,2,0,0,0
2021-12-02 04:00,0,0,0,0,0,0
2021-12-02 04:15,3,0,3,0,0,0
2021-12-02 04:30,1,1,0,0,0,0
2021-12-02 04:45,3,1,2,0,0,0
2021-12-02 05:00,0,0,0,0,0,0
2021-12-02 05:15,0,0,0,0,0,0
2021-12-02 05:30,6,4,2,0,0,0
2021-12-02 05:45,8,2,6,0,0,0
2021-12-02 06:00,4,4,0,0,0,0
2021-12-02 06:15,24,5,19,0,0,0
2021-12-02 06:30,25,11,14,0,0,0
2021-12-02 06:45,45,14,31,0,0,0
2021-12-02 07:00,60,11,49,0,0,0
2021-12-02 07:15,73,32,41,0,0,0
2021-12-02 07:30,145,65,80,0,0,0
2021-12-02 07:45,243,112,131,0,0,0
2021-12-02 08:00,308,157,151,0,0,0
2021-12-02 08:15,145,61,84,0,0,0
2021-12-02 08:30,82,39,43,0,0,0
2021-12-02 08:45,121,47,74,0,0,0
2021-12-02 09:00,90,39,51,0,0,0
2021-12-02 09:15,68,38,30,0,0,0
2021-12-02 09:30,49,25,24,0,0,0
2021-12-02 09:45,128,70,58,0,0,0
2021-12-02 10:00,209,87,122,0,0,0
2021-12-02 10:15,59,29,30,0,0,0
2021-12-02 10:30,64,40,24,0,0,0
2021-12-02 10:45,72,42,30,0,0,0
2021-12-02 11:00,71,39,32,0,0,0
2021-12-02 11:15,51,24,27,0,0,0
2021-12-02 11:30,63,26,37,0,0,0
2021-12-02 11:45,141,55,86,0,0,0
2021-12-02 12:00,181,86,95,0,0,0
2021-12-02 12:15,104,55,49,0,0,0
2021-12-02 12:30,89,38,51,0,0,0
2021-12-02 12:45,106,45,61,0,0,0
2021-12-02 13:00,115,40,75,0,0,0
2021-12-02 13:15,71,26,45,0,0,0
2021-12-02 13:30,129,32,97,0,0,0
2021-12-02 13:45,188,91,97,0,0,0
2021-12-02 14:00,131,55,76,0,0,0
2021-12-02 14:15,85,34,51,0,0,0
2021-12-02 14:30,114,37,77,0,0,0
2021-12-02 14:45,73,36,37,0,0,0
2021-12-02 15:00,98,51,47,0,0,0
2021-12-02 15:15,95,49,46,0,0,0
2021-12-02 15:30,116,55,61,0,0,0
2021-12-02 15:45,223,138,85,0,0,0
2021-12-02 16:00,170,85,85,0,0,0
2021-12-02 16:15,106,56,50,0,0,0
2021-12-02 16:30,131,83,48,0,0,0
2021-12-02 16:45,137,77,60,0,0,0
2021-12-02 17:00,126,55,71,0,0,0
2021-12-02 17:15,106,66,40,0,0,0
2021-12-02 17:30,99,71,28,0,0,0
2021-12-02 17:45,172,90,82,0,0,0
2021-12-02 18:00,137,83,54,0,0,0
2021-12-02 18:15,99,47,52,0,0,0
2021-12-02 18:30,74,30,44,0,0,0
2021-12-02 18:45,80,46,34,0,0,0
2021-12-02 19:00,62,28,34,0,0,0
2021-12-02 19:15,59,28,31,0,0,0
2021-12-02 19:30,55,14,41,0,0,0
2021-12-02 19:45,73,21,52,0,0,0
2021-12-02 20:00,54,12,42,0,0,0
2021-12-02 20:15,67,14,53,0,0,0
2021-12-02 20:30,37,13,24,0,0,0
2021-12-02 20:45,41,6,35,0,0,0
2021-12-02 21:00,25,8,17,0,0,0
2021-12-02 21:15,31,15,16,0,0,0
2021-12-02 21:30,16,8,8,0,0,0
2021-12-02 21:45,18,3,15,0,0,0
2021-12-02 22:00,23,5,18,0,0,0
2021-12-02 22:15,24,7,17,0,0,0
2021-12-02 22:30,9,5,4,0,0,0
2021-12-02 22:45,13,2,11,0,0,0
2021-12-02 23:00,6,2,4,0,0,0
2021-12-02 23:15,9,2,7,0,0,0
2021-12-02 23:30,6,1,5,0,0,0
2021-12-02 23:45,2,0,2,0,0,0
2021-12-03 00:00,10,5,5,0,0,0
2021-12-03 00:15,5,1,4,0,0,0
2021-12-03 00:30,4,1,3,0,0,0
2021-12-03 00:45,1,0,1,0,0,0
2021-12-03 01:00,9,1,8,0,0,0
2021-12-03 01:15,6,4,2,0,0,0
2021-12-03 01:30,2,0,2,0,0,0
2021-12-03 01:45,1,0,1,0,0,0
2021-12-03 02:00,3,0,3,0,0,0
2021-12-03 02:15,0,0,0,0,0,0
2021-12-03 02:30,2,1,1,0,0,0
2021-12-03 02:45,0,0,0,0,0,0
2021-12-03 03:00,0,0,0,0,0,0
2021-12-03 03:15,0,0,0,0,0,0
2021-12-03 03:30,0,0,0,0,0,0
2021-12-03 03:45,2,0,2,0,0,0
2021-12-03 04:00,1,0,1,0,0,0
2021-12-03 04:15,0,0,0,0,0,0
2021-12-03 04:30,0,0,0,0,0,0
2021-12-03 04:45,1,1,0,0,0,0
2021-12-03 05:00,0,0,0,0,0,0
2021-12-03 05:15,0,0,0,0,0,0
2021-12-03 05:30,9,4,5,0,0,0
2021-12-03 05:45,5,1,4,0,0,0
2021-12-03 06:00,5,4,1,0,0,0
2021-12-03 06:15,16,6,10,0,0,0
2021-12-03 06:30,22,10,12,0,0,0
2021-12-03 06:45,34,10,24,0,0,0
2021-12-03 07:00,49,16,33,0,0,0
2021-12-03 07:15,52,24,28,0,0,0
2021-12-03 07:30,96,40,56,0,0,0
2021-12-03 07:45,202,94,108,0,0,0
2021-12-03 08:00,242,161,81,0,0,0
2021-12-03 08:15,121,57,64,0,0,0
2021-12-03 08:30,69,33,36,0,0,0
2021-12-03 08:45,114,56,58,0,0,0
2021-12-03 09:00,64,30,34,0,0,0
2021-12-03 09:15,84,36,48,0,0,0
2021-12-03 09:30,84,24,60,0,0,0
2021-12-03 09:45,118,47,71,0,0,0
2021-12-03 10:00,120,53,67,0,0,0
2021-12-03 10:15,71,42,29,0,0,0
2021-12-03 10:30,60,38,22,0,0,0
2021-12-03 10:45,77,42,35,0,0,0
2021-12-03 11:00,77,49,28,0,0,0
2021-12-03 11:15,70,37,33,0,0,0
2021-12-03 11:30,80,41,39,0,0,0
2021-12-03 11:45,104,62,42,0,0,0
2021-12-03 12:00,114,71,43,0,0,0
2021-12-03 12:15,88,41,47,0,0,0
2021-12-03 12:30,72,32,40,0,0,0
2021-12-03 12:45,94,36,58,0,0,0
2021-12-03 13:00,130,62,68,0,0,0
2021-12-03 13:15,89,32,57,0,0,0
2021-12-03 13:30,146,55,91,0,0,0
2021-12-03 13:45,142,55,87,0,0,0
2021-12-03 14:00,116,57,59,0,0,0
2021-12-03 14:15,97,49,48,0,0,0
2021-12-03 14:30,111,40,71,0,0,0
2021-12-03 14:45,99,53,46,0,0,0
2021-12-03 15:00,101,61,40,0,0,0
2021-12-03 15:15,125,50,75,0,0,0
2021-12-03 15:30,101,52,49,0,0,0
2021-12-03 15:45,122,76,46,0,0,0
2021-12-03 16:00,102,59,43,0,0,0
2021-12-03 16:15,104,53,51,0,0,0
2021-12-03 16:30,91,52,39,0,0,0
2021-12-03 16:45,97,59,38,0,0,0
2021-12-03 17:00,64,28,36,0,0,0
2021-12-03 17:15,66,33,33,0,0,0
2021-12-03 17:30,74,34,40,0,0,0
2021-12-03 17:45,71,34,37,0,0,0
2021-12-03 18:00,73,41,32,0,0,0
2021-12-03 18:15,49,16,33,0,0,0
2021-12-03 18:30,79,33,46,0,0,0
2021-12-03 18:45,72,39,33,0,0,0
2021-12-03 19:00,47,20,27,0,0,0
2021-12-03 19:15,37,20,17,0,0,0
2021-12-03 19:30,42,24,18,0,0,0
2021-12-03 19:45,41,18,23,0,0,0
2021-12-03 20:00,41,16,25,0,0,0
2021-12-03 20:15,35,8,27,0,0,0
2021-12-03 20:30,23,14,9,0,0,0
2021-12-03 20:45,39,18,21,0,0,0
2021-12-03 21:00,35,12,23,0,0,0
2021-12-03 21:15,31,12,19,0,0,0
2021-12-03 21:30,31,14,17,0,0,0
2021-12-03 21:45,16,3,13,0,0,0
2021-12-03 22:00,23,5,18,0,0,0
2021-12-03 22:15,14,2,12,0,0,0
2021-12-03 22:30,15,4,11,0,0,0
2021-12-03 22:45,9,1,8,0,0,0
2021-12-03 23:00,19,2,17,0,0,0
2021-12-03 23:15,9,1,8,0,0,0
2021-12-03 23:30,18,11,7,0,0,0
2021-12-03 23:45,13,2,11,0,0,0
2021-12-04 00:00,15,5,10,0,0,0
2021-12-04 00:15,9,3,6,0,0,0
2021-12-04 00:30,14,2,12,0,0,0
2021-12-04 00:45,4,0,4,0,0,0
2021-12-04 01:00,4,3,1,0,0,0
2021-12-04 01:15,4,1,3,0,0,0
2021-12-04 01:30,6,2,4,0,0,0
2021-12-04 01:45,8,1,7,0,0,0
2021-12-04 02:00,7,4,3,0,0,0
2021-12-04 02:15,2,0,2,0,0,0
2021-12-04 02:30,12,6,6,0,0,0
2021-12-04 02:45,1,1,0,0,0,0
2021-12-04 03:00,1,0,1,0,0,0
2021-12-04 03:15,4,1,3,0,0,0
2021-12-04 03:30,3,0,3,0,0,0
2021-12-04 03:45,8,1,7,0,0,0
2021-12-04 04:00,1,1,0,0,0,0
2021-12-04 04:15,2,1,1,0,0,0
2021-12-04 04:30,4,0,4,0,0,0
2021-12-04 04:45,2,1,1,0,0,0
2021-12-04 05:00,1,0,1,0,0,0
2021-12-04 05:15,3,0,3,0,0,0
2021-12-04 05:30,3,1,2,0,0,0
2021-12-04 05:45,5,2,3,0,0,0
2021-12-04 06:00,4,3,1,0,0,0
2021-12-04 06:15,1,0,1,0,0,0
2021-12-04 06:30,8,6,2,0,0,0
2021-12-04 06:45,7,6,1,0,0,0
2021-12-04 07:00,5,4,1,0,0,0
2021-12-04 07:15,7,4,3,0,0,0
2021-12-04 07:30,7,5,2,0,0,0
2021-12-04 07:45,14,5,9,0,0,0
2021-12-04 08:00,13,9,4,0,0,0
2021-12-04 08:15,20,15,5,0,0,0
2021-12-04 08:30,31,15,16,0,0,0
2021-12-04 08:45,36,25,11,0,0,0
2021-12-04 09:00,22,13,9,0,0,0
2021-12-04 09:15,38,30,8,0,0,0
2021-12-04 09:30,58,42,16,0,0,0
2021-12-04 09:45,55,43,12,0,0,0
2021-12-04 10:00,59,41,18,0,0,0
2021-12-04 10:15,48,32,16,0,0,0
2021-12-04 10:30,67,45,22,0,0,0
2021-12-04 10:45,54,31,23,0,0,0
2021-12-04 11:00,70,31,39,0,0,0
2021-12-04 11:15,67,38,29,0,0,0
2021-12-04 11:30,65,24,41,0,0,0
2021-12-04 11:45,76,47,29,0,0,0
2021-12-04 12:00,81,37,44,0,0,0
2021-12-04 12:15,94,44,50,0,0,0
2021-12-04 12:30,76,35,41,0,0,0
2021-12-04 12:45,79,32,47,0,0,0
2021-12-04 13:00,78,38,40,0,0,0
2021-12-04 13:15,85,48,37,0,0,0
2021-12-04 13:30,52,21,31,0,0,0
2021-12-04 13:45,70,29,41,0,0,0
2021-12-04 14:00,92,48,44,0,0,0
2021-12-04 14:15,61,32,29,0,0,0
2021-12-04 14:30,63,18,45,0,0,0
2021-12-04 14:45,58,21,37,0,0,0
2021-12-04 15:00,66,16,50,0,0,0
2021-12-04 15:15,47,12,35,0,0,0
2021-12-04 15:30,68,31,37,0,0,0
2021-12-04 15:45,41,10,31,0,0,0
2021-12-04 16:00,42,22,20,0,0,0
2021-12-04 16:15,49,23,26,0,0,0
2021-12-04 16:30,55,24,31,0,0,0
2021-12-04 16:45,41,10,31,0,0,0
2021-12-04 17:00,32,10,22,0,0,0
2021-12-04 17:15,37,12,25,0,0,0
2021-12-04 17:30,22,13,9,0,0,0
2021-12-04 17:45,36,12,24,0,0,0
2021-12-04 18:00,27,11,16,0,0,0
2021-12-04 18:15,31,6,25,0,0,0
2021-12-04 18:30,29,8,21,0,0,0
2021-12-04 18:45,30,20,10,0,0,0
2021-12-04 19:00,27,11,16,0,0,0
2021-12-04 19:15,20,7,13,0,0,0
2021-12-04 19:30,16,9,7,0,0,0
2021-12-04 19:45,24,10,14,0,0,0
2021-12-04 20:00,18,10,8,0,0,0
2021-12-04 20:15,11,6,5,0,0,0
2021-12-04 20:30,14,10,4,0,0,0
2021-12-04 20:45,17,4,13,0,0,0
2021-12-04 21:00,20,9,11,0,0,0
2021-12-04 21:15,24,14,10,0,0,0
2021-12-04 21:30,8,3,5,0,0,0
2021-12-04 21:45,5,2,3,0,0,0
2021-12-04 22:00,11,6,5,0,0,0
2021-12-04 22:15,19,5,14,0,0,0
2021-12-04 22:30,5,1,4,0,0,0
2021-12-04 22:45,7,4,3,0,0,0
2021-12-04 23:00,8,2,6,0,0,0
2021-12-04 23:15,3,1,2,0,0,0
2021-12-04 23:30,8,4,4,0,0,0
2021-12-04 23:45,10,3,7,0,0,0
2021-12-05 00:00,8,0,8,0,0,0
2021-12-05 00:15,13,0,13,0,0,0
2021-12-05 00:30,3,2,1,0,0,0
2021-12-05 00:45,6,2,4,0,0,0
2021-12-05 01:00,4,0,4,0,0,0
2021-12-05 01:15,10,3,7,0,0,0
2021-12-05 01:30,6,0,6,0,0,0
2021-12-05 01:45,1,0,1,0,0,0
2021-12-05 02:00,7,2,5,0,0,0
2021-12-05 02:15,4,0,4,0,0,0
2021-12-05 02:30,4,1,3,0,0,0
2021-12-05 02:45,5,1,4,0,0,0
2021-12-05 03:00,4,0,4,0,0,0
2021-12-05 03:15,2,0,2,0,0,0
2021-12-05 03:30,0,0,0,0,0,0
2021-12-05 03:45,4,2,2,0,0,0
2021-12-05 04:00,0,0,0,0,0,0
2021-12-05 04:15,3,0,3,0,0,0
2021-12-05 04:30,2,0,2,0,0,0
2021-12-05 04:45,3,0,3,0,0,0
2021-12-05 05:00,1,0,1,0,0,0
2021-12-05 05:15,2,0,2,0,0,0
2021-12-05 05:30,3,1,2,0,0,0
2021-12-05 05:45,1,0,1,0,0,0
2021-12-05 06:00,0,0,0,0,0,0
2021-12-05 06:15,3,2,1,0,0,0
2021-12-05 06:30,5,3,2,0,0,0
2021-12-05 06:45,1,0,1,0,0,0
2021-12-05 07:00,2,1,1,0,0,0
2021-12-05 07:15,4,0,4,0,0,0
2021-12-05 07:30,5,2,3,0,0,0
2021-12-05 07:45,3,1,2,0,0,0
2021-12-05 08:00,5,5,0,0,0,0
2021-12-05 08:15,5,3,2,0,0,0
2021-12-05 08:30,7,6,1,0,0,0
2021-12-05 08:45,9,5,4,0,0,0
2021-12-05 09:00,9,6,3,0,0,0
2021-12-05 09:15,11,8,3,0,0,0
2021-12-05 09:30,21,16,5,0,0,0
2021-12-05 09:45,13,7,6,0,0,0
2021-12-05 10:00,23,12,11,0,0,0
2021-12-05 10:15,25,19,6,0,0,0
2021-12-05 10:30,21,11,10,0,0,0
2021-12-05 10:45,22,13,9,0,0,0
2021-12-05 11:00,18,11,7,0,0,0
2021-12-05 11:15,16,6,10,0,0,0
2021-12-05 11:30,18,8,10,0,0,0
2021-12-05 11:45,28,14,14,0,0,0
2021-12-05 12:00,10,6,4,0,0,0
2021-12-05 12:15,41,17,24,0,0,0
2021-12-05 12:30,26,14,12,0,0,0
2021-12-05 12:45,24,9,15,0,0,0
2021-12-05 13:00,31,12,19,0,0,0
2021-12-05 13:15,32,18,14,0,0,0
2021-12-05 13:30,39,24,15,0,0,0
2021-12-05 13:45,29,13,16,0,0,0
2021-12-05 14:00,32,16,16,0,0,0
2021-12-05 14:15,34,14,20,0,0,0
2021-12-05 14:30,41,21,20,0,0,0
2021-12-05 14:45,30,15,15,0,0,0
2021-12-05 15:00,32,21,11,0,0,0
2021-12-05 15:15,34,14,20,0,0,0
2021-12-05 15:30,26,14,12,0,0,0
2021-12-05 15:45,48,34,14,0,0,0
2021-12-05 16:00,39,16,23,0,0,0
2021-12-05 16:15,39,17,22,0,0,0
2021-12-05 16:30,45,15,30,0,0,0
2021-12-05 16:45,44,17,27,0,0,0
2021-12-05 17:00,43,23,20,0,0,0
2021-12-05 17:15,24,12,12,0,0,0
2021-12-05 17:30,42,16,26,0,0,0
2021-12-05 17:45,31,15,16,0,0,0
2021-12-05 18:00,34,13,21,0,0,0
2021-12-05 18:15,34,19,15,0,0,0
2021-12-05 18:30,27,3,24,0,0,0
2021-12-05 18:45,53,27,26,0,0,0
2021-12-05 19:00,31,14,17,0,0,0
2021-12-05 19:15,28,11,17,0,0,0
2021-12-05 19:30,23,4,19,0,0,0
2021-12-05 19:45,29,10,19,0,0,0
2021-12-05 20:00,29,8,21,0,0,0
2021-12-05 20:15,19,2,17,0,0,0
2021-12-05 20:30,21,2,19,0,0,0
2021-12-05 20:45,11,1,10,0,0,0
2021-12-05 21:00,14,5,9,0,0,0
2021-12-05 21:15,12,6,6,0,0,0
2021-12-05 21:30,15,5,10,0,0,0
2021-12-05 21:45,12,1,11,0,0,0
2021-12-05 22:00,12,4,8,0,0,0
2021-12-05 22:15,8,4,4,0,0,0
2021-12-05 22:30,8,1,7,0,0,0
2021-12-05 22:45,5,2,3,0,0,0
2021-12-05 23:00,5,2,3,0,0,0
2021-12-05 23:15,2,1,1,0,0,0
2021-12-05 23:30,10,3,7,0,0,0
2021-12-05 23:45,4,1,3,0,0,0
2021-12-06 00:00,5,1,4,0,0,0
2021-12-06 00:15,2,1,1,0,0,0
2021-12-06 00:30,1,0,1,0,0,0
2021-12-06 00:45,1,1,0,0,0,0
2021-12-06 01:00,3,0,3,0,0,0
2021-12-06 01:15,2,2,0,0,0,0
2021-12-06 01:30,1,0,1,0,0,0
2021-12-06 01:45,0,0,0,0,0,0
2021-12-06 02:00,1,1,0,0,0,0
2021-12-06 02:15,0,0,0,0,0,0
2021-12-06 02:30,0,0,0,0,0,0
2021-12-06 02:45,0,0,0,0,0,0
2021-12-06 03:00,0,0,0,0,0,0
2021-12-06 03:15,0,0,0,0,0,0
2021-12-06 03:30,1,0,1,0,0,0
2021-12-06 03:45,0,0,0,0,0,0
2021-12-06 04:00,0,0,0,0,0,0
2021-12-06 04:15,1,1,0,0,0,0
2021-12-06 04:30,1,0,1,0,0,0
2021-12-06 04:45,1,0,1,0,0,0
2021-12-06 05:00,0,0,0,0,0,0
2021-12-06 05:15,1,1,0,0,0,0
2021-12-06 05:30,11,2,9,0,0,0
2021-12-06 05:45,9,2,7,0,0,0
2021-12-06 06:00,10,4,6,0,0,0
2021-12-06 06:15,20,7,13,0,0,0
2021-12-06 06:30,28,9,19,0,0,0
2021-12-06 06:45,50,20,30,0,0,0
2021-12-06 07:00,56,14,42,0,0,0
2021-12-06 07:15,62,25,37,0,0,0
2021-12-06 07:30,124,55,69,0,0,0
2021-12-06 07:45,226,104,122,0,0,0
2021-12-06 08:00,282,147,135,0,0,0
2021-12-06 08:15,124,43,81,0,0,0
2021-12-06 08:30,120,53,67,0,0,0
2021-12-06 08:45,103,37,66,0,0,0
2021-12-06 09:00,129,50,79,0,0,0
2021-12-06 09:15,59,23,36,0,0,0
2021-12-06 09:30,67,29,38,0,0,0
2021-12-06 09:45,107,51,56,0,0,0
2021-12-06 10:00,155,82,73,0,0,0
2021-12-06 10:15,62,38,24,0,0,0
2021-12-06 10:30,59,39,20,0,0,0
2021-12-06 10:45,50,25,25,0,0,0
2021-12-06 11:00,63,34,29,0,0,0
2021-12-06 11:15,38,16,22,0,0,0
2021-12-06 11:30,94,46,48,0,0,0
2021-12-06 11:45,173,78,95,0,0,0
2021-12-06 12:00,118,50,68,0,0,0
2021-12-06 12:15,96,40,56,0,0,0
2021-12-06 12:30,94,39,55,0,0,0
2021-12-06 12:45,132,47,85,0,0,0
2021-12-06 13:00,98,37,61,0,0,0
2021-12-06 13:15,110,43,67,0,0,0
2021-12-06 13:30,149,47,102,0,0,0
2021-12-06 13:45,155,58,97,0,0,0
2021-12-06 14:00,148,43,105,0,0,0
2021-12-06 14:15,99,43,56,0,0,0
2021-12-06 14:30,142,61,81,0,0,0
2021-12-06 14:45,105,57,48,0,0,0
2021-12-06 15:00,106,51,55,0,0,0
2021-12-06 15:15,119,58,61,0,0,0
2021-12-06 15:30,110,55,55,0,0,0
2021-12-06 15:45,219,110,109,0,0,0
2021-12-06 16:00,232,120,112,0,0,0
2021-12-06 16:15,137,77,60,0,0,0
2021-12-06 16:30,126,73,53,0,0,0
2021-12-06 16:45,115,74,41,0,0,0
2021-12-06 17:00,140,79,61,0,0,0
2021-12-06 17:15,132,70,62,0,0,0
2021-12-06 17:30,122,85,37,0,0,0
2021-12-06 17:45,180,81,99,0,0,0
2021-12-06 18:00,151,70,81,0,0,0
2021-12-06 18:15,108,39,69,0,0,0
2021-12-06 18:30,80,34,46,0,0,0
2021-12-06 18:45,80,22,58,0,0,0
2021-12-06 19:00,63,14,49,0,0,0
2021-12-06 19:15,74,37,37,0,0,0
2021-12-06 19:30,56,21,35,0,0,0
2021-12-06 19:45,65,17,48,0,0,0
2021-12-06 20:00,72,19,53,0,0,0
2021-12-06 20:15,58,14,44,0,0,0
2021-12-06 20:30,44,14,30,0,0,0
2021-12-06 20:45,26,6,20,0,0,0
2021-12-06 21:00,37,22,15,0,0,0
2021-12-06 21:15,27,8,19,0,0,0
2021-12-06 21:30,34,9,25,0,0,0
2021-12-06 21:45,17,2,15,0,0,0
2021-12-06 22:00,21,11,10,0,0,0
2021-12-06 22:15,24,5,19,0,0,0
2021-12-06 22:30,15,6,9,0,0,0
2021-12-06 22:45,13,5,8,0,0,0
2021-12-06 23:00,10,0,10,0,0,0
2021-12-06 23:15,11,4,7,0,0,0
2021-12-06 23:30,6,2,4,0,0,0
2021-12-06 23:45,1,0,1,0,0,0
2021-12-07 00:00,9,2,7,0,0,0
2021-12-07 00:15,5,0,5,0,0,0
2021-12-07 00:30,0,0,0,0,0,0
2021-12-07 00:45,2,0,2,0,0,0
2021-12-07 01:00,2,2,0,0,0,0
2021-12-07 01:15,3,2,1,0,0,0
2021-12-07 01:30,4,0,4,0,0,0
2021-12-07 01:45,0,0,0,0,0,0
2021-12-07 02:00,1,1,0,0,0,0
2021-12-07 02:15,0,0,0,0,0,0
2021-12-07 02:30,1,1,0,0,0,0
2021-12-07 02:45,0,0,0,0,0,0
2021-12-07 03:00,0,0,0,0,0,0
2021-12-07 03:15,0,0,0,0,0,0
2021-12-07 03:30,0,0,0,0,0,0
2021-12-07 03:45,2,0,2,0,0,0
2021-12-07 04:00,0,0,0,0,0,0
2021-12-07 04:15,1,0,1,0,0,0
2021-12-07 04:30,0,0,0,0,0,0
2021-12-07 04:45,0,0,0,0,0,0
2021-12-07 05:00,0,0,0,0,0,0
2021-12-07 05:15,0,0,0,0,0,0
2021-12-07 05:30,11,3,8,0,0,0
2021-12-07 05:45,10,2,8,0,0,0
2021-12-07 06:00,4,2,2,0,0,0
2021-12-07 06:15,16,7,9,0,0,0
2021-12-07 06:30,29,11,18,0,0,0
2021-12-07 06:45,54,21,33,0,0,0
2021-12-07 07:00,66,15,51,0,0,0
2021-12-07 07:15,75,32,43,0,0,0
2021-12-07 07:30,126,62,64,0,0,0
2021-12-07 07:45,250,126,124,0,0,0
2021-12-07 08:00,342,213,129,0,0,0
2021-12-07 08:15,144,70,74,0,0,0
2021-12-07 08:30,100,51,49,0,0,0
2021-12-07 08:45,126,53,73,0,0,0
2021-12-07 09:00,78,32,46,0,0,0
2021-12-07 09:15,68,34,34,0,0,0
2021-12-07 09:30,71,30,41,0,0,0
2021-12-07 09:45,160,86,74,0,0,0
2021-12-07 10:00,191,86,105,0,0,0
2021-12-07 10:15,64,34,30,0,0,0
2021-12-07 10:30,47,20,27,0,0,0
2021-12-07 10:45,61,41,20,0,0,0
2021-12-07 11:00,70,34,36,0,0,0
2021-12-07 11:15,71,43,28,0,0,0
2021-12-07 11:30,78,37,41,0,0,0
2021-12-07 11:45,178,76,102,0,0,0
2021-12-07 12:00,144,60,84,0,0,0
2021-12-07 12:15,79,24,55,0,0,0
2021-12-07 12:30,85,35,50,0,0,0
2021-12-07 12:45,83,38,45,0,0,0
2021-12-07 13:00,94,39,55,0,0,0
2021-12-07 13:15,89,26,63,0,0,0
2021-12-07 13:30,147,28,119,0,0,0
2021-12-07 13:45,182,66,116,0,0,0
2021-12-07 14:00,169,90,79,0,0,0
2021-12-07 14:15,101,40,61,0,0,0
2021-12-07 14:30,90,42,48,0,0,0
2021-12-07 14:45,93,44,49,0,0,0
2021-12-07 15:00,116,58,58,0,0,0
2021-12-07 15:15,130,58,72,0,0,0
2021-12-07 15:30,130,70,60,0,0,0
2021-12-07 15:45,237,111,126,0,0,0
2021-12-07 16:00,222,108,114,0,0,0
2021-12-07 16:15,141,82,59,0,0,0
2021-12-07 16:30,143,80,63,0,0,0
2021-12-07 16:45,141,78,63,0,0,0
2021-12-07 17:00,130,74,56,0,0,0
2021-12-07 17:15,104,54,50,0,0,0
2021-12-07 17:30,144,75,69,0,0,0
2021-12-07 17:45,195,122,73,0,0,0
2021-12-07 18:00,174,96,78,0,0,0
2021-12-07 18:15,143,82,61,0,0,0
2021-12-07 18:30,65,22,43,0,0,0
2021-12-07 18:45,103,33,70,0,0,0
2021-12-07 19:00,62,36,26,0,0,0
2021-12-07 19:15,78,41,37,0,0,0
2021-12-07 19:30,66,30,36,0,0,0
2021-12-07 19:45,94,35,59,0,0,0
2021-12-07 20:00,69,18,51,0,0,0
2021-12-07 20:15,50,10,40,0,0,0
2021-12-07 20:30,32,12,20,0,0,0
2021-12-07 20:45,29,8,21,0,0,0
2021-12-07 21:00,25,6,19,0,0,0
2021-12-07 21:15,39,13,26,0,0,0
2021-12-07 21:30,38,12,26,0,0,0
2021-12-07 21:45,25,4,21,0,0,0
2021-12-07 22:00,23,9,14,0,0,0
2021-12-07 22:15,31,10,21,0,0,0
2021-12-07 22:30,29,7,22,0,0,0
2021-12-07 22:45,22,4,18,0,0,0
2021-12-07 23:00,12,6,6,0,0,0
2021-12-07 23:15,6,3,3,0,0,0
2021-12-07 23:30,4,0,4,0,0,0
2021-12-07 23:45,7,1,6,0,0,0
2021-12-08 00:00,10,5,5,0,0,0
2021-12-08 00:15,3,1,2,0,0,0
2021-12-08 00:30,0,0,0,0,0,0
2021-12-08 00:45,4,0,4,0,0,0
2021-12-08 01:00,0,0,0,0,0,0
2021-12-08 01:15,3,0,3,0,0,0
2021-12-08 01:30,1,0,1,0,0,0
2021-12-08 01:45,0,0,0,0,0,0
2021-12-08 02:00,0,0,0,0,0,0
2021-12-08 02:15,0,0,0,0,0,0
2021-12-08 02:30,1,0,1,0,0,0
2021-12-08 02:45,0,0,0,0,0,0
2021-12-08 03:00,1,1,0,0,0,0
2021-12-08 03:15,2,0,2,0,0,0
2021-12-08 03:30,0,0,0,0,0,0
2021-12-08 03:45,0,0,0,0,0,0
2021-12-08 04:00,1,0,1,0,0,0
2021-12-08 04:15,0,0,0,0,0,0
2021-12-08 04:30,1,0,1,0,0,0
2021-12-08 04:45,0,0,0,0,0,0
2021-12-08 05:00,1,0,1,0,0,0
2021-12-08 05:15,2,2,0,0,0,0
2021-12-08 05:30,12,3,9,0,0,0
2021-12-08 05:45,10,3,7,0,0,0
2021-12-08 06:00,6,4,2,0,0,0
2021-12-08 06:15,19,7,12,0,0,0
2021-12-08 06:30,38,19,19,0,0,0
2021-12-08 06:45,47,22,25,0,0,0
2021-12-08 07:00,49,10,39,0,0,0
2021-12-08 07:15,78,26,52,0,0,0
2021-12-08 07:30,140,57,83,0,0,0
2021-12-08 07:45,259,125,134,0,0,0
2021-12-08 08:00,343,193,150,0,0,0
2021-12-08 08:15,129,58,71,0,0,0
2021-12-08 08:30,91,32,59,0,0,0
2021-12-08 08:45,124,64,60,0,0,0
2021-12-08 09:00,82,42,40,0,0,0
2021-12-08 09:15,84,41,43,0,0,0
2021-12-08 09:30,87,50,37,0,0,0
2021-12-08 09:45,204,99,105,0,0,0
2021-12-08 10:00,240,117,123,0,0,0
2021-12-08 10:15,88,53,35,0,0,0
2021-12-08 10:30,80,45,35,0,0,0
2021-12-08 10:45,74,45,29,0,0,0
2021-12-08 11:00,92,41,51,0,0,0
2021-12-08 11:15,81,43,38,0,0,0
2021-12-08 11:30,102,49,53,0,0,0
2021-12-08 11:45,181,89,92,0,0,0
2021-12-08 12:00,164,78,86,0,0,0
2021-12-08 12:15,118,53,65,0,0,0
2021-12-08 12:30,140,52,88,0,0,0
2021-12-08 12:45,126,55,71,0,0,0
2021-12-08 13:00,137,52,85,0,0,0
2021-12-08 13:15,114,48,66,0,0,0
2021-12-08 13:30,162,56,106,0,0,0
2021-12-08 13:45,191,77,114,0,0,0
2021-12-08 14:00,156,65,91,0,0,0
2021-12-08 14:15,119,63,56,0,0,0
2021-12-08 14:30,139,51,88,0,0,0
2021-12-08 14:45,123,64,59,0,0,0
2021-12-08 15:00,113,49,64,0,0,0
2021-12-08 15:15,140,92,48,0,0,0
2021-12-08 15:30,140,94,46,0,0,0
2021-12-08 15:45,210,111,99,0,0,0
2021-12-08 16:00,171,92,79,0,0,0
2021-12-08 16:15,132,72,60,0,0,0
2021-12-08 16:30,111,61,50,0,0,0
2021-12-08 16:45,136,63,73,0,0,0
2021-12-08 17:00,150,88,62,0,0,0
2021-12-08 17:15,112,57,55,0,0,0
2021-12-08 17:30,101,55,46,0,0,0
2021-12-08 17:45,215,127,88,0,0,0
2021-12-08 18:00,135,80,55,0,0,0
2021-12-08 18:15,132,63,69,0,0,0
2021-12-08 18:30,81,45,36,0,0,0
2021-12-08 18:45,85,54,31,0,0,0
2021-12-08 19:00,76,39,37,0,0,0
2021-12-08 19:15,68,35,33,0,0,0
2021-12-08 19:30,59,28,31,0,0,0
2021-12-08 19:45,72,30,42,0,0,0
2021-12-08 20:00,64,24,40,0,0,0
2021-12-08 20:15,61,14,47,0,0,0
2021-12-08 20:30,45,10,35,0,0,0
2021-12-08 20:45,41,15,26,0,0,0
2021-12-08 21:00,27,8,19,0,0,0
2021-12-08 21:15,28,7,21,0,0,0
2021-12-08 21:30,25,6,19,0,0,0
2021-12-08 21:45,24,8,16,0,0,0
2021-12-08 22:00,15,6,9,0,0,0
2021-12-08 22:15,28,11,17,0,0,0
2021-12-08 22:30,20,6,14,0,0,0
2021-12-08 22:45,12,5,7,0,0,0
2021-12-08 23:00,23,1,22,0,0,0
2021-12-08 23:15,13,3,10,0,0,0
2021-12-08 23:30,17,3,14,0,0,0
2021-12-08 23:45,10,2,8,0,0,0
2021-12-09 00:00,11,3,8,0,0,0
2021-12-09 00:15,8,4,4,0,0,0
2021-12-09 00:30,11,4,7,0,0,0
2021-12-09 00:45,6,0,6,0,0,0
2021-12-09 01:00,9,5,4,0,0,0
2021-12-09 01:15,3,1,2,0,0,0
2021-12-09 01:30,5,2,3,0,0,0
2021-12-09 01:45,1,0,1,0,0,0
2021-12-09 02:00,4,1,3,0,0,0
2021-12-09 02:15,1,0,1,0,0,0
2021-12-09 02:30,0,0,0,0,0,0
2021-12-09 02:45,1,1,0,0,0,0
2021-12-09 03:00,2,0,2,0,0,0
2021-12-09 03:15,0,0,0,0,0,0
2021-12-09 03:30,0,0,0,0,0,0
2021-12-09 03:45,0,0,0,0,0,0
2021-12-09 04:00,0,0,0,0,0,0
2021-12-09 04:15,2,0,2,0,0,0
2021-12-09 04:30,0,0,0,0,0,0
2021-12-09 04:45,0,0,0,0,0,0
2021-12-09 05:00,0,0,0,0,0,0
2021-12-09 05:15,3,2,1,0,0,0
2021-12-09 05:30,6,2,4,0,0,0
2021-12-09 05:45,17,5,12,0,0,0
2021-12-09 06:00,6,5,1,0,0,0
2021-12-09 06:15,20,6,14,0,0,0
2021-12-09 06:30,25,7,18,0,0,0
2021-12-09 06:45,38,14,24,0,0,0
2021-12-09 07:00,62,14,48,0,0,0
2021-12-09 07:15,73,31,42,0,0,0
2021-12-09 07:30,145,58,87,0,0,0
2021-12-09 07:45,228,107,121,0,0,0
2021-12-09 08:00,291,158,133,0,0,0
2021-12-09 08:15,139,72,67,0,0,0
2021-12-09 08:30,91,33,58,0,0,0
2021-12-09 08:45,137,77,60,0,0,0
2021-12-09 09:00,76,37,39,0,0,0
2021-12-09 09:15,60,29,31,0,0,0
2021-12-09 09:30,68,36,32,0,0,0
2021-12-09 09:45,160,103,57,0,0,0
2021-12-09 10:00,182,81,101,0,0,0
2021-12-09 10:15,64,25,39,0,0,0
2021-12-09 10:30,48,19,29,0,0,0
2021-12-09 10:45,59,20,39,0,0,0
2021-12-09 11:00,61,27,34,0,0,0
2021-12-09 11:15,60,27,33,0,0,0
2021-12-09 11:30,87,47,40,0,0,0
2021-12-09 11:45,124,56,68,0,0,0
2021-12-09 12:00,135,61,74,0,0,0
2021-12-09 12:15,89,47,42,0,0,0
2021-12-09 12:30,112,51,61,0,0,0
2021-12-09 12:45,102,41,61,0,0,0
2021-12-09 13:00,120,57,63,0,0,0
2021-12-09 13:15,103,39,64,0,0,0
2021-12-09 13:30,154,54,100,0,0,0
2021-12-09 13:45,180,77,103,0,0,0
2021-12-09 14:00,162,70,92,0,0,0
2021-12-09 14:15,106,50,56,0,0,0
2021-12-09 14:30,123,43,80,0,0,0
2021-12-09 14:45,97,53,44,0,0,0
2021-12-09 15:00,117,62,55,0,0,0
2021-12-09 15:15,103,63,40,0,0,0
2021-12-09 15:30,138,69,69,0,0,0
2021-12-09 15:45,214,126,88,0,0,0
2021-12-09 16:00,174,94,80,0,0,0
2021-12-09 16:15,142,83,59,0,0,0
2021-12-09 16:30,121,60,61,0,0,0
2021-12-09 16:45,152,85,67,0,0,0
2021-12-09 17:00,120,72,48,0,0,0
2021-12-09 17:15,114,66,48,0,0,0
2021-12-09 17:30,150,92,58,0,0,0
2021-12-09 17:45,164,102,62,0,0,0
2021-12-09 18:00,130,70,60,0,0,0
2021-12-09 18:15,107,51,56,0,0,0
2021-12-09 18:30,88,38,50,0,0,0
2021-12-09 18:45,91,48,43,0,0,0
2021-12-09 19:00,65,27,38,0,0,0
2021-12-09 19:15,86,45,41,0,0,0
2021-12-09 19:30,43,18,25,0,0,0
2021-12-09 19:45,94,27,67,0,0,0
2021-12-09 20:00,59,20,39,0,0,0
2021-12-09 20:15,74,21,53,0,0,0
2021-12-09 20:30,46,13,33,0,0,0
2021-12-09 20:45,48,12,36,0,0,0
2021-12-09 21:00,23,12,11,0,0,0
2021-12-09 21:15,24,7,17,0,0,0
2021-12-09 21:30,20,2,18,0,0,0
2021-12-09 21:45,28,9,19,0,0,0
2021-12-09 22:00,29,6,23,0,0,0
2021-12-09 22:15,21,10,11,0,0,0
2021-12-09 22:30,23,8,15,0,0,0
2021-12-09 22:45,25,9,16,0,0,0
2021-12-09 23:00,11,0,11,0,0,0
2021-12-09 23:15,6,4,2,0,0,0
2021-12-09 23:30,12,2,10,0,0,0
2021-12-09 23:45,4,1,3,0,0,0
2021-12-10 00:00,14,4,10,0,0,0
2021-12-10 00:15,7,1,6,0,0,0
2021-12-10 00:30,5,1,4,0,0,0
2021-12-10 00:45,4,2,2,0,0,0
2021-12-10 01:00,0,0,0,0,0,0
2021-12-10 01:15,7,3,4,0,0,0
2021-12-10 01:30,2,0,2,0,0,0
2021-12-10 01:45,4,1,3,0,0,0
2021-12-10 02:00,0,0,0,0,0,0
2021-12-10 02:15,1,0,1,0,0,0
2021-12-10 02:30,2,1,1,0,0,0
2021-12-10 02:45,0,0,0,0,0,0
2021-12-10 03:00,1,0,1,0,0,0
2021-12-10 03:15,0,0,0,0,0,0
2021-12-10 03:30,1,0,1,0,0,0
2021-12-10 03:45,2,0,2,0,0,0
2021-12-10 04:00,4,1,3,0,0,0
2021-12-10 04:15,0,0,0,0,0,0
2021-12-10 04:30,0,0,0,0,0,0
2021-12-10 04:45,1,0,1,0,0,0
2021-12-10 05:00,1,1,0,0,0,0
2021-12-10 05:15,0,0,0,0,0,0
2021-12-10 05:30,10,4,6,0,0,0
2021-12-10 05:45,12,3,9,0,0,0
2021-12-10 06:00,2,0,2,0,0,0
2021-12-10 06:15,13,6,7,0,0,0
2021-12-10 06:30,29,11,18,0,0,0
2021-12-10 06:45,41,11,30,0,0,0
2021-12-10 07:00,43,10,33,0,0,0
2021-12-10 07:15,63,21,42,0,0,0
2021-12-10 07:30,104,44,60,0,0,0
2021-12-10 07:45,233,111,122,0,0,0
2021-12-10 08:00,247,156,91,0,0,0
2021-12-10 08:15,134,68,66,0,0,0
2021-12-10 08:30,87,42,45,0,0,0
2021-12-10 08:45,116,52,64,0,0,0
2021-12-10 09:00,81,41,40,0,0,0
2021-12-10 09:15,89,37,52,0,0,0
2021-12-10 09:30,65,31,34,0,0,0
2021-12-10 09:45,122,54,68,0,0,0
2021-12-10 10:00,136,68,68,0,0,0
2021-12-10 10:15,72,38,34,0,0,0
2021-12-10 10:30,55,34,21,0,0,0
2021-12-10 10:45,93,48,45,0,0,0
2021-12-10 11:00,55,32,23,0,0,0
2021-12-10 11:15,106,51,55,0,0,0
2021-12-10 11:30,86,45,41,0,0,0
2021-12-10 11:45,105,69,36,0,0,0
2021-12-10 12:00,126,79,47,0,0,0
2021-12-10 12:15,92,44,48,0,0,0
2021-12-10 12:30,95,38,57,0,0,0
2021-12-10 12:45,116,59,57,0,0,0
2021-12-10 13:00,121,55,66,0,0,0
2021-12-10 13:15,138,58,80,0,0,0
2021-12-10 13:30,152,36,116,0,0,0
2021-12-10 13:45,165,67,98,0,0,0
2021-12-10 14:00,140,76,64,0,0,0
2021-12-10 14:15,134,58,76,0,0,0
2021-12-10 14:30,134,59,75,0,0,0
2021-12-10 14:45,122,76,46,0,0,0
2021-12-10 15:00,124,62,62,0,0,0
2021-12-10 15:15,136,72,64,0,0,0
2021-12-10 15:30,114,57,57,0,0,0
2021-12-10 15:45,136,79,57,0,0,0
2021-12-10 16:00,112,67,45,0,0,0
2021-12-10 16:15,102,55,47,0,0,0
2021-12-10 16:30,104,57,47,0,0,0
2021-12-10 16:45,110,57,53,0,0,0
2021-12-10 17:00,107,66,41,0,0,0
2021-12-10 17:15,95,50,45,0,0,0
2021-12-10 17:30,94,44,50,0,0,0
2021-12-10 17:45,84,47,37,0,0,0
2021-12-10 18:00,86,41,45,0,0,0
2021-12-10 18:15,98,47,51,0,0,0
2021-12-10 18:30,82,41,41,0,0,0
2021-12-10 18:45,75,38,37,0,0,0
2021-12-10 19:00,50,26,24,0,0,0
2021-12-10 19:15,67,29,38,0,0,0
2021-12-10 19:30,70,25,45,0,0,0
2021-12-10 19:45,53,22,31,0,0,0
2021-12-10 20:00,50,18,32,0,0,0
2021-12-10 20:15,44,25,19,0,0,0
2021-12-10 20:30,35,14,21,0,0,0
2021-12-10 20:45,45,16,29,0,0,0
2021-12-10 21:00,54,14,40,0,0,0
2021-12-10 21:15,21,5,16,0,0,0
2021-12-10 21:30,49,15,34,0,0,0
2021-12-10 21:45,20,7,13,0,0,0
2021-12-10 22:00,29,9,20,0,0,0
2021-12-10 22:15,23,10,13,0,0,0
2021-12-10 22:30,13,3,10,0,0,0
2021-12-10 22:45,20,7,13,0,0,0
2021-12-10 23:00,27,11,16,0,0,0
2021-12-10 23:15,19,1,18,0,0,0
2021-12-10 23:30,11,2,9,0,0,0
2021-12-10 23:45,14,1,13,0,0,0
2021-12-11 00:00,17,1,16,0,0,0
2021-12-11 00:15,20,3,17,0,0,0
2021-12-11 00:30,17,2,15,0,0,0
2021-12-11 00:45,15,3,12,0,0,0
2021-12-11 01:00,21,5,16,0,0,0
2021-12-11 01:15,9,3,6,0,0,0
2021-12-11 01:30,7,2,5,0,0,0
2021-12-11 01:45,3,0,3,0,0,0
2021-12-11 02:00,9,4,5,0,0,0
2021-12-11 02:15,3,0,3,0,0,0
2021-12-11 02:30,11,4,7,0,0,0
2021-12-11 02:45,4,1,3,0,0,0
2021-12-11 03:00,2,1,1,0,0,0
2021-12-11 03:15,5,1,4,0,0,0
2021-12-11 03:30,2,0,2,0,0,0
2021-12-11 03:45,2,0,2,0,0,0
2021-12-11 04:00,2,0,2,0,0,0
2021-12-11 04:15,4,1,3,0,0,0
2021-12-11 04:30,1,0,1,0,0,0
2021-12-11 04:45,0,0,0,0,0,0
2021-12-11 05:00,1,0,1,0,0,0
2021-12-11 05:15,4,4,0,0,0,0
2021-12-11 05:30,7,3,4,0,0,0
2021-12-11 05:45,4,1,3,0,0,0
2021-12-11 06:00,1,1,0,0,0,0
2021-12-11 06:15,3,2,1,0,0,0
2021-12-11 06:30,5,2,3,0,0,0
2021-12-11 06:45,12,9,3,0,0,0
2021-12-11 07:00,5,3,2,0,0,0
2021-12-11 07:15,4,4,0,0,0,0
2021-12-11 07:30,7,6,1,0,0,0
2021-12-11 07:45,14,7,7,0,0,0
2021-12-11 08:00,8,6,2,0,0,0
2021-12-11 08:15,34,25,9,0,0,0
2021-12-11 08:30,26,20,6,0,0,0
2021-12-11 08:45,32,20,12,0,0,0
2021-12-11 09:00,34,28,6,0,0,0
2021-12-11 09:15,30,21,9,0,0,0
2021-12-11 09:30,56,39,17,0,0,0
2021-12-11 09:45,61,38,23,0,0,0
2021-12-11 10:00,59,37,22,0,0,0
2021-12-11 10:15,49,34,15,0,0,0
2021-12-11 10:30,45,34,11,0,0,0
2021-12-11 10:45,49,35,14,0,0,0
2021-12-11 11:00,59,35,24,0,0,0
2021-12-11 11:15,60,26,34,0,0,0
2021-12-11 11:30,55,30,25,0,0,0
2021-12-11 11:45,59,33,26,0,0,0
2021-12-11 12:00,64,32,32,0,0,0
2021-12-11 12:15,57,22,35,0,0,0
2021-12-11 12:30,75,37,38,0,0,0
2021-12-11 12:45,69,46,23,0,0,0
2021-12-11 13:00,60,34,26,0,0,0
2021-12-11 13:15,56,29,27,0,0,0
2021-12-11 13:30,58,22,36,0,0,0
2021-12-11 13:45,55,25,30,0,0,0
2021-12-11 14:00,71,44,27,0,0,0
2021-12-11 14:15,73,35,38,0,0,0
2021-12-11 14:30,61,25,36,0,0,0
2021-12-11 14:45,84,40,44,0,0,0
2021-12-11 15:00,53,28,25,0,0,0
2021-12-11 15:15,40,17,23,0,0,0
2021-12-11 15:30,57,23,34,0,0,0
2021-12-11 15:45,79,30,49,0,0,0
2021-12-11 16:00,31,11,20,0,0,0
2021-12-11 16:15,41,17,24,0,0,0
2021-12-11 16:30,52,22,30,0,0,0
2021-12-11 16:45,61,30,31,0,0,0
2021-12-11 17:00,51,25,26,0,0,0
2021-12-11 17:15,45,23,22,0,0,0
2021-12-11 17:30,33,16,17,0,0,0
2021-12-11 17:45,71,26,45,0,0,0
2021-12-11 18:00,48,29,19,0,0,0
2021-12-11 18:15,58,27,31,0,0,0
2021-12-11 18:30,57,24,33,0,0,0
2021-12-11 18:45,39,9,30,0,0,0
2021-12-11 19:00,49,18,31,0,0,0
2021-12-11 19:15,45,12,33,0,0,0
2021-12-11 19:30,41,27,14,0,0,0
2021-12-11 19:45,31,10,21,0,0,0
2021-12-11 20:00,26,11,15,0,0,0
2021-12-11 20:15,40,11,29,0,0,0
2021-12-11 20:30,14,3,11,0,0,0
2021-12-11 20:45,19,10,9,0,0,0
2021-12-11 21:00,28,8,20,0,0,0
2021-12-11 21:15,18,4,14,0,0,0
2021-12-11 21:30,24,7,17,0,0,0
2021-12-11 21:45,23,4,19,0,0,0
2021-12-11 22:00,16,8,8,0,0,0
2021-12-11 22:15,14,2,12,0,0,0
2021-12-11 22:30,18,7,11,0,0,0
2021-12-11 22:45,12,2,10,0,0,0
2021-12-11 23:00,13,2,11,0,0,0
2021-12-11 23:15,19,3,16,0,0,0
2021-12-11 23:30,6,1,5,0,0,0
2021-12-11 23:45,5,2,3,0,0,0
2021-12-12 00:00,13,3,10,0,0,0
2021-12-12 00:15,13,7,6,0,0,0
2021-12-12 00:30,14,4,10,0,0,0
2021-12-12 00:45,16,3,13,0,0,0
2021-12-12 01:00,14,1,13,0,0,0
2021-12-12 01:15,14,2,12,0,0,0
2021-12-12 01:30,13,5,8,0,0,0
2021-12-12 01:45,5,0,5,0,0,0
2021-12-12 02:00,6,1,5,0,0,0
2021-12-12 02:15,3,2,1,0,0,0
2021-12-12 02:30,7,1,6,0,0,0
2021-12-12 02:45,1,1,0,0,0,0
2021-12-12 03:00,2,0,2,0,0,0
2021-12-12 03:15,0,0,0,0,0,0
2021-12-12 03:30,2,1,1,0,0,0
2021-12-12 03:45,3,0,3,0,0,0
2021-12-12 04:00,2,0,2,0,0,0
2021-12-12 04:15,4,1,3,0,0,0
2021-12-12 04:30,1,1,0,0,0,0
2021-12-12 04:45,2,0,2,0,0,0
2021-12-12 05:00,4,0,4,0,0,0
2021-12-12 05:15,1,0,1,0,0,0
2021-12-12 05:30,5,1,4,0,0,0
2021-12-12 05:45,5,1,4,0,0,0
2021-12-12 06:00,2,0,2,0,0,0
2021-12-12 06:15,1,1,0,0,0,0
2021-12-12 06:30,7,4,3,0,0,0
2021-12-12 06:45,3,3,0,0,0,0
2021-12-12 07:00,0,0,0,0,0,0
2021-12-12 07:15,4,2,2,0,0,0
2021-12-12 07:30,3,2,1,0,0,0
2021-12-12 07:45,8,2,6,0,0,0
2021-12-12 08:00,4,1,3,0,0,0
2021-12-12 08:15,2,0,2,0,0,0
2021-12-12 08:30,10,5,5,0,0,0
2021-12-12 08:45,17,5,12,0,0,0
2021-12-12 09:00,6,3,3,0,0,0
2021-12-12 09:15,14,6,8,0,0,0
2021-12-12 09:30,17,11,6,0,0,0
2021-12-12 09:45,17,14,3,0,0,0
2021-12-12 10:00,19,12,7,0,0,0
2021-12-12 10:15,14,8,6,0,0,0
2021-12-12 10:30,12,6,6,0,0,0
2021-12-12 10:45,15,8,7,0,0,0
2021-12-12 11:00,10,1,9,0,0,0
2021-12-12 11:15,21,10,11,0,0,0
2021-12-12 11:30,12,6,6,0,0,0
2021-12-12 11:45,27,22,5,0,0,0
2021-12-12 12:00,11,1,10,0,0,0
2021-12-12 12:15,11,4,7,0,0,0
2021-12-12 12:30,17,7,10,0,0,0
2021-12-12 12:45,17,8,9,0,0,0
2021-12-12 13:00,13,8,5,0,0,0
2021-12-12 13:15,17,9,8,0,0,0
2021-12-12 13:30,16,10,6,0,0,0
2021-12-12 13:45,20,13,7,0,0,0
2021-12-12 14:00,22,11,11,0,0,0
2021-12-12 14:15,13,10,3,0,0,0
2021-12-12 14:30,20,11,9,0,0,0
2021-12-12 14:45,18,9,9,0,0,0
2021-12-12 15:00,17,9,8,0,0,0
2021-12-12 15:15,26,15,11,0,0,0
2021-12-12 15:30,20,13,7,0,0,0
2021-12-12 15:45,31,17,14,0,0,0
2021-12-12 16:00,32,6,26,0,0,0
2021-12-12 16:15,20,11,9,0,0,0
2021-12-12 16:30,25,15,10,0,0,0
2021-12-12 16:45,26,12,14,0,0,0
2021-12-12 17:00,16,5,11,0,0,0
2021-12-12 17:15,17,10,7,0,0,0
2021-12-12 17:30,27,14,13,0,0,0
2021-12-12 17:45,29,9,20,0,0,0
2021-12-12 18:00,27,16,11,0,0,0
2021-12-12 18:15,21,7,14,0,0,0
2021-12-12 18:30,24,10,14,0,0,0
2021-12-12 18:45,28,21,7,0,0,0
2021-12-12 19:00,22,5,17,0,0,0
2021-12-12 19:15,22,11,11,0,0,0
2021-12-12 19:30,18,3,15,0,0,0
2021-12-12 19:45,22,9,13,0,0,0
2021-12-12 20:00,37,10,27,0,0,0
2021-12-12 20:15,14,1,13,0,0,0
2021-12-12 20:30,18,5,13,0,0,0
2021-12-12 20:45,12,2,10,0,0,0
2021-12-12 21:00,17,8,9,0,0,0
2021-12-12 21:15,8,3,5,0,0,0
2021-12-12 21:30,9,4,5,0,0,0
2021-12-12 21:45,8,7,1,0,0,0
2021-12-12 22:00,9,3,6,0,0,0
2021-12-12 22:15,12,4,8,0,0,0
2021-12-12 22:30,14,6,8,0,0,0
2021-12-12 22:45,7,0,7,0,0,0
2021-12-12 23:00,2,0,2,0,0,0
2021-12-12 23:15,3,1,2,0,0,0
2021-12-12 23:30,3,3,0,0,0,0
2021-12-12 23:45,3,1,2,0,0,0
2021-12-13 00:00,3,1,2,0,0,0
2021-12-13 00:15,4,0,4,0,0,0
2021-12-13 00:30,0,0,0,0,0,0
2021-12-13 00:45,2,1,1,0,0,0
2021-12-13 01:00,0,0,0,0,0,0
2021-12-13 01:15,2,0,2,0,0,0
2021-12-13 01:30,1,0,1,0,0,0
2021-12-13 01:45,0,0,0,0,0,0
2021-12-13 02:00,0,0,0,0,0,0
2021-12-13 02:15,0,0,0,0,0,0
2021-12-13 02:30,0,0,0,0,0,0
2021-12-13 02:45,0,0,0,0,0,0
2021-12-13 03:00,0,0,0,0,0,0
2021-12-13 03:15,0,0,0,0,0,0
2021-12-13 03:30,0,0,0,0,0,0
2021-12-13 03:45,0,0,0,0,0,0
2021-12-13 04:00,0,0,0,0,0,0
2021-12-13 04:15,0,0,0,0,0,0
2021-12-13 04:30,2,1,1,0,0,0
2021-12-13 04:45,1,0,1,0,0,0
2021-12-13 05:00,0,0,0,0,0,0
2021-12-13 05:15,1,1,0,0,0,0
2021-12-13 05:30,12,4,8,0,0,0
2021-12-13 05:45,5,2,3,0,0,0
2021-12-13 06:00,3,2,1,0,0,0
2021-12-13 06:15,20,9,11,0,0,0
2021-12-13 06:30,29,9,20,0,0,0
2021-12-13 06:45,37,8,29,0,0,0
2021-12-13 07:00,60,21,39,0,0,0
2021-12-13 07:15,71,30,41,0,0,0
2021-12-13 07:30,116,55,61,0,0,0
2021-12-13 07:45,214,93,121,0,0,0
2021-12-13 08:00,239,147,92,0,0,0
2021-12-13 08:15,125,46,79,0,0,0
2021-12-13 08:30,96,41,55,0,0,0
2021-12-13 08:45,115,51,64,0,0,0
2021-12-13 09:00,75,36,39,0,0,0
2021-12-13 09:15,64,39,25,0,0,0
2021-12-13 09:30,65,37,28,0,0,0
2021-12-13 09:45,95,51,44,0,0,0
2021-12-13 10:00,125,50,75,0,0,0
2021-12-13 10:15,50,26,24,0,0,0
2021-12-13 10:30,36,18,18,0,0,0
2021-12-13 10:45,48,26,22,0,0,0
2021-12-13 11:00,49,25,24,0,0,0
2021-12-13 11:15,52,25,27,0,0,0
2021-12-13 11:30,69,34,35,0,0,0
2021-12-13 11:45,88,46,42,0,0,0
2021-12-13 12:00,101,44,57,0,0,0
2021-12-13 12:15,104,43,61,0,0,0
2021-12-13 12:30,95,40,55,0,0,0
2021-12-13 12:45,124,44,80,0,0,0
2021-12-13 13:00,99,43,56,0,0,0
2021-12-13 13:15,79,35,44,0,0,0
2021-12-13 13:30,144,31,113,0,0,0
2021-12-13 13:45,133,53,80,0,0,0
2021-12-13 14:00,114,57,57,0,0,0
2021-12-13 14:15,92,47,45,0,0,0
2021-12-13 14:30,98,33,65,0,0,0
2021-12-13 14:45,99,44,55,0,0,0
2021-12-13 15:00,74,31,43,0,0,0
2021-12-13 15:15,122,76,46,0,0,0
2021-12-13 15:30,133,76,57,0,0,0
2021-12-13 15:45,154,86,68,0,0,0
2021-12-13 16:00,154,69,85,0,0,0
2021-12-13 16:15,133,80,53,0,0,0
2021-12-13 16:30,127,63,64,0,0,0
2021-12-13 16:45,125,71,54,0,0,0
2021-12-13 17:00,135,73,62,0,0,0
2021-12-13 17:15,113,64,49,0,0,0
2021-12-13 17:30,105,54,51,0,0,0
2021-12-13 17:45,132,78,54,0,0,0
2021-12-13 18:00,112,60,52,0,0,0
2021-12-13 18:15,86,40,46,0,0,0
2021-12-13 18:30,55,24,31,0,0,0
2021-12-13 18:45,81,25,56,0,0,0
2021-12-13 19:00,71,30,41,0,0,0
2021-12-13 19:15,72,26,46,0,0,0
2021-12-13 19:30,52,26,26,0,0,0
2021-12-13 19:45,49,16,33,0,0,0
2021-12-13 20:00,68,26,42,0,0,0
2021-12-13 20:15,53,26,27,0,0,0
2021-12-13 20:30,30,8,22,0,0,0
2021-12-13 20:45,26,8,18,0,0,0
2021-12-13 21:00,37,15,22,0,0,0
2021-12-13 21:15,24,9,15,0,0,0
2021-12-13 21:30,17,2,15,0,0,0
2021-12-13 21:45,15,3,12,0,0,0
2021-12-13 22:00,21,6,15,0,0,0
2021-12-13 22:15,12,7,5,0,0,0
2021-12-13 22:30,12,2,10,0,0,0
2021-12-13 22:45,26,4,22,0,0,0
2021-12-13 23:00,10,4,6,0,0,0
2021-12-13 23:15,19,2,17,0,0,0
2021-12-13 23:30,9,1,8,0,0,0
2021-12-13 23:45,8,2,6,0,0,0
2021-12-14 00:00,5,1,4,0,0,0
2021-12-14 00:15,9,1,8,0,0,0
2021-12-14 00:30,5,3,2,0,0,0
2021-12-14 00:45,1,1,0,0,0,0
2021-12-14 01:00,1,0,1,0,0,0
2021-12-14 01:15,0,0,0,0,0,0
2021-12-14 01:30,0,0,0,0,0,0
2021-12-14 01:45,2,0,2,0,0,0
2021-12-14 02:00,4,1,3,0,0,0
2021-12-14 02:15,0,0,0,0,0,0
2021-12-14 02:30,2,0,2,0,0,0
2021-12-14 02:45,1,0,1,0,0,0
2021-12-14 03:00,1,0,1,0,0,0
2021-12-14 03:15,0,0,0,0,0,0
2021-12-14 03:30,1,1,0,0,0,0
2021-12-14 03:45,4,0,4,0,0,0
2021-12-14 04:00,0,0,0,0,0,0
2021-12-14 04:15,2,2,0,0,0,0
2021-12-14 04:30,1,0,1,0,0,0
2021-12-14 04:45,2,1,1,0,0,0
2021-12-14 05:00,0,0,0,0,0,0
2021-12-14 05:15,3,3,0,0,0,0
2021-12-14 05:30,13,4,9,0,0,0
2021-12-14 05:45,8,3,5,0,0,0
2021-12-14 06:00,10,4,6,0,0,0
2021-12-14 06:15,13,3,10,0,0,0
2021-12-14 06:30,29,13,16,0,0,0
2021-12-14 06:45,50,10,40,0,0,0
2021-12-14 07:00,71,16,55,0,0,0
2021-12-14 07:15,60,18,42,0,0,0
2021-12-14 07:30,116,49,67,0,0,0
2021-12-14 07:45,223,119,104,0,0,0
2021-12-14 08:00,254,142,112,0,0,0
2021-12-14 08:15,109,54,55,0,0,0
2021-12-14 08:30,119,51,68,0,0,0
2021-12-14 08:45,128,55,73,0,0,0
2021-12-14 09:00,92,44,48,0,0,0
2021-12-14 09:15,46,20,26,0,0,0
2021-12-14 09:30,65,35,30,0,0,0
2021-12-14 09:45,114,68,46,0,0,0
2021-12-14 10:00,131,59,72,0,0,0
2021-12-14 10:15,59,25,34,0,0,0
2021-12-14 10:30,56,26,30,0,0,0
2021-12-14 10:45,92,63,29,0,0,0
2021-12-14 11:00,66,32,34,0,0,0
2021-12-14 11:15,65,31,34,0,0,0
2021-12-14 11:30,83,53,30,0,0,0
2021-12-14 11:45,102,48,54,0,0,0
2021-12-14 12:00,108,52,56,0,0,0
2021-12-14 12:15,110,46,64,0,0,0
2021-12-14 12:30,103,49,54,0,0,0
2021-12-14 12:45,131,57,74,0,0,0
2021-12-14 13:00,99,50,49,0,0,0
2021-12-14 13:15,81,27,54,0,0,0
2021-12-14 13:30,164,45,119,0,0,0
2021-12-14 13:45,130,60,70,0,0,0
2021-12-14 14:00,100,36,64,0,0,0
2021-12-14 14:15,100,47,53,0,0,0
2021-12-14 14:30,101,38,63,0,0,0
2021-12-14 14:45,130,71,59,0,0,0
2021-12-14 15:00,118,67,51,0,0,0
2021-12-14 15:15,116,59,57,0,0,0
2021-12-14 15:30,112,67,45,0,0,0
2021-12-14 15:45,145,70,75,0,0,0
2021-12-14 16:00,167,84,83,0,0,0
2021-12-14 16:15,160,98,62,0,0,0
2021-12-14 16:30,144,87,57,0,0,0
2021-12-14 16:45,132,63,69,0,0,0
2021-12-14 17:00,121,62,59,0,0,0
2021-12-14 17:15,132,70,62,0,0,0
2021-12-14 17:30,129,70,59,0,0,0
2021-12-14 17:45,128,74,54,0,0,0
2021-12-14 18:00,137,67,70,0,0,0
2021-12-14 18:15,133,55,78,0,0,0
2021-12-14 18:30,86,45,41,0,0,0
2021-12-14 18:45,83,42,41,0,0,0
2021-12-14 19:00,80,34,46,0,0,0
2021-12-14 19:15,45,19,26,0,0,0
2021-12-14 19:30,56,24,32,0,0,0
2021-12-14 19:45,64,25,39,0,0,0
2021-12-14 20:00,56,19,37,0,0,0
2021-12-14 20:15,46,11,35,0,0,0
2021-12-14 20:30,37,15,22,0,0,0
2021-12-14 20:45,28,9,19,0,0,0
2021-12-14 21:00,30,13,17,0,0,0
2021-12-14 21:15,30,13,17,0,0,0
2021-12-14 21:30,25,8,17,0,0,0
2021-12-14 21:45,35,3,32,0,0,0
2021-12-14 22:00,13,8,5,0,0,0
2021-12-14 22:15,27,8,19,0,0,0
2021-12-14 22:30,24,2,22,0,0,0
2021-12-14 22:45,13,2,11,0,0,0
2021-12-14 23:00,14,6,8,0,0,0
2021-12-14 23:15,15,4,11,0,0,0
2021-12-14 23:30,13,2,11,0,0,0
2021-12-14 23:45,3,1,2,0,0,0
2021-12-15 00:00,10,1,9,0,0,0
2021-12-15 00:15,0,0,0,0,0,0
2021-12-15 00:30,5,5,0,0,0,0
2021-12-15 00:45,4,2,2,0,0,0
2021-12-15 01:00,1,0,1,0,0,0
2021-12-15 01:15,4,4,0,0,0,0
2021-12-15 01:30,6,1,5,0,0,0
2021-12-15 01:45,0,0,0,0,0,0
2021-12-15 02:00,2,0,2,0,0,0
2021-12-15 02:15,1,0,1,0,0,0
2021-12-15 02:30,0,0,0,0,0,0
2021-12-15 02:45,3,1,2,0,0,0
2021-12-15 03:00,0,0,0,0,0,0
2021-12-15 03:15,0,0,0,0,0,0
2021-12-15 03:30,0,0,0,0,0,0
2021-12-15 03:45,0,0,0,0,0,0
2021-12-15 04:00,3,2,1,0,0,0
2021-12-15 04:15,1,0,1,0,0,0
2021-12-15 04:30,0,0,0,0,0,0
2021-12-15 04:45,1,1,0,0,0,0
2021-12-15 05:00,0,0,0,0,0,0
2021-12-15 05:15,4,3,1,0,0,0
2021-12-15 05:30,11,4,7,0,0,0
2021-12-15 05:45,10,3,7,0,0,0
2021-12-15 06:00,9,6,3,0,0,0
2021-12-15 06:15,17,8,9,0,0,0
2021-12-15 06:30,31,13,18,0,0,0
2021-12-15 06:45,47,20,27,0,0,0
2021-12-15 07:00,62,18,44,0,0,0
2021-12-15 07:15,87,24,63,0,0,0
2021-12-15 07:30,115,52,63,0,0,0
2021-12-15 07:45,220,115,105,0,0,0
2021-12-15 08:00,263,161,102,0,0,0
2021-12-15 08:15,118,45,73,0,0,0
2021-12-15 08:30,93,54,39,0,0,0
2021-12-15 08:45,133,61,72,0,0,0
2021-12-15 09:00,102,56,46,0,0,0
2021-12-15 09:15,77,45,32,0,0,0
2021-12-15 09:30,82,35,47,0,0,0
2021-12-15 09:45,115,63,52,0,0,0
2021-12-15 10:00,140,62,78,0,0,0
2021-12-15 10:15,71,38,33,0,0,0
2021-12-15 10:30,69,44,25,0,0,0
2021-12-15 10:45,92,45,47,0,0,0
2021-12-15 11:00,78,38,40,0,0,0
2021-12-15 11:15,87,36,51,0,0,0
2021-12-15 11:30,85,42,43,0,0,0
2021-12-15 11:45,120,38,82,0,0,0
2021-12-15 12:00,132,55,77,0,0,0
2021-12-15 12:15,90,37,53,0,0,0
2021-12-15 12:30,94,42,52,0,0,0
2021-12-15 12:45,114,56,58,0,0,0
2021-12-15 13:00,93,42,51,0,0,0
2021-12-15 13:15,106,48,58,0,0,0
2021-12-15 13:30,157,35,122,0,0,0
2021-12-15 13:45,139,59,80,0,0,0
2021-12-15 14:00,151,70,81,0,0,0
2021-12-15 14:15,135,65,70,0,0,0
2021-12-15 14:30,116,48,68,0,0,0
2021-12-15 14:45,115,47,68,0,0,0
2021-12-15 15:00,127,63,64,0,0,0
2021-12-15 15:15,202,138,64,0,0,0
2021-12-15 15:30,136,71,65,0,0,0
2021-12-15 15:45,165,86,79,0,0,0
2021-12-15 16:00,181,87,94,0,0,0
2021-12-15 16:15,138,84,54,0,0,0
2021-12-15 16:30,135,76,59,0,0,0
2021-12-15 16:45,151,62,89,0,0,0
2021-12-15 17:00,126,61,65,0,0,0
2021-12-15 17:15,118,66,52,0,0,0
2021-12-15 17:30,107,54,53,0,0,0
2021-12-15 17:45,136,87,49,0,0,0
2021-12-15 18:00,107,53,54,0,0,0
2021-12-15 18:15,89,39,50,0,0,0
2021-12-15 18:30,79,45,34,0,0,0
2021-12-15 18:45,80,37,43,0,0,0
2021-12-15 19:00,83,39,44,0,0,0
2021-12-15 19:15,87,51,36,0,0,0
2021-12-15 19:30,68,24,44,0,0,0
2021-12-15 19:45,71,31,40,0,0,0
2021-12-15 20:00,59,26,33,0,0,0
2021-12-15 20:15,49,8,41,0,0,0
2021-12-15 20:30,48,15,33,0,0,0
2021-12-15 20:45,41,20,21,0,0,0
2021-12-15 21:00,24,12,12,0,0,0
2021-12-15 21:15,38,15,23,0,0,0
2021-12-15 21:30,37,11,26,0,0,0
2021-12-15 21:45,31,5,26,0,0,0
2021-12-15 22:00,29,13,16,0,0,0
2021-12-15 22:15,20,9,11,0,0,0
2021-12-15 22:30,46,7,39,0,0,0
2021-12-15 22:45,16,1,15,0,0,0
2021-12-15 23:00,26,7,19,0,0,0
2021-12-15 23:15,19,1,18,0,0,0
2021-12-15 23:30,23,10,13,0,0,0
2021-12-15 23:45,8,5,3,0,0,0
2021-12-16 00:00,8,1,7,0,0,0
2021-12-16 00:15,11,2,9,0,0,0
2021-12-16 00:30,9,1,8,0,0,0
2021-12-16 00:45,9,5,4,0,0,0
2021-12-16 01:00,9,7,2,0,0,0
2021-12-16 01:15,9,4,5,0,0,0
2021-12-16 01:30,7,2,5,0,0,0
2021-12-16 01:45,3,0,3,0,0,0
2021-12-16 02:00,10,1,9,0,0,0
2021-12-16 02:15,3,2,1,0,0,0
2021-12-16 02:30,6,1,5,0,0,0
2021-12-16 02:45,2,1,1,0,0,0
2021-12-16 03:00,2,0,2,0,0,0
2021-12-16 03:15,0,0,0,0,0,0
2021-12-16 03:30,1,0,1,0,0,0
2021-12-16 03:45,2,0,2,0,0,0
2021-12-16 04:00,1,0,1,0,0,0
2021-12-16 04:15,2,0,2,0,0,0
2021-12-16 04:30,3,2,1,0,0,0
2021-12-16 04:45,2,2,0,0,0,0
2021-12-16 05:00,0,0,0,0,0,0
2021-12-16 05:15,3,2,1,0,0,0
2021-12-16 05:30,9,2,7,0,0,0
2021-12-16 05:45,6,4,2,0,0,0
2021-12-16 06:00,7,5,2,0,0,0
2021-12-16 06:15,15,6,9,0,0,0
2021-12-16 06:30,30,12,18,0,0,0
2021-12-16 06:45,53,15,38,0,0,0
2021-12-16 07:00,62,15,47,0,0,0
2021-12-16 07:15,72,26,46,0,0,0
2021-12-16 07:30,144,63,81,0,0,0
2021-12-16 07:45,228,113,115,0,0,0
2021-12-16 08:00,268,159,109,0,0,0
2021-12-16 08:15,110,39,71,0,0,0
2021-12-16 08:30,97,35,62,0,0,0
2021-12-16 08:45,138,75,63,0,0,0
2021-12-16 09:00,93,50,43,0,0,0
2021-12-16 09:15,78,34,44,0,0,0
2021-12-16 09:30,89,36,53,0,0,0
2021-12-16 09:45,153,85,68,0,0,0
2021-12-16 10:00,131,50,81,0,0,0
2021-12-16 10:15,86,49,37,0,0,0
2021-12-16 10:30,103,53,50,0,0,0
2021-12-16 10:45,87,45,42,0,0,0
2021-12-16 11:00,86,47,39,0,0,0
2021-12-16 11:15,84,48,36,0,0,0
2021-12-16 11:30,112,68,44,0,0,0
2021-12-16 11:45,131,61,70,0,0,0
2021-12-16 12:00,138,65,73,0,0,0
2021-12-16 12:15,134,62,72,0,0,0
2021-12-16 12:30,90,40,50,0,0,0
2021-12-16 12:45,139,71,68,0,0,0
2021-12-16 13:00,104,45,59,0,0,0
2021-12-16 13:15,107,49,58,0,0,0
2021-12-16 13:30,148,40,108,0,0,0
2021-12-16 13:45,129,52,77,0,0,0
2021-12-16 14:00,131,53,78,0,0,0
2021-12-16 14:15,112,54,58,0,0,0
2021-12-16 14:30,168,58,110,0,0,0
2021-12-16 14:45,133,61,72,0,0,0
2021-12-16 15:00,131,57,74,0,0,0
2021-12-16 15:15,135,80,55,0,0,0
2021-12-16 15:30,173,78,95,0,0,0
2021-12-16 15:45,168,98,70,0,0,0
2021-12-16 16:00,166,79,87,0,0,0
2021-12-16 16:15,141,76,65,0,0,0
2021-12-16 16:30,176,112,64,0,0,0
2021-12-16 16:45,157,87,70,0,0,0
2021-12-16 17:00,159,93,66,0,0,0
2021-12-16 17:15,136,82,54,0,0,0
2021-12-16 17:30,153,76,77,0,0,0
2021-12-16 17:45,121,74,47,0,0,0
2021-12-16 18:00,175,120,55,0,0,0
2021-12-16 18:15,141,71,70,0,0,0
2021-12-16 18:30,95,32,63,0,0,0
2021-12-16 18:45,75,38,37,0,0,0
2021-12-16 19:00,84,36,48,0,0,0
2021-12-16 19:15,98,40,58,0,0,0
2021-12-16 19:30,80,36,44,0,0,0
2021-12-16 19:45,76,35,41,0,0,0
2021-12-16 20:00,68,17,51,0,0,0
2021-12-16 20:15,53,8,45,0,0,0
2021-12-16 20:30,48,10,38,0,0,0
2021-12-16 20:45,29,11,18,0,0,0
2021-12-16 21:00,32,5,27,0,0,0
2021-12-16 21:15,29,6,23,0,0,0
2021-12-16 21:30,18,10,8,0,0,0
2021-12-16 21:45,23,9,14,0,0,0
2021-12-16 22:00,29,7,22,0,0,0
2021-12-16 22:15,33,14,19,0,0,0
2021-12-16 22:30,32,9,23,0,0,0
2021-12-16 22:45,27,8,19,0,0,0
2021-12-16 23:00,10,3,7,0,0,0
2021-12-16 23:15,12,1,11,0,0,0
2021-12-16 23:30,24,1,23,0,0,0
2021-12-16 23:45,15,2,13,0,0,0
2021-12-17 00:00,8,3,5,0,0,0
2021-12-17 00:15,14,3,11,0,0,0
2021-12-17 00:30,9,2,7,0,0,0
2021-12-17 00:45,4,0,4,0,0,0
2021-12-17 01:00,3,0,3,0,0,0
2021-12-17 01:15,10,3,7,0,0,0
2021-12-17 01:30,3,0,3,0,0,0
2021-12-17 01:45,5,1,4,0,0,0
2021-12-17 02:00,4,1,3,0,0,0
2021-12-17 02:15,6,2,4,0,0,0
2021-12-17 02:30,1,0,1,0,0,0
2021-12-17 02:45,0,0,0,0,0,0
2021-12-17 03:00,3,3,0,0,0,0
2021-12-17 03:15,0,0,0,0,0,0
2021-12-17 03:30,1,0,1,0,0,0
2021-12-17 03:45,0,0,0,0,0,0
2021-12-17 04:00,0,0,0,0,0,0
2021-12-17 04:15,0,0,0,0,0,0
2021-12-17 04:30,2,0,2,0,0,0
2021-12-17 04:45,3,2,1,0,0,0
2021-12-17 05:00,1,0,1,0,0,0
2021-12-17 05:15,1,1,0,0,0,0
2021-12-17 05:30,9,2,7,0,0,0
2021-12-17 05:45,10,4,6,0,0,0
2021-12-17 06:00,5,3,2,0,0,0
2021-12-17 06:15,18,8,10,0,0,0
2021-12-17 06:30,28,12,16,0,0,0
2021-12-17 06:45,41,14,27,0,0,0
2021-12-17 07:00,48,8,40,0,0,0
2021-12-17 07:15,58,24,34,0,0,0
2021-12-17 07:30,117,50,67,0,0,0
2021-12-17 07:45,213,107,106,0,0,0
2021-12-17 08:00,237,148,89,0,0,0
2021-12-17 08:15,123,49,74,0,0,0
2021-12-17 08:30,109,51,58,0,0,0
2021-12-17 08:45,112,48,64,0,0,0
2021-12-17 09:00,87,44,43,0,0,0
2021-12-17 09:15,86,56,30,0,0,0
2021-12-17 09:30,93,42,51,0,0,0
2021-12-17 09:45,128,77,51,0,0,0
2021-12-17 10:00,103,54,49,0,0,0
2021-12-17 10:15,90,47,43,0,0,0
2021-12-17 10:30,70,36,34,0,0,0
2021-12-17 10:45,99,47,52,0,0,0
2021-12-17 11:00,64,41,23,0,0,0
2021-12-17 11:15,95,45,50,0,0,0
2021-12-17 11:30,86,47,39,0,0,0
2021-12-17 11:45,93,40,53,0,0,0
2021-12-17 12:00,140,77,63,0,0,0
2021-12-17 12:15,130,73,57,0,0,0
2021-12-17 12:30,117,60,57,0,0,0
2021-12-17 12:45,132,55,77,0,0,0
2021-12-17 13:00,112,39,73,0,0,0
2021-12-17 13:15,125,69,56,0,0,0
2021-12-17 13:30,174,45,129,0,0,0
2021-12-17 13:45,122,53,69,0,0,0
2021-12-17 14:00,104,46,58,0,0,0
2021-12-17 14:15,142,70,72,0,0,0
2021-12-17 14:30,192,102,90,0,0,0
2021-12-17 14:45,137,80,57,0,0,0
2021-12-17 15:00,141,80,61,0,0,0
2021-12-17 15:15,123,66,57,0,0,0
2021-12-17 15:30,131,70,61,0,0,0
2021-12-17 15:45,127,69,58,0,0,0
2021-12-17 16:00,127,80,47,0,0,0
2021-12-17 16:15,110,53,57,0,0,0
2021-12-17 16:30,123,75,48,0,0,0
2021-12-17 16:45,149,81,68,0,0,0
2021-12-17 17:00,145,74,71,0,0,0
2021-12-17 17:15,126,57,69,0,0,0
2021-12-17 17:30,88,53,35,0,0,0
2021-12-17 17:45,118,67,51,0,0,0
2021-12-17 18:00,90,46,44,0,0,0
2021-12-17 18:15,83,36,47,0,0,0
2021-12-17 18:30,82,29,53,0,0,0
2021-12-17 18:45,96,52,44,0,0,0
2021-12-17 19:00,71,33,38,0,0,0
2021-12-17 19:15,69,26,43,0,0,0
2021-12-17 19:30,93,37,56,0,0,0
2021-12-17 19:45,47,26,21,0,0,0
2021-12-17 20:00,60,14,46,0,0,0
2021-12-17 20:15,49,12,37,0,0,0
2021-12-17 20:30,42,12,30,0,0,0
2021-12-17 20:45,23,9,14,0,0,0
2021-12-17 21:00,32,10,22,0,0,0
2021-12-17 21:15,28,5,23,0,0,0
2021-12-17 21:30,25,7,18,0,0,0
2021-12-17 21:45,41,10,31,0,0,0
2021-12-17 22:00,28,10,18,0,0,0
2021-12-17 22:15,33,7,26,0,0,0
2021-12-17 22:30,13,5,8,0,0,0
2021-12-17 22:45,21,4,17,0,0,0
2021-12-17 23:00,24,5,19,0,0,0
2021-12-17 23:15,18,3,15,0,0,0
2021-12-17 23:30,14,7,7,0,0,0
2021-12-17 23:45,16,5,11,0,0,0
2021-12-18 00:00,10,3,7,0,0,0
2021-12-18 00:15,24,13,11,0,0,0
2021-12-18 00:30,13,2,11,0,0,0
2021-12-18 00:45,12,1,11,0,0,0
2021-12-18 01:00,11,6,5,0,0,0
2021-12-18 01:15,12,4,8,0,0,0
2021-12-18 01:30,14,4,10,0,0,0
2021-12-18 01:45,11,1,10,0,0,0
2021-12-18 02:00,6,3,3,0,0,0
2021-12-18 02:15,6,0,6,0,0,0
2021-12-18 02:30,4,0,4,0,0,0
2021-12-18 02:45,6,4,2,0,0,0
2021-12-18 03:00,1,0,1,0,0,0
2021-12-18 03:15,5,1,4,0,0,0
2021-12-18 03:30,7,0,7,0,0,0
2021-12-18 03:45,4,0,4,0,0,0
2021-12-18 04:00,0,0,0,0,0,0
2021-12-18 04:15,0,0,0,0,0,0
2021-12-18 04:30,3,0,3,0,0,0
2021-12-18 04:45,0,0,0,0,0,0
2021-12-18 05:00,2,0,2,0,0,0
2021-12-18 05:15,3,2,1,0,0,0
2021-12-18 05:30,3,0,3,0,0,0
2021-12-18 05:45,7,4,3,0,0,0
2021-12-18 06:00,3,0,3,0,0,0
2021-12-18 06:15,3,2,1,0,0,0
2021-12-18 06:30,7,2,5,0,0,0
2021-12-18 06:45,10,9,1,0,0,0
2021-12-18 07:00,3,2,1,0,0,0
2021-12-18 07:15,14,9,5,0,0,0
2021-12-18 07:30,7,7,0,0,0,0
2021-12-18 07:45,27,9,18,0,0,0
2021-12-18 08:00,12,9,3,0,0,0
2021-12-18 08:15,29,21,8,0,0,0
2021-12-18 08:30,19,9,10,0,0,0
2021-12-18 08:45,49,26,23,0,0,0
2021-12-18 09:00,50,40,10,0,0,0
2021-12-18 09:15,36,25,11,0,0,0
2021-12-18 09:30,54,31,23,0,0,0
2021-12-18 09:45,67,50,17,0,0,0
2021-12-18 10:00,72,53,19,0,0,0
2021-12-18 10:15,60,39,21,0,0,0
2021-12-18 10:30,84,52,32,0,0,0
2021-12-18 10:45,102,73,29,0,0,0
2021-12-18 11:00,106,63,43,0,0,0
2021-12-18 11:15,73,48,25,0,0,0
2021-12-18 11:30,74,44,30,0,0,0
2021-12-18 11:45,85,53,32,0,0,0
2021-12-18 12:00,99,53,46,0,0,0
2021-12-18 12:15,91,41,50,0,0,0
2021-12-18 12:30,87,50,37,0,0,0
2021-12-18 12:45,86,54,32,0,0,0
2021-12-18 13:00,92,44,48,0,0,0
2021-12-18 13:15,82,34,48,0,0,0
2021-12-18 13:30,80,41,39,0,0,0
2021-12-18 13:45,72,27,45,0,0,0
2021-12-18 14:00,81,30,51,0,0,0
2021-12-18 14:15,88,37,51,0,0,0
2021-12-18 14:30,67,25,42,0,0,0
2021-12-18 14:45,73,34,39,0,0,0
2021-12-18 15:00,76,30,46,0,0,0
2021-12-18 15:15,70,37,33,0,0,0
2021-12-18 15:30,89,36,53,0,0,0
2021-12-18 15:45,70,38,32,0,0,0
2021-12-18 16:00,80,40,40,0,0,0
2021-12-18 16:15,87,39,48,0,0,0
2021-12-18 16:30,56,22,34,0,0,0
2021-12-18 16:45,63,28,35,0,0,0
2021-12-18 17:00,43,23,20,0,0,0
2021-12-18 17:15,55,17,38,0,0,0
2021-12-18 17:30,82,28,54,0,0,0
2021-12-18 17:45,63,29,34,0,0,0
2021-12-18 18:00,60,34,26,0,0,0
2021-12-18 18:15,78,27,51,0,0,0
2021-12-18 18:30,49,20,29,0,0,0
2021-12-18 18:45,46,21,25,0,0,0
2021-12-18 19:00,58,27,31,0,0,0
2021-12-18 19:15,34,12,22,0,0,0
2021-12-18 19:30,46,15,31,0,0,0
2021-12-18 19:45,52,20,32,0,0,0
2021-12-18 20:00,57,23,34,0,0,0
2021-12-18 20:15,40,9,31,0,0,0
2021-12-18 20:30,38,16,22,0,0,0
2021-12-18 20:45,24,4,20,0,0,0
2021-12-18 21:00,24,9,15,0,0,0
2021-12-18 21:15,28,10,18,0,0,0
2021-12-18 21:30,18,7,11,0,0,0
2021-12-18 21:45,13,4,9,0,0,0
2021-12-18 22:00,20,2,18,0,0,0
2021-12-18 22:15,14,1,13,0,0,0
2021-12-18 22:30,15,8,7,0,0,0
2021-12-18 22:45,22,5,17,0,0,0
2021-12-18 23:00,7,2,5,0,0,0
2021-12-18 23:15,7,2,5,0,0,0
2021-12-18 23:30,7,3,4,0,0,0
2021-12-18 23:45,9,0,9,0,0,0
2021-12-19 00:00,10,5,5,0,0,0
2021-12-19 00:15,11,3,8,0,0,0
2021-12-19 00:30,14,7,7,0,0,0
2021-12-19 00:45,1,0,1,0,0,0
2021-12-19 01:00,10,2,8,0,0,0
2021-12-19 01:15,7,1,6,0,0,0
2021-12-19 01:30,11,2,9,0,0,0
2021-12-19 01:45,11,7,4,0,0,0
2021-12-19 02:00,11,4,7,0,0,0
2021-12-19 02:15,9,0,9,0,0,0
2021-12-19 02:30,2,0,2,0,0,0
2021-12-19 02:45,5,1,4,0,0,0
2021-12-19 03:00,3,1,2,0,0,0
2021-12-19 03:15,7,3,4,0,0,0
2021-12-19 03:30,5,2,3,0,0,0
2021-12-19 03:45,7,6,1,0,0,0
2021-12-19 04:00,0,0,0,0,0,0
2021-12-19 04:15,4,3,1,0,0,0
2021-12-19 04:30,2,0,2,0,0,0
2021-12-19 04:45,7,0,7,0,0,0
2021-12-19 05:00,2,0,2,0,0,0
2021-12-19 05:15,1,0,1,0,0,0
2021-12-19 05:30,4,0,4,0,0,0
2021-12-19 05:45,3,1,2,0,0,0
2021-12-19 06:00,4,0,4,0,0,0
2021-12-19 06:15,3,2,1,0,0,0
2021-12-19 06:30,3,3,0,0,0,0
2021-12-19 06:45,4,2,2,0,0,0
2021-12-19 07:00,0,0,0,0,0,0
2021-12-19 07:15,3,0,3,0,0,0
2021-12-19 07:30,1,0,1,0,0,0
2021-12-19 07:45,8,3,5,0,0,0
2021-12-19 08:00,7,5,2,0,0,0
2021-12-19 08:15,7,1,6,0,0,0
2021-12-19 08:30,4,2,2,0,0,0
2021-12-19 08:45,14,4,10,0,0,0
2021-12-19 09:00,17,13,4,0,0,0
2021-12-19 09:15,14,11,3,0,0,0
2021-12-19 09:30,14,8,6,0,0,0
2021-12-19 09:45,35,26,9,0,0,0
2021-12-19 10:00,38,24,14,0,0,0
2021-12-19 10:15,26,16,10,0,0,0
2021-12-19 10:30,20,11,9,0,0,0
2021-12-19 10:45,34,15,19,0,0,0
2021-12-19 11:00,30,12,18,0,0,0
2021-12-19 11:15,25,15,10,0,0,0
2021-12-19 11:30,25,18,7,0,0,0
2021-12-19 11:45,31,22,9,0,0,0
2021-12-19 12:00,29,17,12,0,0,0
2021-12-19 12:15,39,15,24,0,0,0
2021-12-19 12:30,26,7,19,0,0,0
2021-12-19 12:45,31,20,11,0,0,0
2021-12-19 13:00,22,12,10,0,0,0
2021-12-19 13:15,24,7,17,0,0,0
2021-12-19 13:30,36,20,16,0,0,0
2021-12-19 13:45,33,9,24,0,0,0
2021-12-19 14:00,43,27,16,0,0,0
2021-12-19 14:15,47,15,32,0,0,0
2021-12-19 14:30,42,14,28,0,0,0
2021-12-19 14:45,31,16,15,0,0,0
2021-12-19 15:00,30,12,18,0,0,0
2021-12-19 15:15,42,17,25,0,0,0
2021-12-19 15:30,33,13,20,0,0,0
2021-12-19 15:45,40,11,29,0,0,0
2021-12-19 16:00,54,25,29,0,0,0
2021-12-19 16:15,29,15,14,0,0,0
2021-12-19 16:30,43,21,22,0,0,0
2021-12-19 16:45,50,29,21,0,0,0
2021-12-19 17:00,46,23,23,0,0,0
2021-12-19 17:15,43,14,29,0,0,0
2021-12-19 17:30,36,15,21,0,0,0
2021-12-19 17:45,53,27,26,0,0,0
2021-12-19 18:00,24,12,12,0,0,0
2021-12-19 18:15,35,16,19,0,0,0
2021-12-19 18:30,28,13,15,0,0,0
2021-12-19 18:45,38,18,20,0,0,0
2021-12-19 19:00,29,13,16,0,0,0
2021-12-19 19:15,31,9,22,0,0,0
2021-12-19 19:30,24,6,18,0,0,0
2021-12-19 19:45,34,13,21,0,0,0
2021-12-19 20:00,20,8,12,0,0,0
2021-12-19 20:15,17,10,7,0,0,0
2021-12-19 20:30,19,4,15,0,0,0
2021-12-19 20:45,20,4,16,0,0,0
2021-12-19 21:00,10,5,5,0,0,0
2021-12-19 21:15,11,6,5,0,0,0
2021-12-19 21:30,11,3,8,0,0,0
2021-12-19 21:45,7,2,5,0,0,0
2021-12-19 22:00,10,5,5,0,0,0
2021-12-19 22:15,15,6,9,0,0,0
2021-12-19 22:30,6,2,4,0,0,0
2021-12-19 22:45,9,1,8,0,0,0
2021-12-19 23:00,2,1,1,0,0,0
2021-12-19 23:15,3,0,3,0,0,0
2021-12-19 23:30,10,1,9,0,0,0
2021-12-19 23:45,8,6,2,0,0,0
2021-12-20 00:00,7,0,7,0,0,0
2021-12-20 00:15,4,1,3,0,0,0
2021-12-20 00:30,4,0,4,0,0,0
2021-12-20 00:45,9,2,7,0,0,0
2021-12-20 01:00,1,0,1,0,0,0
2021-12-20 01:15,1,1,0,0,0,0
2021-12-20 01:30,1,1,0,0,0,0
2021-12-20 01:45,2,1,1,0,0,0
2021-12-20 02:00,2,1,1,0,0,0
2021-12-20 02:15,2,0,2,0,0,0
2021-12-20 02:30,0,0,0,0,0,0
2021-12-20 02:45,0,0,0,0,0,0
2021-12-20 03:00,1,1,0,0,0,0
2021-12-20 03:15,2,0,2,0,0,0
2021-12-20 03:30,0,0,0,0,0,0
2021-12-20 03:45,0,0,0,0,0,0
2021-12-20 04:00,0,0,0,0,0,0
2021-12-20 04:15,0,0,0,0,0,0
2021-12-20 04:30,1,0,1,0,0,0
2021-12-20 04:45,0,0,0,0,0,0
2021-12-20 05:00,0,0,0,0,0,0
2021-12-20 05:15,0,0,0,0,0,0
2021-12-20 05:30,15,5,10,0,0,0
2021-12-20 05:45,16,8,8,0,0,0
2021-12-20 06:00,5,3,2,0,0,0
2021-12-20 06:15,19,7,12,0,0,0
2021-12-20 06:30,27,14,13,0,0,0
2021-12-20 06:45,39,10,29,0,0,0
2021-12-20 07:00,55,16,39,0,0,0
2021-12-20 07:15,73,35,38,0,0,0
2021-12-20 07:30,140,70,70,0,0,0
2021-12-20 07:45,157,73,84,0,0,0
2021-12-20 08:00,289,223,66,0,0,0
2021-12-20 08:15,99,37,62,0,0,0
2021-12-20 08:30,84,44,40,0,0,0
2021-12-20 08:45,92,41,51,0,0,0
2021-12-20 09:00,86,34,52,0,0,0
2021-12-20 09:15,68,38,30,0,0,0
2021-12-20 09:30,75,44,31,0,0,0
2021-12-20 09:45,117,61,56,0,0,0
2021-12-20 10:00,123,61,62,0,0,0
2021-12-20 10:15,79,39,40,0,0,0
2021-12-20 10:30,76,41,35,0,0,0
2021-12-20 10:45,83,41,42,0,0,0
2021-12-20 11:00,89,57,32,0,0,0
2021-12-20 11:15,91,47,44,0,0,0
2021-12-20 11:30,120,78,42,0,0,0
2021-12-20 11:45,100,54,46,0,0,0
2021-12-20 12:00,118,64,54,0,0,0
2021-12-20 12:15,98,50,48,0,0,0
2021-12-20 12:30,82,36,46,0,0,0
2021-12-20 12:45,146,57,89,0,0,0
2021-12-20 13:00,94,39,55,0,0,0
2021-12-20 13:15,113,60,53,0,0,0
2021-12-20 13:30,147,43,104,0,0,0
2021-12-20 13:45,150,41,109,0,0,0
2021-12-20 14:00,136,67,69,0,0,0
2021-12-20 14:15,122,63,59,0,0,0
2021-12-20 14:30,123,66,57,0,0,0
2021-12-20 14:45,162,87,75,0,0,0
2021-12-20 15:00,117,67,50,0,0,0
2021-12-20 15:15,140,74,66,0,0,0
2021-12-20 15:30,147,87,60,0,0,0
2021-12-20 15:45,155,81,74,0,0,0
2021-12-20 16:00,165,90,75,0,0,0
2021-12-20 16:15,143,78,65,0,0,0
2021-12-20 16:30,167,96,71,0,0,0
2021-12-20 16:45,157,88,69,0,0,0
2021-12-20 17:00,147,86,61,0,0,0
2021-12-20 17:15,167,100,67,0,0,0
2021-12-20 17:30,129,76,53,0,0,0
2021-12-20 17:45,152,99,53,0,0,0
2021-12-20 18:00,123,71,52,0,0,0
2021-12-20 18:15,121,54,67,0,0,0
2021-12-20 18:30,84,39,45,0,0,0
2021-12-20 18:45,84,37,47,0,0,0
2021-12-20 19:00,74,30,44,0,0,0
2021-12-20 19:15,69,26,43,0,0,0
2021-12-20 19:30,69,16,53,0,0,0
2021-12-20 19:45,51,17,34,0,0,0
2021-12-20 20:00,89,30,59,0,0,0
2021-12-20 20:15,46,11,35,0,0,0
2021-12-20 20:30,28,8,20,0,0,0
2021-12-20 20:45,29,12,17,0,0,0
2021-12-20 21:00,33,11,22,0,0,0
2021-12-20 21:15,33,12,21,0,0,0
2021-12-20 21:30,23,4,19,0,0,0
2021-12-20 21:45,30,4,26,0,0,0
2021-12-20 22:00,13,4,9,0,0,0
2021-12-20 22:15,15,5,10,0,0,0
2021-12-20 22:30,11,5,6,0,0,0
2021-12-20 22:45,12,2,10,0,0,0
2021-12-20 23:00,15,3,12,0,0,0
2021-12-20 23:15,10,1,9,0,0,0
2021-12-20 23:30,8,1,7,0,0,0
2021-12-20 23:45,5,0,5,0,0,0
2021-12-21 00:00,7,5,2,0,0,0
2021-12-21 00:15,6,1,5,0,0,0
2021-12-21 00:30,3,1,2,0,0,0
2021-12-21 00:45,8,5,3,0,0,0
2021-12-21 01:00,1,0,1,0,0,0
2021-12-21 01:15,4,0,4,0,0,0
2021-12-21 01:30,1,0,1,0,0,0
2021-12-21 01:45,5,1,4,0,0,0
2021-12-21 02:00,3,2,1,0,0,0
2021-12-21 02:15,5,0,5,0,0,0
2021-12-21 02:30,1,0,1,0,0,0
2021-12-21 02:45,2,0,2,0,0,0
2021-12-21 03:00,1,0,1,0,0,0
2021-12-21 03:15,0,0,0,0,0,0
2021-12-21 03:30,2,0,2,0,0,0
2021-12-21 03:45,0,0,0,0,0,0
2021-12-21 04:00,0,0,0,0,0,0
2021-12-21 04:15,1,1,0,0,0,0
2021-12-21 04:30,1,0,1,0,0,0
2021-12-21 04:45,0,0,0,0,0,0
2021-12-21 05:00,0,0,0,0,0,0
2021-12-21 05:15,4,2,2,0,0,0
2021-12-21 05:30,13,6,7,0,0,0
2021-12-21 05:45,15,6,9,0,0,0
2021-12-21 06:00,4,1,3,0,0,0
2021-12-21 06:15,21,7,14,0,0,0
2021-12-21 06:30,35,15,20,0,0,0
2021-12-21 06:45,44,19,25,0,0,0
2021-12-21 07:00,53,10,43,0,0,0
2021-12-21 07:15,52,21,31,0,0,0
2021-12-21 07:30,96,46,50,0,0,0
2021-12-21 07:45,199,115,84,0,0,0
2021-12-21 08:00,182,118,64,0,0,0
2021-12-21 08:15,85,29,56,0,0,0
2021-12-21 08:30,79,38,41,0,0,0
2021-12-21 08:45,86,42,44,0,0,0
2021-12-21 09:00,77,34,43,0,0,0
2021-12-21 09:15,71,37,34,0,0,0
2021-12-21 09:30,65,37,28,0,0,0
2021-12-21 09:45,89,47,42,0,0,0
2021-12-21 10:00,115,56,59,0,0,0
2021-12-21 10:15,78,37,41,0,0,0
2021-12-21 10:30,71,38,33,0,0,0
2021-12-21 10:45,99,60,39,0,0,0
2021-12-21 11:00,58,27,31,0,0,0
2021-12-21 11:15,75,42,33,0,0,0
2021-12-21 11:30,83,42,41,0,0,0
2021-12-21 11:45,96,47,49,0,0,0
2021-12-21 12:00,89,52,37,0,0,0
2021-12-21 12:15,85,33,52,0,0,0
2021-12-21 12:30,82,40,42,0,0,0
2021-12-21 12:45,112,53,59,0,0,0
2021-12-21 13:00,96,36,60,0,0,0
2021-12-21 13:15,83,30,53,0,0,0
2021-12-21 13:30,167,54,113,0,0,0
2021-12-21 13:45,118,41,77,0,0,0
2021-12-21 14:00,130,71,59,0,0,0
2021-12-21 14:15,113,61,52,0,0,0
2021-12-21 14:30,126,51,75,0,0,0
2021-12-21 14:45,122,65,57,0,0,0
2021-12-21 15:00,124,69,55,0,0,0
2021-12-21 15:15,156,84,72,0,0,0
2021-12-21 15:30,133,78,55,0,0,0
2021-12-21 15:45,166,91,75,0,0,0
2021-12-21 16:00,161,86,75,0,0,0
2021-12-21 16:15,138,85,53,0,0,0
2021-12-21 16:30,129,57,72,0,0,0
2021-12-21 16:45,148,64,84,0,0,0
2021-12-21 17:00,133,73,60,0,0,0
2021-12-21 17:15,108,59,49,0,0,0
2021-12-21 17:30,111,65,46,0,0,0
2021-12-21 17:45,125,80,45,0,0,0
2021-12-21 18:00,94,52,42,0,0,0
2021-12-21 18:15,106,56,50,0,0,0
2021-12-21 18:30,88,42,46,0,0,0
2021-12-21 18:45,63,30,33,0,0,0
2021-12-21 19:00,70,25,45,0,0,0
2021-12-21 19:15,72,30,42,0,0,0
2021-12-21 19:30,60,15,45,0,0,0
2021-12-21 19:45,54,24,30,0,0,0
2021-12-21 20:00,62,17,45,0,0,0
2021-12-21 20:15,49,8,41,0,0,0
2021-12-21 20:30,23,4,19,0,0,0
2021-12-21 20:45,25,8,17,0,0,0
2021-12-21 21:00,31,13,18,0,0,0
2021-12-21 21:15,38,21,17,0,0,0
2021-12-21 21:30,13,2,11,0,0,0
2021-12-21 21:45,20,5,15,0,0,0
2021-12-21 22:00,30,10,20,0,0,0
2021-12-21 22:15,16,3,13,0,0,0
2021-12-21 22:30,9,2,7,0,0,0
2021-12-21 22:45,18,3,15,0,0,0
2021-12-21 23:00,12,1,11,0,0,0
2021-12-21 23:15,4,0,4,0,0,0
2021-12-21 23:30,5,0,5,0,0,0
2021-12-21 23:45,9,2,7,0,0,0
2021-12-22 00:00,10,0,10,0,0,0
2021-12-22 00:15,7,3,4,0,0,0
2021-12-22 00:30,1,1,0,0,0,0
2021-12-22 00:45,4,1,3,0,0,0
2021-12-22 01:00,4,0,4,0,0,0
2021-12-22 01:15,9,2,7,0,0,0
2021-12-22 01:30,4,0,4,0,0,0
2021-12-22 01:45,3,2,1,0,0,0
2021-12-22 02:00,1,0,1,0,0,0
2021-12-22 02:15,1,1,0,0,0,0
2021-12-22 02:30,0,0,0,0,0,0
2021-12-22 02:45,0,0,0,0,0,0
2021-12-22 03:00,1,0,1,0,0,0
2021-12-22 03:15,0,0,0,0,0,0
2021-12-22 03:30,1,0,1,0,0,0
2021-12-22 03:45,0,0,0,0,0,0
2021-12-22 04:00,3,0,3,0,0,0
2021-12-22 04:15,0,0,0,0,0,0
2021-12-22 04:30,0,0,0,0,0,0
2021-12-22 04:45,0,0,0,0,0,0
2021-12-22 05:00,0,0,0,0,0,0
2021-12-22 05:15,1,1,0,0,0,0
2021-12-22 05:30,13,3,10,0,0,0
2021-12-22 05:45,6,3,3,0,0,0
2021-12-22 06:00,6,2,4,0,0,0
2021-12-22 06:15,17,7,10,0,0,0
2021-12-22 06:30,39,17,22,0,0,0
2021-12-22 06:45,40,16,24,0,0,0
2021-12-22 07:00,57,25,32,0,0,0
2021-12-22 07:15,50,22,28,0,0,0
2021-12-22 07:30,114,53,61,0,0,0
2021-12-22 07:45,177,105,72,0,0,0
2021-12-22 08:00,197,140,57,0,0,0
2021-12-22 08:15,82,42,40,0,0,0
2021-12-22 08:30,90,46,44,0,0,0
2021-12-22 08:45,82,46,36,0,0,0
2021-12-22 09:00,52,28,24,0,0,0
2021-12-22 09:15,82,48,34,0,0,0
2021-12-22 09:30,76,42,34,0,0,0
2021-12-22 09:45,94,42,52,0,0,0
2021-12-22 10:00,133,59,74,0,0,0
2021-12-22 10:15,95,62,33,0,0,0
2021-12-22 10:30,81,44,37,0,0,0
2021-12-22 10:45,77,44,33,0,0,0
2021-12-22 11:00,104,52,52,0,0,0
2021-12-22 11:15,88,42,46,0,0,0
2021-12-22 11:30,114,70,44,0,0,0
2021-12-22 11:45,111,52,59,0,0,0
2021-12-22 12:00,128,58,70,0,0,0
2021-12-22 12:15,107,43,64,0,0,0
2021-12-22 12:30,115,49,66,0,0,0
2021-12-22 12:45,118,72,46,0,0,0
2021-12-22 13:00,104,48,56,0,0,0
2021-12-22 13:15,79,31,48,0,0,0
2021-12-22 13:30,164,41,123,0,0,0
2021-12-22 13:45,135,47,88,0,0,0
2021-12-22 14:00,78,29,49,0,0,0
2021-12-22 14:15,102,47,55,0,0,0
2021-12-22 14:30,133,41,92,0,0,0
2021-12-22 14:45,131,73,58,0,0,0
2021-12-22 15:00,108,56,52,0,0,0
2021-12-22 15:15,107,47,60,0,0,0
2021-12-22 15:30,116,48,68,0,0,0
2021-12-22 15:45,139,75,64,0,0,0
2021-12-22 16:00,159,68,91,0,0,0
2021-12-22 16:15,88,44,44,0,0,0
2021-12-22 16:30,120,63,57,0,0,0
2021-12-22 16:45,107,48,59,0,0,0
2021-12-22 17:00,91,43,48,0,0,0
2021-12-22 17:15,117,43,74,0,0,0
2021-12-22 17:30,70,38,32,0,0,0
2021-12-22 17:45,92,46,46,0,0,0
2021-12-22 18:00,87,55,32,0,0,0
2021-12-22 18:15,87,47,40,0,0,0
2021-12-22 18:30,61,31,30,0,0,0
2021-12-22 18:45,65,27,38,0,0,0
2021-12-22 19:00,63,24,39,0,0,0
2021-12-22 19:15,53,30,23,0,0,0
2021-12-22 19:30,56,30,26,0,0,0
2021-12-22 19:45,45,11,34,0,0,0
2021-12-22 20:00,54,20,34,0,0,0
2021-12-22 20:15,64,15,49,0,0,0
2021-12-22 20:30,31,5,26,0,0,0
2021-12-22 20:45,26,5,21,0,0,0
2021-12-22 21:00,19,8,11,0,0,0
2021-12-22 21:15,25,15,10,0,0,0
2021-12-22 21:30,15,2,13,0,0,0
2021-12-22 21:45,25,12,13,0,0,0
2021-12-22 22:00,16,7,9,0,0,0
2021-12-22 22:15,10,2,8,0,0,0
2021-12-22 22:30,10,2,8,0,0,0
2021-12-22 22:45,12,5,7,0,0,0
2021-12-22 23:00,12,3,9,0,0,0
2021-12-22 23:15,10,3,7,0,0,0
2021-12-22 23:30,10,4,6,0,0,0
2021-12-22 23:45,4,2,2,0,0,0
2021-12-23 00:00,9,5,4,0,0,0
2021-12-23 00:15,7,2,5,0,0,0
2021-12-23 00:30,13,1,12,0,0,0
2021-12-23 00:45,6,0,6,0,0,0
2021-12-23 01:00,2,0,2,0,0,0
2021-12-23 01:15,13,2,11,0,0,0
2021-12-23 01:30,13,2,11,0,0,0
2021-12-23 01:45,3,2,1,0,0,0
2021-12-23 02:00,3,2,1,0,0,0
2021-12-23 02:15,4,2,2,0,0,0
2021-12-23 02:30,2,0,2,0,0,0
2021-12-23 02:45,3,1,2,0,0,0
2021-12-23 03:00,1,1,0,0,0,0
2021-12-23 03:15,0,0,0,0,0,0
2021-12-23 03:30,1,0,1,0,0,0
2021-12-23 03:45,0,0,0,0,0,0
2021-12-23 04:00,0,0,0,0,0,0
2021-12-23 04:15,1,0,1,0,0,0
2021-12-23 04:30,4,4,0,0,0,0
2021-12-23 04:45,1,1,0,0,0,0
2021-12-23 05:00,0,0,0,0,0,0
2021-12-23 05:15,0,0,0,0,0,0
2021-12-23 05:30,10,1,9,0,0,0
2021-12-23 05:45,11,3,8,0,0,0
2021-12-23 06:00,2,0,2,0,0,0
2021-12-23 06:15,13,5,8,0,0,0
2021-12-23 06:30,12,7,5,0,0,0
2021-12-23 06:45,15,8,7,0,0,0
2021-12-23 07:00,23,11,12,0,0,0
2021-12-23 07:15,15,9,6,0,0,0
2021-12-23 07:30,56,36,20,0,0,0
2021-12-23 07:45,98,79,19,0,0,0
2021-12-23 08:00,144,127,17,0,0,0
2021-12-23 08:15,52,30,22,0,0,0
2021-12-23 08:30,36,27,9,0,0,0
2021-12-23 08:45,40,20,20,0,0,0
2021-12-23 09:00,56,32,24,0,0,0
2021-12-23 09:15,41,31,10,0,0,0
2021-12-23 09:30,34,18,16,0,0,0
2021-12-23 09:45,61,42,19,0,0,0
2021-12-23 10:00,71,41,30,0,0,0
2021-12-23 10:15,50,33,17,0,0,0
2021-12-23 10:30,56,28,28,0,0,0
2021-12-23 10:45,59,29,30,0,0,0
2021-12-23 11:00,50,24,26,0,0,0
2021-12-23 11:15,61,34,27,0,0,0
2021-12-23 11:30,43,26,17,0,0,0
2021-12-23 11:45,84,39,45,0,0,0
2021-12-23 12:00,61,31,30,0,0,0
2021-12-23 12:15,59,19,40,0,0,0
2021-12-23 12:30,88,27,61,0,0,0
2021-12-23 12:45,135,22,113,0,0,0
2021-12-23 13:00,66,30,36,0,0,0
2021-12-23 13:15,70,26,44,0,0,0
2021-12-23 13:30,73,25,48,0,0,0
2021-12-23 13:45,68,30,38,0,0,0
2021-12-23 14:00,67,33,34,0,0,0
2021-12-23 14:15,88,46,42,0,0,0
2021-12-23 14:30,84,42,42,0,0,0
2021-12-23 14:45,69,27,42,0,0,0
2021-12-23 15:00,75,28,47,0,0,0
2021-12-23 15:15,71,30,41,0,0,0
2021-12-23 15:30,70,32,38,0,0,0
2021-12-23 15:45,71,29,42,0,0,0
2021-12-23 16:00,54,17,37,0,0,0
2021-12-23 16:15,74,40,34,0,0,0
2021-12-23 16:30,71,37,34,0,0,0
2021-12-23 16:45,74,28,46,0,0,0
2021-12-23 17:00,63,24,39,0,0,0
2021-12-23 17:15,52,26,26,0,0,0
2021-12-23 17:30,42,21,21,0,0,0
2021-12-23 17:45,53,22,31,0,0,0
2021-12-23 18:00,64,32,32,0,0,0
2021-12-23 18:15,63,27,36,0,0,0
2021-12-23 18:30,47,23,24,0,0,0
2021-12-23 18:45,46,16,30,0,0,0
2021-12-23 19:00,37,15,22,0,0,0
2021-12-23 19:15,36,12,24,0,0,0
2021-12-23 19:30,27,14,13,0,0,0
2021-12-23 19:45,37,17,20,0,0,0
2021-12-23 20:00,50,15,35,0,0,0
2021-12-23 20:15,35,10,25,0,0,0
2021-12-23 20:30,26,2,24,0,0,0
2021-12-23 20:45,13,2,11,0,0,0
2021-12-23 21:00,10,2,8,0,0,0
2021-12-23 21:15,11,4,7,0,0,0
2021-12-23 21:30,9,3,6,0,0,0
2021-12-23 21:45,8,3,5,0,0,0
2021-12-23 22:00,10,2,8,0,0,0
2021-12-23 22:15,3,1,2,0,0,0
2021-12-23 22:30,7,4,3,0,0,0
2021-12-23 22:45,9,4,5,0,0,0
2021-12-23 23:00,6,3,3,0,0,0
2021-12-23 23:15,2,1,1,0,0,0
2021-12-23 23:30,6,2,4,0,0,0
2021-12-23 23:45,5,2,3,0,0,0
2021-12-24 00:00,4,2,2,0,0,0
2021-12-24 00:15,6,0,6,0,0,0
2021-12-24 00:30,2,1,1,0,0,0
2021-12-24 00:45,3,1,2,0,0,0
2021-12-24 01:00,10,0,10,0,0,0
2021-12-24 01:15,6,3,3,0,0,0
2021-12-24 01:30,3,0,3,0,0,0
2021-12-24 01:45,3,0,3,0,0,0
2021-12-24 02:00,6,1,5,0,0,0
2021-12-24 02:15,0,0,0,0,0,0
2021-12-24 02:30,2,1,1,0,0,0
2021-12-24 02:45,0,0,0,0,0,0
2021-12-24 03:00,2,1,1,0,0,0
2021-12-24 03:15,1,1,0,0,0,0
2021-12-24 03:30,1,0,1,0,0,0
2021-12-24 03:45,3,3,0,0,0,0
2021-12-24 04:00,1,0,1,0,0,0
2021-12-24 04:15,1,0,1,0,0,0
2021-12-24 04:30,1,0,1,0,0,0
2021-12-24 04:45,0,0,0,0,0,0
2021-12-24 05:00,0,0,0,0,0,0
2021-12-24 05:15,2,1,1,0,0,0
2021-12-24 05:30,4,0,4,0,0,0
2021-12-24 05:45,4,1,3,0,0,0
2021-12-24 06:00,6,6,0,0,0,0
2021-12-24 06:15,2,0,2,0,0,0
2021-12-24 06:30,7,6,1,0,0,0
2021-12-24 06:45,10,9,1,0,0,0
2021-12-24 07:00,13,11,2,0,0,0
2021-12-24 07:15,15,12,3,0,0,0
2021-12-24 07:30,21,12,9,0,0,0
2021-12-24 07:45,14,4,10,0,0,0
2021-12-24 08:00,19,10,9,0,0,0
2021-12-24 08:15,31,22,9,0,0,0
2021-12-24 08:30,20,10,10,0,0,0
2021-12-24 08:45,27,15,12,0,0,0
2021-12-24 09:00,35,25,10,0,0,0
2021-12-24 09:15,51,32,19,0,0,0
2021-12-24 09:30,48,29,19,0,0,0
2021-12-24 09:45,67,42,25,0,0,0
2021-12-24 10:00,50,32,18,0,0,0
2021-12-24 10:15,59,41,18,0,0,0
2021-12-24 10:30,48,27,21,0,0,0
2021-12-24 10:45,57,29,28,0,0,0
2021-12-24 11:00,51,35,16,0,0,0
2021-12-24 11:15,48,27,21,0,0,0
2021-12-24 11:30,56,21,35,0,0,0
2021-12-24 11:45,56,16,40,0,0,0
2021-12-24 12:00,48,29,19,0,0,0
2021-12-24 12:15,45,14,31,0,0,0
2021-12-24 12:30,48,13,35,0,0,0
2021-12-24 12:45,41,10,31,0,0,0
2021-12-24 13:00,24,8,16,0,0,0
2021-12-24 13:15,33,5,28,0,0,0
2021-12-24 13:30,39,11,28,0,0,0
2021-12-24 13:45,23,8,15,0,0,0
2021-12-24 14:00,26,5,21,0,0,0
2021-12-24 14:15,16,3,13,0,0,0
2021-12-24 14:30,5,1,4,0,0,0
2021-12-24 14:45,18,6,12,0,0,0
2021-12-24 15:00,10,8,2,0,0,0
2021-12-24 15:15,5,1,4,0,0,0
2021-12-24 15:30,15,6,9,0,0,0
2021-12-24 15:45,3,2,1,0,0,0
2021-12-24 16:00,12,6,6,0,0,0
2021-12-24 16:15,11,3,8,0,0,0
2021-12-24 16:30,12,9,3,0,0,0
2021-12-24 16:45,4,2,2,0,0,0
2021-12-24 17:00,4,1,3,0,0,0
2021-12-24 17:15,2,2,0,0,0,0
2021-12-24 17:30,2,1,1,0,0,0
2021-12-24 17:45,6,4,2,0,0,0
2021-12-24 18:00,8,5,3,0,0,0
2021-12-24 18:15,10,2,8,0,0,0
2021-12-24 18:30,4,0,4,0,0,0
2021-12-24 18:45,7,1,6,0,0,0
2021-12-24 19:00,0,0,0,0,0,0
2021-12-24 19:15,3,3,0,0,0,0
2021-12-24 19:30,2,0,2,0,0,0
2021-12-24 19:45,4,3,1,0,0,0
2021-12-24 20:00,3,0,3,0,0,0
2021-12-24 20:15,5,1,4,0,0,0
2021-12-24 20:30,8,7,1,0,0,0
2021-12-24 20:45,3,1,2,0,0,0
2021-12-24 21:00,4,1,3,0,0,0
2021-12-24 21:15,3,2,1,0,0,0
2021-12-24 21:30,2,0,2,0,0,0
2021-12-24 21:45,6,1,5,0,0,0
2021-12-24 22:00,2,2,0,0,0,0
2021-12-24 22:15,5,2,3,0,0,0
2021-12-24 22:30,2,2,0,0,0,0
2021-12-24 22:45,5,2,3,0,0,0
2021-12-24 23:00,3,2,1,0,0,0
2021-12-24 23:15,5,0,5,0,0,0
2021-12-24 23:30,4,0,4,0,0,0
2021-12-24 23:45,4,2,2,0,0,0
2021-12-25 00:00,2,0,2,0,0,0
2021-12-25 00:15,2,0,2,0,0,0
2021-12-25 00:30,7,3,4,0,0,0
2021-12-25 00:45,4,1,3,0,0,0
2021-12-25 01:00,3,2,1,0,0,0
2021-12-25 01:15,0,0,0,0,0,0
2021-12-25 01:30,1,1,0,0,0,0
2021-12-25 01:45,3,1,2,0,0,0
2021-12-25 02:00,0,0,0,0,0,0
2021-12-25 02:15,1,1,0,0,0,0
2021-12-25 02:30,2,1,1,0,0,0
2021-12-25 02:45,1,0,1,0,0,0
2021-12-25 03:00,0,0,0,0,0,0
2021-12-25 03:15,0,0,0,0,0,0
2021-12-25 03:30,0,0,0,0,0,0
2021-12-25 03:45,0,0,0,0,0,0
2021-12-25 04:00,0,0,0,0,0,0
2021-12-25 04:15,2,0,2,0,0,0
2021-12-25 04:30,0,0,0,0,0,0
2021-12-25 04:45,1,0,1,0,0,0
2021-12-25 05:00,0,0,0,0,0,0
2021-12-25 05:15,1,1,0,0,0,0
2021-12-25 05:30,2,0,2,0,0,0
2021-12-25 05:45,0,0,0,0,0,0
2021-12-25 06:00,2,2,0,0,0,0
2021-12-25 06:15,1,1,0,0,0,0
2021-12-25 06:30,2,1,1,0,0,0
2021-12-25 06:45,4,2,2,0,0,0
2021-12-25 07:00,2,1,1,0,0,0
2021-12-25 07:15,1,0,1,0,0,0
2021-12-25 07:30,2,1,1,0,0,0
2021-12-25 07:45,4,0,4,0,0,0
2021-12-25 08:00,3,3,0,0,0,0
2021-12-25 08:15,7,3,4,0,0,0
2021-12-25 08:30,4,1,3,0,0,0
2021-12-25 08:45,1,0,1,0,0,0
2021-12-25 09:00,1,0,1,0,0,0
2021-12-25 09:15,3,2,1,0,0,0
2021-12-25 09:30,10,6,4,0,0,0
2021-12-25 09:45,14,10,4,0,0,0
2021-12-25 10:00,11,5,6,0,0,0
2021-12-25 10:15,6,1,5,0,0,0
2021-12-25 10:30,9,6,3,0,0,0
2021-12-25 10:45,6,2,4,0,0,0
2021-12-25 11:00,6,3,3,0,0,0
2021-12-25 11:15,7,2,5,0,0,0
2021-12-25 11:30,8,3,5,0,0,0
2021-12-25 11:45,8,6,2,0,0,0
2021-12-25 12:00,15,2,13,0,0,0
2021-12-25 12:15,13,6,7,0,0,0
2021-12-25 12:30,10,4,6,0,0,0
2021-12-25 12:45,11,4,7,0,0,0
2021-12-25 13:00,13,5,8,0,0,0
2021-12-25 13:15,6,3,3,0,0,0
2021-12-25 13:30,12,5,7,0,0,0
2021-12-25 13:45,16,9,7,0,0,0
2021-12-25 14:00,16,8,8,0,0,0
2021-12-25 14:15,15,6,9,0,0,0
2021-12-25 14:30,9,5,4,0,0,0
2021-12-25 14:45,11,8,3,0,0,0
2021-12-25 15:00,16,3,13,0,0,0
2021-12-25 15:15,10,4,6,0,0,0
2021-12-25 15:30,8,3,5,0,0,0
2021-12-25 15:45,6,4,2,0,0,0
2021-12-25 16:00,12,1,11,0,0,0
2021-12-25 16:15,7,1,6,0,0,0
2021-12-25 16:30,5,0,5,0,0,0
2021-12-25 16:45,8,6,2,0,0,0
2021-12-25 17:00,8,5,3,0,0,0
2021-12-25 17:15,9,0,9,0,0,0
2021-12-25 17:30,4,2,2,0,0,0
2021-12-25 17:45,4,3,1,0,0,0
2021-12-25 18:00,4,2,2,0,0,0
2021-12-25 18:15,4,3,1,0,0,0
2021-12-25 18:30,5,4,1,0,0,0
2021-12-25 18:45,11,4,7,0,0,0
2021-12-25 19:00,1,0,1,0,0,0
2021-12-25 19:15,10,0,10,0,0,0
2021-12-25 19:30,16,14,2,0,0,0
2021-12-25 19:45,0,0,0,0,0,0
2021-12-25 20:00,2,1,1,0,0,0
2021-12-25 20:15,12,1,11,0,0,0
2021-12-25 20:30,6,1,5,0,0,0
2021-12-25 20:45,4,3,1,0,0,0
2021-12-25 21:00,4,3,1,0,0,0
2021-12-25 21:15,3,1,2,0,0,0
2021-12-25 21:30,1,1,0,0,0,0
2021-12-25 21:45,4,4,0,0,0,0
2021-12-25 22:00,0,0,0,0,0,0
2021-12-25 22:15,3,2,1,0,0,0
2021-12-25 22:30,2,2,0,0,0,0
2021-12-25 22:45,3,0,3,0,0,0
2021-12-25 23:00,2,0,2,0,0,0
2021-12-25 23:15,2,1,1,0,0,0
2021-12-25 23:30,7,5,2,0,0,0
2021-12-25 23:45,3,1,2,0,0,0
2021-12-26 00:00,1,1,0,0,0,0
2021-12-26 00:15,2,1,1,0,0,0
2021-12-26 00:30,2,2,0,0,0,0
2021-12-26 00:45,0,0,0,0,0,0
2021-12-26 01:00,0,0,0,0,0,0
2021-12-26 01:15,1,0,1,0,0,0
2021-12-26 01:30,1,0,1,0,0,0
2021-12-26 01:45,1,0,1,0,0,0
2021-12-26 02:00,0,0,0,0,0,0
2021-12-26 02:15,0,0,0,0,0,0
2021-12-26 02:30,2,0,2,0,0,0
2021-12-26 02:45,0,0,0,0,0,0
2021-12-26 03:00,1,1,0,0,0,0
2021-12-26 03:15,2,2,0,0,0,0
2021-12-26 03:30,1,0,1,0,0,0
2021-12-26 03:45,0,0,0,0,0,0
2021-12-26 04:00,0,0,0,0,0,0
2021-12-26 04:15,1,0,1,0,0,0
2021-12-26 04:30,1,0,1,0,0,0
2021-12-26 04:45,0,0,0,0,0,0
2021-12-26 05:00,1,1,0,0,0,0
2021-12-26 05:15,2,2,0,0,0,0
2021-12-26 05:30,6,1,5,0,0,0
2021-12-26 05:45,2,0,2,0,0,0
2021-12-26 06:00,1,1,0,0,0,0
2021-12-26 06:15,3,2,1,0,0,0
2021-12-26 06:30,7,4,3,0,0,0
2021-12-26 06:45,0,0,0,0,0,0
2021-12-26 07:00,1,0,1,0,0,0
2021-12-26 07:15,1,1,0,0,0,0
2021-12-26 07:30,3,0,3,0,0,0
2021-12-26 07:45,2,0,2,0,0,0
2021-12-26 08:00,1,0,1,0,0,0
2021-12-26 08:15,5,3,2,0,0,0
2021-12-26 08:30,5,0,5,0,0,0
2021-12-26 08:45,1,0,1,0,0,0
2021-12-26 09:00,2,2,0,0,0,0
2021-12-26 09:15,7,3,4,0,0,0
2021-12-26 09:30,8,5,3,0,0,0
2021-12-26 09:45,5,3,2,0,0,0
2021-12-26 10:00,4,3,1,0,0,0
2021-12-26 10:15,1,1,0,0,0,0
2021-12-26 10:30,2,1,1,0,0,0
2021-12-26 10:45,7,4,3,0,0,0
2021-12-26 11:00,9,4,5,0,0,0
2021-12-26 11:15,4,2,2,0,0,0
2021-12-26 11:30,10,2,8,0,0,0
2021-12-26 11:45,14,4,10,0,0,0
2021-12-26 12:00,7,3,4,0,0,0
2021-12-26 12:15,13,6,7,0,0,0
2021-12-26 12:30,14,5,9,0,0,0
2021-12-26 12:45,5,2,3,0,0,0
2021-12-26 13:00,16,8,8,0,0,0
2021-12-26 13:15,13,5,8,0,0,0
2021-12-26 13:30,15,6,9,0,0,0
2021-12-26 13:45,9,4,5,0,0,0
2021-12-26 14:00,13,9,4,0,0,0
2021-12-26 14:15,14,2,12,0,0,0
2021-12-26 14:30,14,7,7,0,0,0
2021-12-26 14:45,17,4,13,0,0,0
2021-12-26 15:00,11,9,2,0,0,0
2021-12-26 15:15,11,10,1,0,0,0
2021-12-26 15:30,10,4,6,0,0,0
2021-12-26 15:45,11,5,6,0,0,0
2021-12-26 16:00,18,8,10,0,0,0
2021-12-26 16:15,11,4,7,0,0,0
2021-12-26 16:30,9,6,3,0,0,0
2021-12-26 16:45,6,3,3,0,0,0
2021-12-26 17:00,5,0,5,0,0,0
2021-12-26 17:15,15,3,12,0,0,0
2021-12-26 17:30,3,1,2,0,0,0
2021-12-26 17:45,7,3,4,0,0,0
2021-12-26 18:00,7,2,5,0,0,0
2021-12-26 18:15,8,2,6,0,0,0
2021-12-26 18:30,12,6,6,0,0,0
2021-12-26 18:45,2,1,1,0,0,0
2021-12-26 19:00,6,1,5,0,0,0
2021-12-26 19:15,4,1,3,0,0,0
2021-12-26 19:30,6,3,3,0,0,0
2021-12-26 19:45,9,1,8,0,0,0
2021-12-26 20:00,7,6,1,0,0,0
2021-12-26 20:15,7,1,6,0,0,0
2021-12-26 20:30,3,0,3,0,0,0
2021-12-26 20:45,9,6,3,0,0,0
2021-12-26 21:00,4,4,0,0,0,0
2021-12-26 21:15,7,4,3,0,0,0
2021-12-26 21:30,2,0,2,0,0,0
2021-12-26 21:45,4,1,3,0,0,0
2021-12-26 22:00,1,0,1,0,0,0
2021-12-26 22:15,12,9,3,0,0,0
2021-12-26 22:30,5,4,1,0,0,0
2021-12-26 22:45,4,0,4,0,0,0
2021-12-26 23:00,2,0,2,0,0,0
2021-12-26 23:15,8,5,3,0,0,0
2021-12-26 23:30,3,0,3,0,0,0
2021-12-26 23:45,2,1,1,0,0,0
2021-12-27 00:00,1,0,1,0,0,0
2021-12-27 00:15,1,1,0,0,0,0
2021-12-27 00:30,0,0,0,0,0,0
2021-12-27 00:45,1,0,1,0,0,0
2021-12-27 01:00,3,0,3,0,0,0
2021-12-27 01:15,0,0,0,0,0,0
2021-12-27 01:30,2,0,2,0,0,0
2021-12-27 01:45,0,0,0,0,0,0
2021-12-27 02:00,0,0,0,0,0,0
2021-12-27 02:15,0,0,0,0,0,0
2021-12-27 02:30,0,0,0,0,0,0
2021-12-27 02:45,0,0,0,0,0,0
2021-12-27 03:00,1,1,0,0,0,0
2021-12-27 03:15,1,1,0,0,0,0
2021-12-27 03:30,0,0,0,0,0,0
2021-12-27 03:45,0,0,0,0,0,0
2021-12-27 04:00,1,0,1,0,0,0
2021-12-27 04:15,2,1,1,0,0,0
2021-12-27 04:30,1,0,1,0,0,0
2021-12-27 04:45,2,2,0,0,0,0
2021-12-27 05:00,0,0,0,0,0,0
2021-12-27 05:15,0,0,0,0,0,0
2021-12-27 05:30,6,0,6,0,0,0
2021-12-27 05:45,4,2,2,0,0,0
2021-12-27 06:00,6,2,4,0,0,0
2021-12-27 06:15,7,3,4,0,0,0
2021-12-27 06:30,16,3,13,0,0,0
2021-12-27 06:45,20,6,14,0,0,0
2021-12-27 07:00,21,2,19,0,0,0
2021-12-27 07:15,19,8,11,0,0,0
2021-12-27 07:30,36,18,18,0,0,0
2021-12-27 07:45,25,9,16,0,0,0
2021-12-27 08:00,23,11,12,0,0,0
2021-12-27 08:15,17,8,9,0,0,0
2021-12-27 08:30,10,7,3,0,0,0
2021-12-27 08:45,20,10,10,0,0,0
2021-12-27 09:00,11,7,4,0,0,0
2021-12-27 09:15,22,17,5,0,0,0
2021-12-27 09:30,31,21,10,0,0,0
2021-12-27 09:45,27,23,4,0,0,0
2021-12-27 10:00,27,21,6,0,0,0
2021-12-27 10:15,28,19,9,0,0,0
2021-12-27 10:30,28,21,7,0,0,0
2021-12-27 10:45,28,15,13,0,0,0
2021-12-27 11:00,44,34,10,0,0,0
2021-12-27 11:15,29,22,7,0,0,0
2021-12-27 11:30,39,23,16,0,0,0
2021-12-27 11:45,39,26,13,0,0,0
2021-12-27 12:00,28,12,16,0,0,0
2021-12-27 12:15,47,23,24,0,0,0
2021-12-27 12:30,40,12,28,0,0,0
2021-12-27 12:45,42,15,27,0,0,0
2021-12-27 13:00,37,21,16,0,0,0
2021-12-27 13:15,41,22,19,0,0,0
2021-12-27 13:30,34,15,19,0,0,0
2021-12-27 13:45,42,17,25,0,0,0
2021-12-27 14:00,51,29,22,0,0,0
2021-12-27 14:15,64,36,28,0,0,0
2021-12-27 14:30,34,19,15,0,0,0
2021-12-27 14:45,51,25,26,0,0,0
2021-12-27 15:00,59,26,33,0,0,0
2021-12-27 15:15,89,50,39,0,0,0
2021-12-27 15:30,54,28,26,0,0,0
2021-12-27 15:45,59,27,32,0,0,0
2021-12-27 16:00,56,23,33,0,0,0
2021-12-27 16:15,66,27,39,0,0,0
2021-12-27 16:30,64,31,33,0,0,0
2021-12-27 16:45,46,19,27,0,0,0
2021-12-27 17:00,32,14,18,0,0,0
2021-12-27 17:15,29,16,13,0,0,0
2021-12-27 17:30,45,17,28,0,0,0
2021-12-27 17:45,36,23,13,0,0,0
2021-12-27 18:00,44,24,20,0,0,0
2021-12-27 18:15,42,14,28,0,0,0
2021-12-27 18:30,31,10,21,0,0,0
2021-12-27 18:45,33,10,23,0,0,0
2021-12-27 19:00,32,12,20,0,0,0
2021-12-27 19:15,34,11,23,0,0,0
2021-12-27 19:30,33,8,25,0,0,0
2021-12-27 19:45,22,10,12,0,0,0
2021-12-27 20:00,18,3,15,0,0,0
2021-12-27 20:15,14,3,11,0,0,0
2021-12-27 20:30,6,0,6,0,0,0
2021-12-27 20:45,7,2,5,0,0,0
2021-12-27 21:00,9,7,2,0,0,0
2021-12-27 21:15,13,7,6,0,0,0
2021-12-27 21:30,7,3,4,0,0,0
2021-12-27 21:45,5,2,3,0,0,0
2021-12-27 22:00,8,4,4,0,0,0
2021-12-27 22:15,4,2,2,0,0,0
2021-12-27 22:30,9,0,9,0,0,0
2021-12-27 22:45,6,1,5,0,0,0
2021-12-27 23:00,6,2,4,0,0,0
2021-12-27 23:15,8,1,7,0,0,0
2021-12-27 23:30,3,0,3,0,0,0
2021-12-27 23:45,2,0,2,0,0,0
2021-12-28 00:00,5,0,5,0,0,0
2021-12-28 00:15,1,0,1,0,0,0
2021-12-28 00:30,3,2,1,0,0,0
2021-12-28 00:45,1,0,1,0,0,0
2021-12-28 01:00,1,1,0,0,0,0
2021-12-28 01:15,2,1,1,0,0,0
2021-12-28 01:30,3,0,3,0,0,0
2021-12-28 01:45,1,1,0,0,0,0
2021-12-28 02:00,1,1,0,0,0,0
2021-12-28 02:15,2,0,2,0,0,0
2021-12-28 02:30,0,0,0,0,0,0
2021-12-28 02:45,3,3,0,0,0,0
2021-12-28 03:00,3,2,1,0,0,0
2021-12-28 03:15,4,0,4,0,0,0
2021-12-28 03:30,2,2,0,0,0,0
2021-12-28 03:45,1,0,1,0,0,0
2021-12-28 04:00,2,0,2,0,0,0
2021-12-28 04:15,1,0,1,0,0,0
2021-12-28 04:30,2,0,2,0,0,0
2021-12-28 04:45,2,1,1,0,0,0
2021-12-28 05:00,0,0,0,0,0,0
2021-12-28 05:15,2,2,0,0,0,0
2021-12-28 05:30,3,0,3,0,0,0
2021-12-28 05:45,5,2,3,0,0,0
2021-12-28 06:00,2,0,2,0,0,0
2021-12-28 06:15,8,2,6,0,0,0
2021-12-28 06:30,13,4,9,0,0,0
2021-12-28 06:45,23,4,19,0,0,0
2021-12-28 07:00,24,5,19,0,0,0
2021-12-28 07:15,18,6,12,0,0,0
2021-12-28 07:30,28,10,18,0,0,0
2021-12-28 07:45,35,9,26,0,0,0
2021-12-28 08:00,25,15,10,0,0,0
2021-12-28 08:15,18,11,7,0,0,0
2021-12-28 08:30,14,10,4,0,0,0
2021-12-28 08:45,16,12,4,0,0,0
2021-12-28 09:00,23,17,6,0,0,0
2021-12-28 09:15,21,16,5,0,0,0
2021-12-28 09:30,29,20,9,0,0,0
2021-12-28 09:45,30,26,4,0,0,0
2021-12-28 10:00,37,27,10,0,0,0
2021-12-28 10:15,28,22,6,0,0,0
2021-12-28 10:30,25,17,8,0,0,0
2021-12-28 10:45,36,18,18,0,0,0
2021-12-28 11:00,41,25,16,0,0,0
2021-12-28 11:15,29,12,17,0,0,0
2021-12-28 11:30,30,15,15,0,0,0
2021-12-28 11:45,35,17,18,0,0,0
2021-12-28 12:00,44,20,24,0,0,0
2021-12-28 12:15,33,17,16,0,0,0
2021-12-28 12:30,38,10,28,0,0,0
2021-12-28 12:45,30,13,17,0,0,0
2021-12-28 13:00,40,21,19,0,0,0
2021-12-28 13:15,28,9,19,0,0,0
2021-12-28 13:30,26,14,12,0,0,0
2021-12-28 13:45,22,12,10,0,0,0
2021-12-28 14:00,30,15,15,0,0,0
2021-12-28 14:15,37,19,18,0,0,0
2021-12-28 14:30,27,10,17,0,0,0
2021-12-28 14:45,30,12,18,0,0,0
2021-12-28 15:00,25,14,11,0,0,0
2021-12-28 15:15,37,15,22,0,0,0
2021-12-28 15:30,29,16,13,0,0,0
2021-12-28 15:45,34,18,16,0,0,0
2021-12-28 16:00,39,20,19,0,0,0
2021-12-28 16:15,34,14,20,0,0,0
2021-12-28 16:30,38,17,21,0,0,0
2021-12-28 16:45,27,12,15,0,0,0
2021-12-28 17:00,27,11,16,0,0,0
2021-12-28 17:15,23,13,10,0,0,0
2021-12-28 17:30,22,11,11,0,0,0
2021-12-28 17:45,28,13,15,0,0,0
2021-12-28 18:00,25,12,13,0,0,0
2021-12-28 18:15,29,10,19,0,0,0
2021-12-28 18:30,17,9,8,0,0,0
2021-12-28 18:45,28,9,19,0,0,0
2021-12-28 19:00,21,7,14,0,0,0
2021-12-28 19:15,20,2,18,0,0,0
2021-12-28 19:30,17,6,11,0,0,0
2021-12-28 19:45,15,5,10,0,0,0
2021-12-28 20:00,14,6,8,0,0,0
2021-12-28 20:15,7,2,5,0,0,0
2021-12-28 20:30,11,6,5,0,0,0
2021-12-28 20:45,13,6,7,0,0,0
2021-12-28 21:00,10,6,4,0,0,0
2021-12-28 21:15,6,3,3,0,0,0
2021-12-28 21:30,13,5,8,0,0,0
2021-12-28 21:45,9,1,8,0,0,0
2021-12-28 22:00,1,1,0,0,0,0
2021-12-28 22:15,6,3,3,0,0,0
2021-12-28 22:30,5,1,4,0,0,0
2021-12-28 22:45,4,2,2,0,0,0
2021-12-28 23:00,7,5,2,0,0,0
2021-12-28 23:15,0,0,0,0,0,0
2021-12-28 23:30,4,1,3,0,0,0
2021-12-28 23:45,3,2,1,0,0,0
2021-12-29 00:00,2,0,2,0,0,0
2021-12-29 00:15,4,0,4,0,0,0
2021-12-29 00:30,3,0,3,0,0,0
2021-12-29 00:45,2,1,1,0,0,0
2021-12-29 01:00,0,0,0,0,0,0
2021-12-29 01:15,3,1,2,0,0,0
2021-12-29 01:30,0,0,0,0,0,0
2021-12-29 01:45,1,0,1,0,0,0
2021-12-29 02:00,2,1,1,0,0,0
2021-12-29 02:15,3,0,3,0,0,0
2021-12-29 02:30,1,0,1,0,0,0
2021-12-29 02:45,0,0,0,0,0,0
2021-12-29 03:00,0,0,0,0,0,0
2021-12-29 03:15,0,0,0,0,0,0
2021-12-29 03:30,1,0,1,0,0,0
2021-12-29 03:45,2,1,1,0,0,0
2021-12-29 04:00,0,0,0,0,0,0
2021-12-29 04:15,0,0,0,0,0,0
2021-12-29 04:30,1,0,1,0,0,0
2021-12-29 04:45,1,0,1,0,0,0
2021-12-29 05:00,1,0,1,0,0,0
2021-12-29 05:15,2,2,0,0,0,0
2021-12-29 05:30,6,1,5,0,0,0
2021-12-29 05:45,8,3,5,0,0,0
2021-12-29 06:00,4,3,1,0,0,0
2021-12-29 06:15,10,7,3,0,0,0
2021-12-29 06:30,15,9,6,0,0,0
2021-12-29 06:45,30,10,20,0,0,0
2021-12-29 07:00,24,4,20,0,0,0
2021-12-29 07:15,14,3,11,0,0,0
2021-12-29 07:30,34,15,19,0,0,0
2021-12-29 07:45,39,17,22,0,0,0
2021-12-29 08:00,33,15,18,0,0,0
2021-12-29 08:15,31,18,13,0,0,0
2021-12-29 08:30,34,21,13,0,0,0
2021-12-29 08:45,44,25,19,0,0,0
2021-12-29 09:00,31,27,4,0,0,0
2021-12-29 09:15,39,25,14,0,0,0
2021-12-29 09:30,37,18,19,0,0,0
2021-12-29 09:45,48,34,14,0,0,0
2021-12-29 10:00,35,15,20,0,0,0
2021-12-29 10:15,29,18,11,0,0,0
2021-12-29 10:30,45,23,22,0,0,0
2021-12-29 10:45,42,25,17,0,0,0
2021-12-29 11:00,46,28,18,0,0,0
2021-12-29 11:15,43,23,20,0,0,0
2021-12-29 11:30,43,22,21,0,0,0
2021-12-29 11:45,43,25,18,0,0,0
2021-12-29 12:00,52,36,16,0,0,0
2021-12-29 12:15,68,28,40,0,0,0
2021-12-29 12:30,55,24,31,0,0,0
2021-12-29 12:45,50,21,29,0,0,0
2021-12-29 13:00,65,38,27,0,0,0
2021-12-29 13:15,51,24,27,0,0,0
2021-12-29 13:30,41,22,19,0,0,0
2021-12-29 13:45,47,30,17,0,0,0
2021-12-29 14:00,61,31,30,0,0,0
2021-12-29 14:15,65,31,34,0,0,0
2021-12-29 14:30,49,22,27,0,0,0
2021-12-29 14:45,56,38,18,0,0,0
2021-12-29 15:00,50,25,25,0,0,0
2021-12-29 15:15,67,33,34,0,0,0
2021-12-29 15:30,56,27,29,0,0,0
2021-12-29 15:45,58,28,30,0,0,0
2021-12-29 16:00,56,25,31,0,0,0
2021-12-29 16:15,53,25,28,0,0,0
2021-12-29 16:30,43,14,29,0,0,0
2021-12-29 16:45,51,29,22,0,0,0
2021-12-29 17:00,30,9,21,0,0,0
2021-12-29 17:15,32,15,17,0,0,0
2021-12-29 17:30,37,14,23,0,0,0
2021-12-29 17:45,34,13,21,0,0,0
2021-12-29 18:00,29,8,21,0,0,0
2021-12-29 18:15,25,10,15,0,0,0
2021-12-29 18:30,30,10,20,0,0,0
2021-12-29 18:45,25,8,17,0,0,0
2021-12-29 19:00,31,9,22,0,0,0
2021-12-29 19:15,25,9,16,0,0,0
2021-12-29 19:30,29,13,16,0,0,0
2021-12-29 19:45,11,2,9,0,0,0
2021-12-29 20:00,24,15,9,0,0,0
2021-12-29 20:15,10,5,5,0,0,0
2021-12-29 20:30,16,7,9,0,0,0
2021-12-29 20:45,7,3,4,0,0,0
2021-12-29 21:00,22,13,9,0,0,0
2021-12-29 21:15,9,7,2,0,0,0
2021-12-29 21:30,9,5,4,0,0,0
2021-12-29 21:45,11,3,8,0,0,0
2021-12-29 22:00,5,1,4,0,0,0
2021-12-29 22:15,8,1,7,0,0,0
2021-12-29 22:30,10,6,4,0,0,0
2021-12-29 22:45,12,1,11,0,0,0
2021-12-29 23:00,5,3,2,0,0,0
2021-12-29 23:15,6,0,6,0,0,0
2021-12-29 23:30,3,0,3,0,0,0
2021-12-29 23:45,2,2,0,0,0,0
2021-12-30 00:00,7,1,6,0,0,0
2021-12-30 00:15,1,0,1,0,0,0
2021-12-30 00:30,1,1,0,0,0,0
2021-12-30 00:45,1,0,1,0,0,0
2021-12-30 01:00,4,4,0,0,0,0
2021-12-30 01:15,3,2,1,0,0,0
2021-12-30 01:30,3,3,0,0,0,0
2021-12-30 01:45,2,1,1,0,0,0
2021-12-30 02:00,3,0,3,0,0,0
2021-12-30 02:15,1,1,0,0,0,0
2021-12-30 02:30,3,2,1,0,0,0
2021-12-30 02:45,2,0,2,0,0,0
2021-12-30 03:00,0,0,0,0,0,0
2021-12-30 03:15,0,0,0,0,0,0
2021-12-30 03:30,0,0,0,0,0,0
2021-12-30 03:45,0,0,0,0,0,0
2021-12-30 04:00,2,0,2,0,0,0
2021-12-30 04:15,0,0,0,0,0,0
2021-12-30 04:30,1,0,1,0,0,0
2021-12-30 04:45,1,1,0,0,0,0
2021-12-30 05:00,0,0,0,0,0,0
2021-12-30 05:15,0,0,0,0,0,0
2021-12-30 05:30,2,0,2,0,0,0
2021-12-30 05:45,6,1,5,0,0,0
2021-12-30 06:00,0,0,0,0,0,0
2021-12-30 06:15,10,6,4,0,0,0
2021-12-30 06:30,10,3,7,0,0,0
2021-12-30 06:45,23,3,20,0,0,0
2021-12-30 07:00,21,4,17,0,0,0
2021-12-30 07:15,12,3,9,0,0,0
2021-12-30 07:30,30,16,14,0,0,0
2021-12-30 07:45,34,16,18,0,0,0
2021-12-30 08:00,26,15,11,0,0,0
2021-12-30 08:15,18,10,8,0,0,0
2021-12-30 08:30,16,10,6,0,0,0
2021-12-30 08:45,22,16,6,0,0,0
2021-12-30 09:00,27,18,9,0,0,0
2021-12-30 09:15,21,15,6,0,0,0
2021-12-30 09:30,20,12,8,0,0,0
2021-12-30 09:45,26,16,10,0,0,0
2021-12-30 10:00,21,10,11,0,0,0
2021-12-30 10:15,30,20,10,0,0,0
2021-12-30 10:30,29,10,19,0,0,0
2021-12-30 10:45,29,18,11,0,0,0
2021-12-30 11:00,19,10,9,0,0,0
2021-12-30 11:15,23,16,7,0,0,0
2021-12-30 11:30,34,18,16,0,0,0
2021-12-30 11:45,33,15,18,0,0,0
2021-12-30 12:00,46,31,15,0,0,0
2021-12-30 12:15,36,15,21,0,0,0
2021-12-30 12:30,42,18,24,0,0,0
2021-12-30 12:45,39,24,15,0,0,0
2021-12-30 13:00,38,22,16,0,0,0
2021-12-30 13:15,62,34,28,0,0,0
2021-12-30 13:30,41,21,20,0,0,0
2021-12-30 13:45,47,23,24,0,0,0
2021-12-30 14:00,34,19,15,0,0,0
2021-12-30 14:15,56,27,29,0,0,0
2021-12-30 14:30,39,22,17,0,0,0
2021-12-30 14:45,69,37,32,0,0,0
2021-12-30 15:00,71,35,36,0,0,0
2021-12-30 15:15,57,29,28,0,0,0
2021-12-30 15:30,49,30,19,0,0,0
2021-12-30 15:45,54,27,27,0,0,0
2021-12-30 16:00,60,28,32,0,0,0
2021-12-30 16:15,40,17,23,0,0,0
2021-12-30 16:30,51,30,21,0,0,0
2021-12-30 16:45,58,24,34,0,0,0
2021-12-30 17:00,50,18,32,0,0,0
2021-12-30 17:15,36,16,20,0,0,0
2021-12-30 17:30,40,25,15,0,0,0
2021-12-30 17:45,57,21,36,0,0,0
2021-12-30 18:00,23,8,15,0,0,0
2021-12-30 18:15,30,9,21,0,0,0
2021-12-30 18:30,26,8,18,0,0,0
2021-12-30 18:45,32,13,19,0,0,0
2021-12-30 19:00,30,11,19,0,0,0
2021-12-30 19:15,33,15,18,0,0,0
2021-12-30 19:30,33,4,29,0,0,0
2021-12-30 19:45,16,10,6,0,0,0
2021-12-30 20:00,30,14,16,0,0,0
2021-12-30 20:15,16,2,14,0,0,0
2021-12-30 20:30,8,2,6,0,0,0
2021-12-30 20:45,15,10,5,0,0,0
2021-12-30 21:00,14,8,6,0,0,0
2021-12-30 21:15,11,7,4,0,0,0
2021-12-30 21:30,8,6,2,0,0,0
2021-12-30 21:45,7,2,5,0,0,0
2021-12-30 22:00,9,4,5,0,0,0
2021-12-30 22:15,4,1,3,0,0,0
2021-12-30 22:30,8,1,7,0,0,0
2021-12-30 22:45,18,3,15,0,0,0
2021-12-30 23:00,3,1,2,0,0,0
2021-12-30 23:15,10,5,5,0,0,0
2021-12-30 23:30,6,1,5,0,0,0
2021-12-30 23:45,3,0,3,0,0,0
