Datetime,100034982 (Hüfferstraße),101034982 (Hüfferstraße stadteinwärts),102034982 (Hüfferstraße stadtauswärts),100034982-status,101034982-status,102034982-status
2021-11-01 00:00,15,2,13,0,0,0
2021-11-01 00:15,12,2,10,0,0,0
2021-11-01 00:30,7,2,5,0,0,0
2021-11-01 00:45,12,4,8,0,0,0
2021-11-01 01:00,21,12,9,0,0,0
2021-11-01 01:15,13,3,10,0,0,0
2021-11-01 01:30,18,13,5,0,0,0
2021-11-01 01:45,13,7,6,0,0,0
2021-11-01 02:00,1,0,1,0,0,0
2021-11-01 02:15,15,4,11,0,0,0
2021-11-01 02:30,11,5,6,0,0,0
2021-11-01 02:45,11,1,10,0,0,0
2021-11-01 03:00,8,4,4,0,0,0
2021-11-01 03:15,13,2,11,0,0,0
2021-11-01 03:30,16,6,10,0,0,0
2021-11-01 03:45,8,5,3,0,0,0
2021-11-01 04:00,2,0,2,0,0,0
2021-11-01 04:15,2,0,2,0,0,0
2021-11-01 04:30,2,0,2,0,0,0
2021-11-01 04:45,2,0,2,0,0,0
2021-11-01 05:00,2,0,2,0,0,0
2021-11-01 05:15,2,0,2,0,0,0
2021-11-01 05:30,8,3,5,0,0,0
2021-11-01 05:45,4,2,2,0,0,0
2021-11-01 06:00,6,0,6,0,0,0
2021-11-01 06:15,2,0,2,0,0,0
2021-11-01 06:30,8,4,4,0,0,0
2021-11-01 06:45,3,3,0,0,0,0
2021-11-01 07:00,4,2,2,0,0,0
2021-11-01 07:15,6,5,1,0,0,0
2021-11-01 07:30,5,3,2,0,0,0
2021-11-01 07:45,11,8,3,0,0,0
2021-11-01 08:00,7,4,3,0,0,0
2021-11-01 08:15,6,4,2,0,0,0
2021-11-01 08:30,13,5,8,0,0,0
2021-11-01 08:45,9,6,3,0,0,0
2021-11-01 09:00,17,9,8,0,0,0
2021-11-01 09:15,9,3,6,0,0,0
2021-11-01 09:30,33,21,12,0,0,0
2021-11-01 09:45,27,17,10,0,0,0
2021-11-01 10:00,21,11,10,0,0,0
2021-11-01 10:15,17,9,8,0,0,0
2021-11-01 10:30,22,7,15,0,0,0
2021-11-01 10:45,19,12,7,0,0,0
2021-11-01 11:00,21,11,10,0,0,0
2021-11-01 11:15,26,10,16,0,0,0
2021-11-01 11:30,31,15,16,0,0,0
2021-11-01 11:45,38,16,22,0,0,0
2021-11-01 12:00,31,19,12,0,0,0
2021-11-01 12:15,40,17,23,0,0,0
2021-11-01 12:30,42,16,26,0,0,0
2021-11-01 12:45,41,27,14,0,0,0
2021-11-01 13:00,40,17,23,0,0,0
2021-11-01 13:15,43,18,25,0,0,0
2021-11-01 13:30,44,19,25,0,0,0
2021-11-01 13:45,69,33,36,0,0,0
2021-11-01 14:00,53,32,21,0,0,0
2021-11-01 14:15,49,32,17,0,0,0
2021-11-01 14:30,45,12,33,0,0,0
2021-11-01 14:45,76,34,42,0,0,0
2021-11-01 15:00,45,23,22,0,0,0
2021-11-01 15:15,51,19,32,0,0,0
2021-11-01 15:30,45,16,29,0,0,0
2021-11-01 15:45,53,27,26,0,0,0
2021-11-01 16:00,52,15,37,0,0,0
2021-11-01 16:15,55,26,29,0,0,0
2021-11-01 16:30,43,19,24,0,0,0
2021-11-01 16:45,68,38,30,0,0,0
2021-11-01 17:00,63,30,33,0,0,0
2021-11-01 17:15,53,25,28,0,0,0
2021-11-01 17:30,43,18,25,0,0,0
2021-11-01 17:45,41,24,17,0,0,0
2021-11-01 18:00,39,15,24,0,0,0
2021-11-01 18:15,36,25,11,0,0,0
2021-11-01 18:30,19,7,12,0,0,0
2021-11-01 18:45,31,17,14,0,0,0
2021-11-01 19:00,26,10,16,0,0,0
2021-11-01 19:15,41,16,25,0,0,0
2021-11-01 19:30,28,18,10,0,0,0
2021-11-01 19:45,29,10,19,0,0,0
2021-11-01 20:00,37,9,28,0,0,0
2021-11-01 20:15,16,2,14,0,0,0
2021-11-01 20:30,21,12,9,0,0,0
2021-11-01 20:45,15,5,10,0,0,0
2021-11-01 21:00,15,3,12,0,0,0
2021-11-01 21:15,24,12,12,0,0,0
2021-11-01 21:30,18,7,11,0,0,0
2021-11-01 21:45,14,9,5,0,0,0
2021-11-01 22:00,8,3,5,0,0,0
2021-11-01 22:15,17,7,10,0,0,0
2021-11-01 22:30,16,4,12,0,0,0
2021-11-01 22:45,6,3,3,0,0,0
2021-11-01 23:00,6,1,5,0,0,0
2021-11-01 23:15,5,4,1,0,0,0
2021-11-01 23:30,0,0,0,0,0,0
2021-11-01 23:45,2,1,1,0,0,0
2021-11-02 00:00,2,1,1,0,0,0
2021-11-02 00:15,1,1,0,0,0,0
2021-11-02 00:30,4,1,3,0,0,0
2021-11-02 00:45,1,0,1,0,0,0
2021-11-02 01:00,0,0,0,0,0,0
2021-11-02 01:15,0,0,0,0,0,0
2021-11-02 01:30,0,0,0,0,0,0
2021-11-02 01:45,0,0,0,0,0,0
2021-11-02 02:00,0,0,0,0,0,0
2021-11-02 02:15,0,0,0,0,0,0
2021-11-02 02:30,0,0,0,0,0,0
2021-11-02 02:45,0,0,0,0,0,0
2021-11-02 03:00,0,0,0,0,0,0
2021-11-02 03:15,0,0,0,0,0,0
2021-11-02 03:30,0,0,0,0,0,0
2021-11-02 03:45,0,0,0,0,0,0
2021-11-02 04:00,0,0,0,0,0,0
2021-11-02 04:15,1,0,1,0,0,0
2021-11-02 04:30,1,1,0,0,0,0
2021-11-02 04:45,1,0,1,0,0,0
2021-11-02 05:00,0,0,0,0,0,0
2021-11-02 05:15,4,2,2,0,0,0
2021-11-02 05:30,6,1,5,0,0,0
2021-11-02 05:45,15,11,4,0,0,0
2021-11-02 06:00,10,3,7,0,0,0
2021-11-02 06:15,19,9,10,0,0,0
2021-11-02 06:30,25,15,10,0,0,0
2021-11-02 06:45,49,24,25,0,0,0
2021-11-02 07:00,66,20,46,0,0,0
2021-11-02 07:15,79,32,47,0,0,0
2021-11-02 07:30,164,87,77,0,0,0
2021-11-02 07:45,325,137,188,0,0,0
2021-11-02 08:00,346,212,134,0,0,0
2021-11-02 08:15,145,69,76,0,0,0
2021-11-02 08:30,139,44,95,0,0,0
2021-11-02 08:45,149,60,89,0,0,0
2021-11-02 09:00,95,40,55,0,0,0
2021-11-02 09:15,100,50,50,0,0,0
2021-11-02 09:30,86,43,43,0,0,0
2021-11-02 09:45,230,146,84,0,0,0
2021-11-02 10:00,199,92,107,0,0,0
2021-11-02 10:15,94,43,51,0,0,0
2021-11-02 10:30,66,30,36,0,0,0
2021-11-02 10:45,68,46,22,0,0,0
2021-11-02 11:00,78,39,39,0,0,0
2021-11-02 11:15,84,41,43,0,0,0
2021-11-02 11:30,94,42,52,0,0,0
2021-11-02 11:45,233,103,130,0,0,0
2021-11-02 12:00,184,96,88,0,0,0
2021-11-02 12:15,117,40,77,0,0,0
2021-11-02 12:30,80,36,44,0,0,0
2021-11-02 12:45,105,45,60,0,0,0
2021-11-02 13:00,154,67,87,0,0,0
2021-11-02 13:15,124,57,67,0,0,0
2021-11-02 13:30,158,51,107,0,0,0
2021-11-02 13:45,269,109,160,0,0,0
2021-11-02 14:00,184,101,83,0,0,0
2021-11-02 14:15,114,50,64,0,0,0
2021-11-02 14:30,128,48,80,0,0,0
2021-11-02 14:45,118,57,61,0,0,0
2021-11-02 15:00,115,57,58,0,0,0
2021-11-02 15:15,144,81,63,0,0,0
2021-11-02 15:30,158,82,76,0,0,0
2021-11-02 15:45,266,135,131,0,0,0
2021-11-02 16:00,268,121,147,0,0,0
2021-11-02 16:15,178,103,75,0,0,0
2021-11-02 16:30,140,69,71,0,0,0
2021-11-02 16:45,144,71,73,0,0,0
2021-11-02 17:00,149,83,66,0,0,0
2021-11-02 17:15,161,93,68,0,0,0
2021-11-02 17:30,150,74,76,0,0,0
2021-11-02 17:45,244,135,109,0,0,0
2021-11-02 18:00,159,81,78,0,0,0
2021-11-02 18:15,122,40,82,0,0,0
2021-11-02 18:30,72,26,46,0,0,0
2021-11-02 18:45,98,43,55,0,0,0
2021-11-02 19:00,79,35,44,0,0,0
2021-11-02 19:15,77,35,42,0,0,0
2021-11-02 19:30,67,32,35,0,0,0
2021-11-02 19:45,89,41,48,0,0,0
2021-11-02 20:00,67,29,38,0,0,0
2021-11-02 20:15,42,22,20,0,0,0
2021-11-02 20:30,38,15,23,0,0,0
2021-11-02 20:45,35,15,20,0,0,0
2021-11-02 21:00,20,8,12,0,0,0
2021-11-02 21:15,36,15,21,0,0,0
2021-11-02 21:30,17,6,11,0,0,0
2021-11-02 21:45,29,9,20,0,0,0
2021-11-02 22:00,19,8,11,0,0,0
2021-11-02 22:15,28,13,15,0,0,0
2021-11-02 22:30,22,6,16,0,0,0
2021-11-02 22:45,16,5,11,0,0,0
2021-11-02 23:00,20,5,15,0,0,0
2021-11-02 23:15,14,7,7,0,0,0
2021-11-02 23:30,9,1,8,0,0,0
2021-11-02 23:45,2,1,1,0,0,0
2021-11-03 00:00,7,0,7,0,0,0
2021-11-03 00:15,1,0,1,0,0,0
2021-11-03 00:30,2,0,2,0,0,0
2021-11-03 00:45,1,0,1,0,0,0
2021-11-03 01:00,4,0,4,0,0,0
2021-11-03 01:15,3,1,2,0,0,0
2021-11-03 01:30,2,0,2,0,0,0
2021-11-03 01:45,3,1,2,0,0,0
2021-11-03 02:00,0,0,0,0,0,0
2021-11-03 02:15,0,0,0,0,0,0
2021-11-03 02:30,1,0,1,0,0,0
2021-11-03 02:45,2,2,0,0,0,0
2021-11-03 03:00,0,0,0,0,0,0
2021-11-03 03:15,1,0,1,0,0,0
2021-11-03 03:30,0,0,0,0,0,0
2021-11-03 03:45,0,0,0,0,0,0
2021-11-03 04:00,1,0,1,0,0,0
2021-11-03 04:15,0,0,0,0,0,0
2021-11-03 04:30,0,0,0,0,0,0
2021-11-03 04:45,1,1,0,0,0,0
2021-11-03 05:00,1,0,1,0,0,0
2021-11-03 05:15,0,0,0,0,0,0
2021-11-03 05:30,11,3,8,0,0,0
2021-11-03 05:45,9,5,4,0,0,0
2021-11-03 06:00,10,2,8,0,0,0
2021-11-03 06:15,24,12,12,0,0,0
2021-11-03 06:30,36,13,23,0,0,0
2021-11-03 06:45,49,28,21,0,0,0
2021-11-03 07:00,61,21,40,0,0,0
2021-11-03 07:15,83,36,47,0,0,0
2021-11-03 07:30,180,83,97,0,0,0
2021-11-03 07:45,348,156,192,0,0,0
2021-11-03 08:00,370,187,183,0,0,0
2021-11-03 08:15,199,94,105,0,0,0
2021-11-03 08:30,123,66,57,0,0,0
2021-11-03 08:45,160,67,93,0,0,0
2021-11-03 09:00,106,50,56,0,0,0
2021-11-03 09:15,92,47,45,0,0,0
2021-11-03 09:30,110,46,64,0,0,0
2021-11-03 09:45,240,115,125,0,0,0
2021-11-03 10:00,240,101,139,0,0,0
2021-11-03 10:15,100,53,47,0,0,0
2021-11-03 10:30,67,37,30,0,0,0
2021-11-03 10:45,83,35,48,0,0,0
2021-11-03 11:00,64,41,23,0,0,0
2021-11-03 11:15,95,48,47,0,0,0
2021-11-03 11:30,122,64,58,0,0,0
2021-11-03 11:45,256,123,133,0,0,0
2021-11-03 12:00,210,103,107,0,0,0
2021-11-03 12:15,137,58,79,0,0,0
2021-11-03 12:30,120,63,57,0,0,0
2021-11-03 12:45,128,64,64,0,0,0
2021-11-03 13:00,155,82,73,0,0,0
2021-11-03 13:15,117,58,59,0,0,0
2021-11-03 13:30,176,56,120,0,0,0
2021-11-03 13:45,226,100,126,0,0,0
2021-11-03 14:00,202,82,120,0,0,0
2021-11-03 14:15,125,61,64,0,0,0
2021-11-03 14:30,124,44,80,0,0,0
2021-11-03 14:45,114,61,53,0,0,0
2021-11-03 15:00,127,61,66,0,0,0
2021-11-03 15:15,109,47,62,0,0,0
2021-11-03 15:30,150,86,64,0,0,0
2021-11-03 15:45,206,110,96,0,0,0
2021-11-03 16:00,230,102,128,0,0,0
2021-11-03 16:15,115,61,54,0,0,0
2021-11-03 16:30,118,64,54,0,0,0
2021-11-03 16:45,136,67,69,0,0,0
2021-11-03 17:00,113,57,56,0,0,0
2021-11-03 17:15,151,93,58,0,0,0
2021-11-03 17:30,129,69,60,0,0,0
2021-11-03 17:45,216,130,86,0,0,0
2021-11-03 18:00,166,80,86,0,0,0
2021-11-03 18:15,105,53,52,0,0,0
2021-11-03 18:30,62,28,34,0,0,0
2021-11-03 18:45,70,36,34,0,0,0
2021-11-03 19:00,66,27,39,0,0,0
2021-11-03 19:15,60,33,27,0,0,0
2021-11-03 19:30,78,55,23,0,0,0
2021-11-03 19:45,76,40,36,0,0,0
2021-11-03 20:00,77,46,31,0,0,0
2021-11-03 20:15,54,27,27,0,0,0
2021-11-03 20:30,37,22,15,0,0,0
2021-11-03 20:45,46,24,22,0,0,0
2021-11-03 21:00,46,27,19,0,0,0
2021-11-03 21:15,25,14,11,0,0,0
2021-11-03 21:30,27,10,17,0,0,0
2021-11-03 21:45,24,7,17,0,0,0
2021-11-03 22:00,33,7,26,0,0,0
2021-11-03 22:15,34,20,14,0,0,0
2021-11-03 22:30,17,8,9,0,0,0
2021-11-03 22:45,25,12,13,0,0,0
2021-11-03 23:00,20,5,15,0,0,0
2021-11-03 23:15,18,2,16,0,0,0
2021-11-03 23:30,9,1,8,0,0,0
2021-11-03 23:45,16,4,12,0,0,0
2021-11-04 00:00,7,2,5,0,0,0
2021-11-04 00:15,7,2,5,0,0,0
2021-11-04 00:30,7,3,4,0,0,0
2021-11-04 00:45,3,1,2,0,0,0
2021-11-04 01:00,5,2,3,0,0,0
2021-11-04 01:15,5,1,4,0,0,0
2021-11-04 01:30,5,2,3,0,0,0
2021-11-04 01:45,4,1,3,0,0,0
2021-11-04 02:00,5,0,5,0,0,0
2021-11-04 02:15,0,0,0,0,0,0
2021-11-04 02:30,4,3,1,0,0,0
2021-11-04 02:45,2,0,2,0,0,0
2021-11-04 03:00,1,1,0,0,0,0
2021-11-04 03:15,2,1,1,0,0,0
2021-11-04 03:30,3,1,2,0,0,0
2021-11-04 03:45,4,2,2,0,0,0
2021-11-04 04:00,0,0,0,0,0,0
2021-11-04 04:15,1,0,1,0,0,0
2021-11-04 04:30,2,0,2,0,0,0
2021-11-04 04:45,2,1,1,0,0,0
2021-11-04 05:00,1,1,0,0,0,0
2021-11-04 05:15,1,0,1,0,0,0
2021-11-04 05:30,8,4,4,0,0,0
2021-11-04 05:45,10,4,6,0,0,0
2021-11-04 06:00,6,2,4,0,0,0
2021-11-04 06:15,10,3,7,0,0,0
2021-11-04 06:30,25,10,15,0,0,0
2021-11-04 06:45,55,29,26,0,0,0
2021-11-04 07:00,70,20,50,0,0,0
2021-11-04 07:15,76,30,46,0,0,0
2021-11-04 07:30,156,64,92,0,0,0
2021-11-04 07:45,291,147,144,0,0,0
2021-11-04 08:00,343,175,168,0,0,0
2021-11-04 08:15,179,74,105,0,0,0
2021-11-04 08:30,120,62,58,0,0,0
2021-11-04 08:45,170,71,99,0,0,0
2021-11-04 09:00,80,42,38,0,0,0
2021-11-04 09:15,54,27,27,0,0,0
2021-11-04 09:30,77,42,35,0,0,0
2021-11-04 09:45,208,114,94,0,0,0
2021-11-04 10:00,231,103,128,0,0,0
2021-11-04 10:15,48,22,26,0,0,0
2021-11-04 10:30,61,33,28,0,0,0
2021-11-04 10:45,64,33,31,0,0,0
2021-11-04 11:00,61,32,29,0,0,0
2021-11-04 11:15,77,35,42,0,0,0
2021-11-04 11:30,96,48,48,0,0,0
2021-11-04 11:45,201,81,120,0,0,0
2021-11-04 12:00,177,84,93,0,0,0
2021-11-04 12:15,83,40,43,0,0,0
2021-11-04 12:30,113,44,69,0,0,0
2021-11-04 12:45,117,43,74,0,0,0
2021-11-04 13:00,134,72,62,0,0,0
2021-11-04 13:15,112,45,67,0,0,0
2021-11-04 13:30,131,50,81,0,0,0
2021-11-04 13:45,249,115,134,0,0,0
2021-11-04 14:00,179,90,89,0,0,0
2021-11-04 14:15,99,37,62,0,0,0
2021-11-04 14:30,139,64,75,0,0,0
2021-11-04 14:45,125,77,48,0,0,0
2021-11-04 15:00,99,55,44,0,0,0
2021-11-04 15:15,125,69,56,0,0,0
2021-11-04 15:30,147,75,72,0,0,0
2021-11-04 15:45,246,128,118,0,0,0
2021-11-04 16:00,237,141,96,0,0,0
2021-11-04 16:15,147,78,69,0,0,0
2021-11-04 16:30,129,66,63,0,0,0
2021-11-04 16:45,168,91,77,0,0,0
2021-11-04 17:00,123,73,50,0,0,0
2021-11-04 17:15,173,88,85,0,0,0
2021-11-04 17:30,145,67,78,0,0,0
2021-11-04 17:45,162,89,73,0,0,0
2021-11-04 18:00,155,94,61,0,0,0
2021-11-04 18:15,93,44,49,0,0,0
2021-11-04 18:30,86,35,51,0,0,0
2021-11-04 18:45,99,48,51,0,0,0
2021-11-04 19:00,61,24,37,0,0,0
2021-11-04 19:15,67,37,30,0,0,0
2021-11-04 19:30,51,18,33,0,0,0
2021-11-04 19:45,78,33,45,0,0,0
2021-11-04 20:00,58,26,32,0,0,0
2021-11-04 20:15,53,24,29,0,0,0
2021-11-04 20:30,34,26,8,0,0,0
2021-11-04 20:45,28,16,12,0,0,0
2021-11-04 21:00,31,22,9,0,0,0
2021-11-04 21:15,33,12,21,0,0,0
2021-11-04 21:30,20,6,14,0,0,0
2021-11-04 21:45,29,3,26,0,0,0
2021-11-04 22:00,23,13,10,0,0,0
2021-11-04 22:15,23,11,12,0,0,0
2021-11-04 22:30,21,6,15,0,0,0
2021-11-04 22:45,18,1,17,0,0,0
2021-11-04 23:00,23,7,16,0,0,0
2021-11-04 23:15,15,2,13,0,0,0
2021-11-04 23:30,9,1,8,0,0,0
2021-11-04 23:45,9,4,5,0,0,0
2021-11-05 00:00,8,0,8,0,0,0
2021-11-05 00:15,2,1,1,0,0,0
2021-11-05 00:30,7,2,5,0,0,0
2021-11-05 00:45,1,1,0,0,0,0
2021-11-05 01:00,2,0,2,0,0,0
2021-11-05 01:15,3,1,2,0,0,0
2021-11-05 01:30,1,0,1,0,0,0
2021-11-05 01:45,9,1,8,0,0,0
2021-11-05 02:00,3,0,3,0,0,0
2021-11-05 02:15,4,1,3,0,0,0
2021-11-05 02:30,2,0,2,0,0,0
2021-11-05 02:45,0,0,0,0,0,0
2021-11-05 03:00,4,0,4,0,0,0
2021-11-05 03:15,3,0,3,0,0,0
2021-11-05 03:30,1,0,1,0,0,0
2021-11-05 03:45,2,0,2,0,0,0
2021-11-05 04:00,2,1,1,0,0,0
2021-11-05 04:15,0,0,0,0,0,0
2021-11-05 04:30,3,1,2,0,0,0
2021-11-05 04:45,2,1,1,0,0,0
2021-11-05 05:00,0,0,0,0,0,0
2021-11-05 05:15,1,0,1,0,0,0
2021-11-05 05:30,10,4,6,0,0,0
2021-11-05 05:45,8,3,5,0,0,0
2021-11-05 06:00,8,1,7,0,0,0
2021-11-05 06:15,18,6,12,0,0,0
2021-11-05 06:30,29,13,16,0,0,0
2021-11-05 06:45,36,13,23,0,0,0
2021-11-05 07:00,59,22,37,0,0,0
2021-11-05 07:15,60,30,30,0,0,0
2021-11-05 07:30,134,76,58,0,0,0
2021-11-05 07:45,245,111,134,0,0,0
2021-11-05 08:00,315,152,163,0,0,0
2021-11-05 08:15,130,46,84,0,0,0
2021-11-05 08:30,115,63,52,0,0,0
2021-11-05 08:45,148,75,73,0,0,0
2021-11-05 09:00,101,48,53,0,0,0
2021-11-05 09:15,78,40,38,0,0,0
2021-11-05 09:30,111,48,63,0,0,0
2021-11-05 09:45,197,125,72,0,0,0
2021-11-05 10:00,154,76,78,0,0,0
2021-11-05 10:15,66,35,31,0,0,0
2021-11-05 10:30,58,33,25,0,0,0
2021-11-05 10:45,67,35,32,0,0,0
2021-11-05 11:00,88,54,34,0,0,0
2021-11-05 11:15,88,44,44,0,0,0
2021-11-05 11:30,94,64,30,0,0,0
2021-11-05 11:45,151,76,75,0,0,0
2021-11-05 12:00,139,83,56,0,0,0
2021-11-05 12:15,107,59,48,0,0,0
2021-11-05 12:30,96,49,47,0,0,0
2021-11-05 12:45,123,63,60,0,0,0
2021-11-05 13:00,135,56,79,0,0,0
2021-11-05 13:15,93,29,64,0,0,0
2021-11-05 13:30,177,70,107,0,0,0
2021-11-05 13:45,144,59,85,0,0,0
2021-11-05 14:00,145,81,64,0,0,0
2021-11-05 14:15,112,59,53,0,0,0
2021-11-05 14:30,153,63,90,0,0,0
2021-11-05 14:45,140,77,63,0,0,0
2021-11-05 15:00,119,66,53,0,0,0
2021-11-05 15:15,138,78,60,0,0,0
2021-11-05 15:30,135,66,69,0,0,0
2021-11-05 15:45,150,87,63,0,0,0
2021-11-05 16:00,132,82,50,0,0,0
2021-11-05 16:15,114,68,46,0,0,0
2021-11-05 16:30,136,68,68,0,0,0
2021-11-05 16:45,144,77,67,0,0,0
2021-11-05 17:00,108,62,46,0,0,0
2021-11-05 17:15,117,67,50,0,0,0
2021-11-05 17:30,81,37,44,0,0,0
2021-11-05 17:45,107,66,41,0,0,0
2021-11-05 18:00,78,35,43,0,0,0
2021-11-05 18:15,54,20,34,0,0,0
2021-11-05 18:30,74,37,37,0,0,0
2021-11-05 18:45,86,43,43,0,0,0
2021-11-05 19:00,48,20,28,0,0,0
2021-11-05 19:15,53,23,30,0,0,0
2021-11-05 19:30,50,21,29,0,0,0
2021-11-05 19:45,58,21,37,0,0,0
2021-11-05 20:00,41,25,16,0,0,0
2021-11-05 20:15,42,27,15,0,0,0
2021-11-05 20:30,35,12,23,0,0,0
2021-11-05 20:45,32,12,20,0,0,0
2021-11-05 21:00,39,22,17,0,0,0
2021-11-05 21:15,34,18,16,0,0,0
2021-11-05 21:30,19,4,15,0,0,0
2021-11-05 21:45,43,8,35,0,0,0
2021-11-05 22:00,18,5,13,0,0,0
2021-11-05 22:15,28,11,17,0,0,0
2021-11-05 22:30,20,6,14,0,0,0
2021-11-05 22:45,21,6,15,0,0,0
2021-11-05 23:00,16,2,14,0,0,0
2021-11-05 23:15,17,4,13,0,0,0
2021-11-05 23:30,9,3,6,0,0,0
2021-11-05 23:45,15,3,12,0,0,0
2021-11-06 00:00,14,3,11,0,0,0
2021-11-06 00:15,21,7,14,0,0,0
2021-11-06 00:30,13,4,9,0,0,0
2021-11-06 00:45,17,2,15,0,0,0
2021-11-06 01:00,9,3,6,0,0,0
2021-11-06 01:15,14,5,9,0,0,0
2021-11-06 01:30,8,4,4,0,0,0
2021-11-06 01:45,8,3,5,0,0,0
2021-11-06 02:00,7,0,7,0,0,0
2021-11-06 02:15,4,3,1,0,0,0
2021-11-06 02:30,5,0,5,0,0,0
2021-11-06 02:45,6,1,5,0,0,0
2021-11-06 03:00,4,2,2,0,0,0
2021-11-06 03:15,7,2,5,0,0,0
2021-11-06 03:30,4,0,4,0,0,0
2021-11-06 03:45,4,0,4,0,0,0
2021-11-06 04:00,4,0,4,0,0,0
2021-11-06 04:15,3,2,1,0,0,0
2021-11-06 04:30,0,0,0,0,0,0
2021-11-06 04:45,5,2,3,0,0,0
2021-11-06 05:00,1,1,0,0,0,0
2021-11-06 05:15,1,1,0,0,0,0
2021-11-06 05:30,6,1,5,0,0,0
2021-11-06 05:45,4,3,1,0,0,0
2021-11-06 06:00,2,0,2,0,0,0
2021-11-06 06:15,4,3,1,0,0,0
2021-11-06 06:30,5,5,0,0,0,0
2021-11-06 06:45,4,3,1,0,0,0
2021-11-06 07:00,14,8,6,0,0,0
2021-11-06 07:15,5,3,2,0,0,0
2021-11-06 07:30,12,10,2,0,0,0
2021-11-06 07:45,16,12,4,0,0,0
2021-11-06 08:00,12,9,3,0,0,0
2021-11-06 08:15,21,10,11,0,0,0
2021-11-06 08:30,36,28,8,0,0,0
2021-11-06 08:45,48,28,20,0,0,0
2021-11-06 09:00,38,26,12,0,0,0
2021-11-06 09:15,42,26,16,0,0,0
2021-11-06 09:30,37,22,15,0,0,0
2021-11-06 09:45,82,64,18,0,0,0
2021-11-06 10:00,49,32,17,0,0,0
2021-11-06 10:15,64,42,22,0,0,0
2021-11-06 10:30,62,44,18,0,0,0
2021-11-06 10:45,74,50,24,0,0,0
2021-11-06 11:00,79,47,32,0,0,0
2021-11-06 11:15,72,47,25,0,0,0
2021-11-06 11:30,75,48,27,0,0,0
2021-11-06 11:45,98,55,43,0,0,0
2021-11-06 12:00,83,50,33,0,0,0
2021-11-06 12:15,70,48,22,0,0,0
2021-11-06 12:30,86,44,42,0,0,0
2021-11-06 12:45,84,47,37,0,0,0
2021-11-06 13:00,78,35,43,0,0,0
2021-11-06 13:15,79,39,40,0,0,0
2021-11-06 13:30,86,45,41,0,0,0
2021-11-06 13:45,97,42,55,0,0,0
2021-11-06 14:00,75,41,34,0,0,0
2021-11-06 14:15,87,37,50,0,0,0
2021-11-06 14:30,87,45,42,0,0,0
2021-11-06 14:45,86,29,57,0,0,0
2021-11-06 15:00,76,26,50,0,0,0
2021-11-06 15:15,72,23,49,0,0,0
2021-11-06 15:30,77,36,41,0,0,0
2021-11-06 15:45,60,31,29,0,0,0
2021-11-06 16:00,55,17,38,0,0,0
2021-11-06 16:15,73,31,42,0,0,0
2021-11-06 16:30,53,18,35,0,0,0
2021-11-06 16:45,62,21,41,0,0,0
2021-11-06 17:00,61,21,40,0,0,0
2021-11-06 17:15,48,19,29,0,0,0
2021-11-06 17:30,51,12,39,0,0,0
2021-11-06 17:45,46,12,34,0,0,0
2021-11-06 18:00,62,24,38,0,0,0
2021-11-06 18:15,40,18,22,0,0,0
2021-11-06 18:30,47,15,32,0,0,0
2021-11-06 18:45,54,32,22,0,0,0
2021-11-06 19:00,40,23,17,0,0,0
2021-11-06 19:15,40,20,20,0,0,0
2021-11-06 19:30,35,20,15,0,0,0
2021-11-06 19:45,44,26,18,0,0,0
2021-11-06 20:00,40,11,29,0,0,0
2021-11-06 20:15,28,12,16,0,0,0
2021-11-06 20:30,27,19,8,0,0,0
2021-11-06 20:45,24,10,14,0,0,0
2021-11-06 21:00,20,8,12,0,0,0
2021-11-06 21:15,21,9,12,0,0,0
2021-11-06 21:30,14,7,7,0,0,0
2021-11-06 21:45,16,10,6,0,0,0
2021-11-06 22:00,24,8,16,0,0,0
2021-11-06 22:15,28,13,15,0,0,0
2021-11-06 22:30,9,4,5,0,0,0
2021-11-06 22:45,24,8,16,0,0,0
2021-11-06 23:00,12,2,10,0,0,0
2021-11-06 23:15,21,9,12,0,0,0
2021-11-06 23:30,15,3,12,0,0,0
2021-11-06 23:45,23,3,20,0,0,0
2021-11-07 00:00,19,2,17,0,0,0
2021-11-07 00:15,12,2,10,0,0,0
2021-11-07 00:30,8,3,5,0,0,0
2021-11-07 00:45,10,1,9,0,0,0
2021-11-07 01:00,9,1,8,0,0,0
2021-11-07 01:15,11,2,9,0,0,0
2021-11-07 01:30,12,3,9,0,0,0
2021-11-07 01:45,8,0,8,0,0,0
2021-11-07 02:00,8,1,7,0,0,0
2021-11-07 02:15,6,2,4,0,0,0
2021-11-07 02:30,7,0,7,0,0,0
2021-11-07 02:45,2,0,2,0,0,0
2021-11-07 03:00,7,0,7,0,0,0
2021-11-07 03:15,2,0,2,0,0,0
2021-11-07 03:30,4,2,2,0,0,0
2021-11-07 03:45,5,0,5,0,0,0
2021-11-07 04:00,2,0,2,0,0,0
2021-11-07 04:15,3,1,2,0,0,0
2021-11-07 04:30,4,0,4,0,0,0
2021-11-07 04:45,5,1,4,0,0,0
2021-11-07 05:00,1,0,1,0,0,0
2021-11-07 05:15,1,0,1,0,0,0
2021-11-07 05:30,5,2,3,0,0,0
2021-11-07 05:45,4,3,1,0,0,0
2021-11-07 06:00,3,1,2,0,0,0
2021-11-07 06:15,3,0,3,0,0,0
2021-11-07 06:30,6,2,4,0,0,0
2021-11-07 06:45,1,1,0,0,0,0
2021-11-07 07:00,1,1,0,0,0,0
2021-11-07 07:15,2,1,1,0,0,0
2021-11-07 07:30,1,0,1,0,0,0
2021-11-07 07:45,7,5,2,0,0,0
2021-11-07 08:00,8,5,3,0,0,0
2021-11-07 08:15,12,12,0,0,0,0
2021-11-07 08:30,8,6,2,0,0,0
2021-11-07 08:45,11,6,5,0,0,0
2021-11-07 09:00,14,7,7,0,0,0
2021-11-07 09:15,7,4,3,0,0,0
2021-11-07 09:30,27,15,12,0,0,0
2021-11-07 09:45,23,16,7,0,0,0
2021-11-07 10:00,10,5,5,0,0,0
2021-11-07 10:15,22,13,9,0,0,0
2021-11-07 10:30,15,11,4,0,0,0
2021-11-07 10:45,32,21,11,0,0,0
2021-11-07 11:00,11,8,3,0,0,0
2021-11-07 11:15,34,17,17,0,0,0
2021-11-07 11:30,26,10,16,0,0,0
2021-11-07 11:45,36,18,18,0,0,0
2021-11-07 12:00,21,11,10,0,0,0
2021-11-07 12:15,32,10,22,0,0,0
2021-11-07 12:30,37,16,21,0,0,0
2021-11-07 12:45,27,11,16,0,0,0
2021-11-07 13:00,44,16,28,0,0,0
2021-11-07 13:15,18,13,5,0,0,0
2021-11-07 13:30,45,19,26,0,0,0
2021-11-07 13:45,39,18,21,0,0,0
2021-11-07 14:00,34,9,25,0,0,0
2021-11-07 14:15,30,15,15,0,0,0
2021-11-07 14:30,25,10,15,0,0,0
2021-11-07 14:45,45,23,22,0,0,0
2021-11-07 15:00,22,7,15,0,0,0
2021-11-07 15:15,36,14,22,0,0,0
2021-11-07 15:30,28,15,13,0,0,0
2021-11-07 15:45,28,12,16,0,0,0
2021-11-07 16:00,27,9,18,0,0,0
2021-11-07 16:15,17,5,12,0,0,0
2021-11-07 16:30,30,15,15,0,0,0
2021-11-07 16:45,38,15,23,0,0,0
2021-11-07 17:00,39,17,22,0,0,0
2021-11-07 17:15,16,3,13,0,0,0
2021-11-07 17:30,21,8,13,0,0,0
2021-11-07 17:45,40,20,20,0,0,0
2021-11-07 18:00,30,14,16,0,0,0
2021-11-07 18:15,30,17,13,0,0,0
2021-11-07 18:30,19,1,18,0,0,0
2021-11-07 18:45,26,15,11,0,0,0
2021-11-07 19:00,24,12,12,0,0,0
2021-11-07 19:15,25,14,11,0,0,0
2021-11-07 19:30,31,6,25,0,0,0
2021-11-07 19:45,32,15,17,0,0,0
2021-11-07 20:00,27,7,20,0,0,0
2021-11-07 20:15,15,3,12,0,0,0
2021-11-07 20:30,9,3,6,0,0,0
2021-11-07 20:45,11,3,8,0,0,0
2021-11-07 21:00,16,7,9,0,0,0
2021-11-07 21:15,18,5,13,0,0,0
2021-11-07 21:30,15,3,12,0,0,0
2021-11-07 21:45,15,4,11,0,0,0
2021-11-07 22:00,10,2,8,0,0,0
2021-11-07 22:15,6,2,4,0,0,0
2021-11-07 22:30,13,2,11,0,0,0
2021-11-07 22:45,9,4,5,0,0,0
2021-11-07 23:00,16,3,13,0,0,0
2021-11-07 23:15,2,0,2,0,0,0
2021-11-07 23:30,2,1,1,0,0,0
2021-11-07 23:45,0,0,0,0,0,0
2021-11-08 00:00,5,4,1,0,0,0
2021-11-08 00:15,3,0,3,0,0,0
2021-11-08 00:30,1,0,1,0,0,0
2021-11-08 00:45,10,7,3,0,0,0
2021-11-08 01:00,5,2,3,0,0,0
2021-11-08 01:15,0,0,0,0,0,0
2021-11-08 01:30,1,0,1,0,0,0
2021-11-08 01:45,1,1,0,0,0,0
2021-11-08 02:00,0,0,0,0,0,0
2021-11-08 02:15,1,1,0,0,0,0
2021-11-08 02:30,0,0,0,0,0,0
2021-11-08 02:45,0,0,0,0,0,0
2021-11-08 03:00,0,0,0,0,0,0
2021-11-08 03:15,1,1,0,0,0,0
2021-11-08 03:30,1,1,0,0,0,0
2021-11-08 03:45,0,0,0,0,0,0
2021-11-08 04:00,1,0,1,0,0,0
2021-11-08 04:15,1,0,1,0,0,0
2021-11-08 04:30,0,0,0,0,0,0
2021-11-08 04:45,1,0,1,0,0,0
2021-11-08 05:00,1,0,1,0,0,0
2021-11-08 05:15,0,0,0,0,0,0
2021-11-08 05:30,6,6,0,0,0,0
2021-11-08 05:45,7,1,6,0,0,0
2021-11-08 06:00,4,2,2,0,0,0
2021-11-08 06:15,20,6,14,0,0,0
2021-11-08 06:30,32,13,19,0,0,0
2021-11-08 06:45,52,17,35,0,0,0
2021-11-08 07:00,57,18,39,0,0,0
2021-11-08 07:15,92,40,52,0,0,0
2021-11-08 07:30,122,49,73,0,0,0
2021-11-08 07:45,299,147,152,0,0,0
2021-11-08 08:00,349,184,165,0,0,0
2021-11-08 08:15,147,63,84,0,0,0
2021-11-08 08:30,85,42,43,0,0,0
2021-11-08 08:45,156,76,80,0,0,0
2021-11-08 09:00,108,45,63,0,0,0
2021-11-08 09:15,67,37,30,0,0,0
2021-11-08 09:30,82,41,41,0,0,0
2021-11-08 09:45,205,98,107,0,0,0
2021-11-08 10:00,246,101,145,0,0,0
2021-11-08 10:15,68,32,36,0,0,0
2021-11-08 10:30,81,47,34,0,0,0
2021-11-08 10:45,53,26,27,0,0,0
2021-11-08 11:00,79,30,49,0,0,0
2021-11-08 11:15,56,22,34,0,0,0
2021-11-08 11:30,74,29,45,0,0,0
2021-11-08 11:45,239,100,139,0,0,0
2021-11-08 12:00,167,77,90,0,0,0
2021-11-08 12:15,81,43,38,0,0,0
2021-11-08 12:30,91,37,54,0,0,0
2021-11-08 12:45,134,32,102,0,0,0
2021-11-08 13:00,117,61,56,0,0,0
2021-11-08 13:15,93,34,59,0,0,0
2021-11-08 13:30,176,63,113,0,0,0
2021-11-08 13:45,233,99,134,0,0,0
2021-11-08 14:00,168,80,88,0,0,0
2021-11-08 14:15,107,56,51,0,0,0
2021-11-08 14:30,124,51,73,0,0,0
2021-11-08 14:45,116,50,66,0,0,0
2021-11-08 15:00,91,45,46,0,0,0
2021-11-08 15:15,111,49,62,0,0,0
2021-11-08 15:30,160,94,66,0,0,0
2021-11-08 15:45,284,158,126,0,0,0
2021-11-08 16:00,254,148,106,0,0,0
2021-11-08 16:15,164,99,65,0,0,0
2021-11-08 16:30,153,88,65,0,0,0
2021-11-08 16:45,143,83,60,0,0,0
2021-11-08 17:00,158,91,67,0,0,0
2021-11-08 17:15,145,91,54,0,0,0
2021-11-08 17:30,136,88,48,0,0,0
2021-11-08 17:45,218,104,114,0,0,0
2021-11-08 18:00,176,91,85,0,0,0
2021-11-08 18:15,125,65,60,0,0,0
2021-11-08 18:30,79,35,44,0,0,0
2021-11-08 18:45,83,37,46,0,0,0
2021-11-08 19:00,69,41,28,0,0,0
2021-11-08 19:15,63,28,35,0,0,0
2021-11-08 19:30,66,30,36,0,0,0
2021-11-08 19:45,95,39,56,0,0,0
2021-11-08 20:00,45,15,30,0,0,0
2021-11-08 20:15,56,24,32,0,0,0
2021-11-08 20:30,28,11,17,0,0,0
2021-11-08 20:45,19,7,12,0,0,0
2021-11-08 21:00,37,12,25,0,0,0
2021-11-08 21:15,30,10,20,0,0,0
2021-11-08 21:30,19,7,12,0,0,0
2021-11-08 21:45,20,4,16,0,0,0
2021-11-08 22:00,22,12,10,0,0,0
2021-11-08 22:15,30,7,23,0,0,0
2021-11-08 22:30,14,6,8,0,0,0
2021-11-08 22:45,22,6,16,0,0,0
2021-11-08 23:00,12,5,7,0,0,0
2021-11-08 23:15,9,5,4,0,0,0
2021-11-08 23:30,11,2,9,0,0,0
2021-11-08 23:45,16,6,10,0,0,0
2021-11-09 00:00,5,2,3,0,0,0
2021-11-09 00:15,4,2,2,0,0,0
2021-11-09 00:30,2,0,2,0,0,0
2021-11-09 00:45,1,0,1,0,0,0
2021-11-09 01:00,1,0,1,0,0,0
2021-11-09 01:15,1,1,0,0,0,0
2021-11-09 01:30,1,1,0,0,0,0
2021-11-09 01:45,1,1,0,0,0,0
2021-11-09 02:00,5,0,5,0,0,0
2021-11-09 02:15,1,0,1,0,0,0
2021-11-09 02:30,1,1,0,0,0,0
2021-11-09 02:45,0,0,0,0,0,0
2021-11-09 03:00,0,0,0,0,0,0
2021-11-09 03:15,0,0,0,0,0,0
2021-11-09 03:30,0,0,0,0,0,0
2021-11-09 03:45,1,1,0,0,0,0
2021-11-09 04:00,0,0,0,0,0,0
2021-11-09 04:15,1,0,1,0,0,0
2021-11-09 04:30,0,0,0,0,0,0
2021-11-09 04:45,3,3,0,0,0,0
2021-11-09 05:00,1,0,1,0,0,0
2021-11-09 05:15,0,0,0,0,0,0
2021-11-09 05:30,10,2,8,0,0,0
2021-11-09 05:45,11,4,7,0,0,0
2021-11-09 06:00,8,5,3,0,0,0
2021-11-09 06:15,12,3,9,0,0,0
2021-11-09 06:30,29,15,14,0,0,0
2021-11-09 06:45,51,15,36,0,0,0
2021-11-09 07:00,58,21,37,0,0,0
2021-11-09 07:15,69,32,37,0,0,0
2021-11-09 07:30,147,59,88,0,0,0
2021-11-09 07:45,301,142,159,0,0,0
2021-11-09 08:00,379,188,191,0,0,0
2021-11-09 08:15,152,71,81,0,0,0
2021-11-09 08:30,127,52,75,0,0,0
2021-11-09 08:45,153,66,87,0,0,0
2021-11-09 09:00,86,33,53,0,0,0
2021-11-09 09:15,71,32,39,0,0,0
2021-11-09 09:30,81,47,34,0,0,0
2021-11-09 09:45,247,134,113,0,0,0
2021-11-09 10:00,213,114,99,0,0,0
2021-11-09 10:15,77,32,45,0,0,0
2021-11-09 10:30,48,32,16,0,0,0
2021-11-09 10:45,65,27,38,0,0,0
2021-11-09 11:00,77,39,38,0,0,0
2021-11-09 11:15,56,30,26,0,0,0
2021-11-09 11:30,88,43,45,0,0,0
2021-11-09 11:45,236,91,145,0,0,0
2021-11-09 12:00,207,111,96,0,0,0
2021-11-09 12:15,104,40,64,0,0,0
2021-11-09 12:30,91,45,46,0,0,0
2021-11-09 12:45,137,61,76,0,0,0
2021-11-09 13:00,125,56,69,0,0,0
2021-11-09 13:15,95,43,52,0,0,0
2021-11-09 13:30,221,61,160,0,0,0
2021-11-09 13:45,247,107,140,0,0,0
2021-11-09 14:00,255,127,128,0,0,0
2021-11-09 14:15,129,57,72,0,0,0
2021-11-09 14:30,131,50,81,0,0,0
2021-11-09 14:45,146,61,85,0,0,0
2021-11-09 15:00,106,56,50,0,0,0
2021-11-09 15:15,115,52,63,0,0,0
2021-11-09 15:30,180,99,81,0,0,0
2021-11-09 15:45,292,138,154,0,0,0
2021-11-09 16:00,295,156,139,0,0,0
2021-11-09 16:15,182,121,61,0,0,0
2021-11-09 16:30,146,75,71,0,0,0
2021-11-09 16:45,159,84,75,0,0,0
2021-11-09 17:00,136,61,75,0,0,0
2021-11-09 17:15,139,75,64,0,0,0
2021-11-09 17:30,149,84,65,0,0,0
2021-11-09 17:45,225,141,84,0,0,0
2021-11-09 18:00,191,92,99,0,0,0
2021-11-09 18:15,130,51,79,0,0,0
2021-11-09 18:30,105,33,72,0,0,0
2021-11-09 18:45,102,48,54,0,0,0
2021-11-09 19:00,65,36,29,0,0,0
2021-11-09 19:15,81,40,41,0,0,0
2021-11-09 19:30,79,20,59,0,0,0
2021-11-09 19:45,86,47,39,0,0,0
2021-11-09 20:00,67,19,48,0,0,0
2021-11-09 20:15,43,22,21,0,0,0
2021-11-09 20:30,23,7,16,0,0,0
2021-11-09 20:45,34,14,20,0,0,0
2021-11-09 21:00,24,14,10,0,0,0
2021-11-09 21:15,32,15,17,0,0,0
2021-11-09 21:30,27,11,16,0,0,0
2021-11-09 21:45,29,9,20,0,0,0
2021-11-09 22:00,41,11,30,0,0,0
2021-11-09 22:15,27,8,19,0,0,0
2021-11-09 22:30,26,7,19,0,0,0
2021-11-09 22:45,22,2,20,0,0,0
2021-11-09 23:00,14,6,8,0,0,0
2021-11-09 23:15,14,3,11,0,0,0
2021-11-09 23:30,19,4,15,0,0,0
2021-11-09 23:45,7,1,6,0,0,0
2021-11-10 00:00,8,1,7,0,0,0
2021-11-10 00:15,8,3,5,0,0,0
2021-11-10 00:30,2,1,1,0,0,0
2021-11-10 00:45,2,0,2,0,0,0
2021-11-10 01:00,2,0,2,0,0,0
2021-11-10 01:15,1,1,0,0,0,0
2021-11-10 01:30,3,1,2,0,0,0
2021-11-10 01:45,0,0,0,0,0,0
2021-11-10 02:00,0,0,0,0,0,0
2021-11-10 02:15,1,1,0,0,0,0
2021-11-10 02:30,2,0,2,0,0,0
2021-11-10 02:45,0,0,0,0,0,0
2021-11-10 03:00,1,0,1,0,0,0
2021-11-10 03:15,0,0,0,0,0,0
2021-11-10 03:30,1,1,0,0,0,0
2021-11-10 03:45,1,1,0,0,0,0
2021-11-10 04:00,1,1,0,0,0,0
2021-11-10 04:15,1,1,0,0,0,0
2021-11-10 04:30,1,0,1,0,0,0
2021-11-10 04:45,0,0,0,0,0,0
2021-11-10 05:00,1,0,1,0,0,0
2021-11-10 05:15,0,0,0,0,0,0
2021-11-10 05:30,10,2,8,0,0,0
2021-11-10 05:45,7,4,3,0,0,0
2021-11-10 06:00,11,3,8,0,0,0
2021-11-10 06:15,20,9,11,0,0,0
2021-11-10 06:30,34,16,18,0,0,0
2021-11-10 06:45,51,28,23,0,0,0
2021-11-10 07:00,49,18,31,0,0,0
2021-11-10 07:15,83,34,49,0,0,0
2021-11-10 07:30,155,69,86,0,0,0
2021-11-10 07:45,290,144,146,0,0,0
2021-11-10 08:00,395,209,186,0,0,0
2021-11-10 08:15,165,68,97,0,0,0
2021-11-10 08:30,129,57,72,0,0,0
2021-11-10 08:45,155,69,86,0,0,0
2021-11-10 09:00,120,51,69,0,0,0
2021-11-10 09:15,103,54,49,0,0,0
2021-11-10 09:30,110,54,56,0,0,0
2021-11-10 09:45,250,121,129,0,0,0
2021-11-10 10:00,246,127,119,0,0,0
2021-11-10 10:15,103,61,42,0,0,0
2021-11-10 10:30,80,42,38,0,0,0
2021-11-10 10:45,85,35,50,0,0,0
2021-11-10 11:00,74,34,40,0,0,0
2021-11-10 11:15,83,43,40,0,0,0
2021-11-10 11:30,99,54,45,0,0,0
2021-11-10 11:45,238,108,130,0,0,0
2021-11-10 12:00,229,96,133,0,0,0
2021-11-10 12:15,138,55,83,0,0,0
2021-11-10 12:30,145,67,78,0,0,0
2021-11-10 12:45,156,84,72,0,0,0
2021-11-10 13:00,156,72,84,0,0,0
2021-11-10 13:15,175,85,90,0,0,0
2021-11-10 13:30,240,75,165,0,0,0
2021-11-10 13:45,269,102,167,0,0,0
2021-11-10 14:00,201,82,119,0,0,0
2021-11-10 14:15,104,40,64,0,0,0
2021-11-10 14:30,119,45,74,0,0,0
2021-11-10 14:45,148,66,82,0,0,0
2021-11-10 15:00,129,50,79,0,0,0
2021-11-10 15:15,111,67,44,0,0,0
2021-11-10 15:30,166,88,78,0,0,0
2021-11-10 15:45,277,158,119,0,0,0
2021-11-10 16:00,221,119,102,0,0,0
2021-11-10 16:15,170,82,88,0,0,0
2021-11-10 16:30,143,97,46,0,0,0
2021-11-10 16:45,142,77,65,0,0,0
2021-11-10 17:00,136,72,64,0,0,0
2021-11-10 17:15,173,93,80,0,0,0
2021-11-10 17:30,161,81,80,0,0,0
2021-11-10 17:45,274,131,143,0,0,0
2021-11-10 18:00,154,80,74,0,0,0
2021-11-10 18:15,148,57,91,0,0,0
2021-11-10 18:30,88,30,58,0,0,0
2021-11-10 18:45,86,36,50,0,0,0
2021-11-10 19:00,80,46,34,0,0,0
2021-11-10 19:15,74,30,44,0,0,0
2021-11-10 19:30,74,32,42,0,0,0
2021-11-10 19:45,86,27,59,0,0,0
2021-11-10 20:00,56,21,35,0,0,0
2021-11-10 20:15,63,39,24,0,0,0
2021-11-10 20:30,38,15,23,0,0,0
2021-11-10 20:45,32,10,22,0,0,0
2021-11-10 21:00,25,15,10,0,0,0
2021-11-10 21:15,34,5,29,0,0,0
2021-11-10 21:30,44,13,31,0,0,0
2021-11-10 21:45,45,27,18,0,0,0
2021-11-10 22:00,38,24,14,0,0,0
2021-11-10 22:15,41,21,20,0,0,0
2021-11-10 22:30,26,6,20,0,0,0
2021-11-10 22:45,31,11,20,0,0,0
2021-11-10 23:00,24,8,16,0,0,0
2021-11-10 23:15,13,6,7,0,0,0
2021-11-10 23:30,16,13,3,0,0,0
2021-11-10 23:45,11,5,6,0,0,0
2021-11-11 00:00,13,2,11,0,0,0
2021-11-11 00:15,10,8,2,0,0,0
2021-11-11 00:30,2,0,2,0,0,0
2021-11-11 00:45,8,1,7,0,0,0
2021-11-11 01:00,0,0,0,0,0,0
2021-11-11 01:15,1,0,1,0,0,0
2021-11-11 01:30,2,1,1,0,0,0
2021-11-11 01:45,2,0,2,0,0,0
2021-11-11 02:00,9,1,8,0,0,0
2021-11-11 02:15,10,0,10,0,0,0
2021-11-11 02:30,2,0,2,0,0,0
2021-11-11 02:45,3,0,3,0,0,0
2021-11-11 03:00,3,0,3,0,0,0
2021-11-11 03:15,2,0,2,0,0,0
2021-11-11 03:30,2,1,1,0,0,0
2021-11-11 03:45,3,1,2,0,0,0
2021-11-11 04:00,0,0,0,0,0,0
2021-11-11 04:15,1,0,1,0,0,0
2021-11-11 04:30,0,0,0,0,0,0
2021-11-11 04:45,0,0,0,0,0,0
2021-11-11 05:00,0,0,0,0,0,0
2021-11-11 05:15,2,0,2,0,0,0
2021-11-11 05:30,7,3,4,0,0,0
2021-11-11 05:45,15,5,10,0,0,0
2021-11-11 06:00,4,2,2,0,0,0
2021-11-11 06:15,19,7,12,0,0,0
2021-11-11 06:30,20,4,16,0,0,0
2021-11-11 06:45,49,16,33,0,0,0
2021-11-11 07:00,74,28,46,0,0,0
2021-11-11 07:15,78,25,53,0,0,0
2021-11-11 07:30,117,46,71,0,0,0
2021-11-11 07:45,297,134,163,0,0,0
2021-11-11 08:00,348,185,163,0,0,0
2021-11-11 08:15,177,81,96,0,0,0
2021-11-11 08:30,127,61,66,0,0,0
2021-11-11 08:45,145,55,90,0,0,0
2021-11-11 09:00,113,38,75,0,0,0
2021-11-11 09:15,79,33,46,0,0,0
2021-11-11 09:30,125,48,77,0,0,0
2021-11-11 09:45,181,102,79,0,0,0
2021-11-11 10:00,239,102,137,0,0,0
2021-11-11 10:15,84,38,46,0,0,0
2021-11-11 10:30,76,38,38,0,0,0
2021-11-11 10:45,88,32,56,0,0,0
2021-11-11 11:00,69,29,40,0,0,0
2021-11-11 11:15,84,43,41,0,0,0
2021-11-11 11:30,75,23,52,0,0,0
2021-11-11 11:45,195,79,116,0,0,0
2021-11-11 12:00,211,108,103,0,0,0
2021-11-11 12:15,128,60,68,0,0,0
2021-11-11 12:30,110,43,67,0,0,0
2021-11-11 12:45,149,63,86,0,0,0
2021-11-11 13:00,108,48,60,0,0,0
2021-11-11 13:15,121,52,69,0,0,0
2021-11-11 13:30,151,44,107,0,0,0
2021-11-11 13:45,213,76,137,0,0,0
2021-11-11 14:00,210,67,143,0,0,0
2021-11-11 14:15,117,58,59,0,0,0
2021-11-11 14:30,155,67,88,0,0,0
2021-11-11 14:45,118,50,68,0,0,0
2021-11-11 15:00,114,66,48,0,0,0
2021-11-11 15:15,127,67,60,0,0,0
2021-11-11 15:30,137,80,57,0,0,0
2021-11-11 15:45,222,102,120,0,0,0
2021-11-11 16:00,214,103,111,0,0,0
2021-11-11 16:15,152,94,58,0,0,0
2021-11-11 16:30,142,73,69,0,0,0
2021-11-11 16:45,139,73,66,0,0,0
2021-11-11 17:00,145,83,62,0,0,0
2021-11-11 17:15,153,63,90,0,0,0
2021-11-11 17:30,134,81,53,0,0,0
2021-11-11 17:45,200,108,92,0,0,0
2021-11-11 18:00,150,67,83,0,0,0
2021-11-11 18:15,143,83,60,0,0,0
2021-11-11 18:30,82,38,44,0,0,0
2021-11-11 18:45,93,41,52,0,0,0
2021-11-11 19:00,92,47,45,0,0,0
2021-11-11 19:15,72,39,33,0,0,0
2021-11-11 19:30,48,19,29,0,0,0
2021-11-11 19:45,104,50,54,0,0,0
2021-11-11 20:00,69,28,41,0,0,0
2021-11-11 20:15,50,22,28,0,0,0
2021-11-11 20:30,31,18,13,0,0,0
2021-11-11 20:45,24,9,15,0,0,0
2021-11-11 21:00,42,24,18,0,0,0
2021-11-11 21:15,45,18,27,0,0,0
2021-11-11 21:30,18,4,14,0,0,0
2021-11-11 21:45,41,18,23,0,0,0
2021-11-11 22:00,40,16,24,0,0,0
2021-11-11 22:15,59,25,34,0,0,0
2021-11-11 22:30,20,5,15,0,0,0
2021-11-11 22:45,23,4,19,0,0,0
2021-11-11 23:00,14,2,12,0,0,0
2021-11-11 23:15,12,3,9,0,0,0
2021-11-11 23:30,4,0,4,0,0,0
2021-11-11 23:45,22,6,16,0,0,0
2021-11-12 00:00,24,9,15,0,0,0
2021-11-12 00:15,14,6,8,0,0,0
2021-11-12 00:30,5,5,0,0,0,0
2021-11-12 00:45,8,1,7,0,0,0
2021-11-12 01:00,4,2,2,0,0,0
2021-11-12 01:15,2,0,2,0,0,0
2021-11-12 01:30,4,0,4,0,0,0
2021-11-12 01:45,1,0,1,0,0,0
2021-11-12 02:00,0,0,0,0,0,0
2021-11-12 02:15,3,2,1,0,0,0
2021-11-12 02:30,7,1,6,0,0,0
2021-11-12 02:45,1,1,0,0,0,0
2021-11-12 03:00,0,0,0,0,0,0
2021-11-12 03:15,0,0,0,0,0,0
2021-11-12 03:30,0,0,0,0,0,0
2021-11-12 03:45,1,0,1,0,0,0
2021-11-12 04:00,1,0,1,0,0,0
2021-11-12 04:15,0,0,0,0,0,0
2021-11-12 04:30,3,1,2,0,0,0
2021-11-12 04:45,0,0,0,0,0,0
2021-11-12 05:00,0,0,0,0,0,0
2021-11-12 05:15,2,1,1,0,0,0
2021-11-12 05:30,12,3,9,0,0,0
2021-11-12 05:45,6,3,3,0,0,0
2021-11-12 06:00,4,1,3,0,0,0
2021-11-12 06:15,12,2,10,0,0,0
2021-11-12 06:30,30,15,15,0,0,0
2021-11-12 06:45,45,12,33,0,0,0
2021-11-12 07:00,63,20,43,0,0,0
2021-11-12 07:15,78,28,50,0,0,0
2021-11-12 07:30,133,63,70,0,0,0
2021-11-12 07:45,242,104,138,0,0,0
2021-11-12 08:00,313,155,158,0,0,0
2021-11-12 08:15,152,75,77,0,0,0
2021-11-12 08:30,105,56,49,0,0,0
2021-11-12 08:45,127,68,59,0,0,0
2021-11-12 09:00,97,33,64,0,0,0
2021-11-12 09:15,87,40,47,0,0,0
2021-11-12 09:30,100,45,55,0,0,0
2021-11-12 09:45,216,94,122,0,0,0
2021-11-12 10:00,156,73,83,0,0,0
2021-11-12 10:15,71,44,27,0,0,0
2021-11-12 10:30,79,42,37,0,0,0
2021-11-12 10:45,96,52,44,0,0,0
2021-11-12 11:00,120,81,39,0,0,0
2021-11-12 11:15,92,66,26,0,0,0
2021-11-12 11:30,63,38,25,0,0,0
2021-11-12 11:45,173,71,102,0,0,0
2021-11-12 12:00,147,87,60,0,0,0
2021-11-12 12:15,128,67,61,0,0,0
2021-11-12 12:30,112,55,57,0,0,0
2021-11-12 12:45,130,57,73,0,0,0
2021-11-12 13:00,136,54,82,0,0,0
2021-11-12 13:15,149,47,102,0,0,0
2021-11-12 13:30,206,73,133,0,0,0
2021-11-12 13:45,202,79,123,0,0,0
2021-11-12 14:00,151,69,82,0,0,0
2021-11-12 14:15,145,58,87,0,0,0
2021-11-12 14:30,149,64,85,0,0,0
2021-11-12 14:45,123,65,58,0,0,0
2021-11-12 15:00,121,64,57,0,0,0
2021-11-12 15:15,148,71,77,0,0,0
2021-11-12 15:30,135,65,70,0,0,0
2021-11-12 15:45,138,76,62,0,0,0
2021-11-12 16:00,144,74,70,0,0,0
2021-11-12 16:15,106,58,48,0,0,0
2021-11-12 16:30,109,56,53,0,0,0
2021-11-12 16:45,108,67,41,0,0,0
2021-11-12 17:00,123,61,62,0,0,0
2021-11-12 17:15,99,62,37,0,0,0
2021-11-12 17:30,100,56,44,0,0,0
2021-11-12 17:45,104,51,53,0,0,0
2021-11-12 18:00,113,44,69,0,0,0
2021-11-12 18:15,76,37,39,0,0,0
2021-11-12 18:30,61,20,41,0,0,0
2021-11-12 18:45,61,27,34,0,0,0
2021-11-12 19:00,71,33,38,0,0,0
2021-11-12 19:15,68,30,38,0,0,0
2021-11-12 19:30,58,27,31,0,0,0
2021-11-12 19:45,38,21,17,0,0,0
2021-11-12 20:00,46,21,25,0,0,0
2021-11-12 20:15,51,24,27,0,0,0
2021-11-12 20:30,36,12,24,0,0,0
2021-11-12 20:45,29,7,22,0,0,0
2021-11-12 21:00,25,11,14,0,0,0
2021-11-12 21:15,26,11,15,0,0,0
2021-11-12 21:30,23,7,16,0,0,0
2021-11-12 21:45,30,6,24,0,0,0
2021-11-12 22:00,18,7,11,0,0,0
2021-11-12 22:15,25,5,20,0,0,0
2021-11-12 22:30,35,6,29,0,0,0
2021-11-12 22:45,18,4,14,0,0,0
2021-11-12 23:00,14,3,11,0,0,0
2021-11-12 23:15,40,17,23,0,0,0
2021-11-12 23:30,15,5,10,0,0,0
2021-11-12 23:45,17,4,13,0,0,0
2021-11-13 00:00,29,6,23,0,0,0
2021-11-13 00:15,16,4,12,0,0,0
2021-11-13 00:30,16,7,9,0,0,0
2021-11-13 00:45,21,3,18,0,0,0
2021-11-13 01:00,14,2,12,0,0,0
2021-11-13 01:15,8,2,6,0,0,0
2021-11-13 01:30,18,8,10,0,0,0
2021-11-13 01:45,6,1,5,0,0,0
2021-11-13 02:00,18,8,10,0,0,0
2021-11-13 02:15,6,2,4,0,0,0
2021-11-13 02:30,10,4,6,0,0,0
2021-11-13 02:45,3,1,2,0,0,0
2021-11-13 03:00,5,3,2,0,0,0
2021-11-13 03:15,7,2,5,0,0,0
2021-11-13 03:30,6,5,1,0,0,0
2021-11-13 03:45,4,1,3,0,0,0
2021-11-13 04:00,3,1,2,0,0,0
2021-11-13 04:15,3,0,3,0,0,0
2021-11-13 04:30,4,0,4,0,0,0
2021-11-13 04:45,3,0,3,0,0,0
2021-11-13 05:00,2,0,2,0,0,0
2021-11-13 05:15,2,2,0,0,0,0
2021-11-13 05:30,10,2,8,0,0,0
2021-11-13 05:45,8,3,5,0,0,0
2021-11-13 06:00,2,1,1,0,0,0
2021-11-13 06:15,1,0,1,0,0,0
2021-11-13 06:30,8,3,5,0,0,0
2021-11-13 06:45,10,9,1,0,0,0
2021-11-13 07:00,10,6,4,0,0,0
2021-11-13 07:15,7,5,2,0,0,0
2021-11-13 07:30,7,1,6,0,0,0
2021-11-13 07:45,17,11,6,0,0,0
2021-11-13 08:00,11,5,6,0,0,0
2021-11-13 08:15,32,18,14,0,0,0
2021-11-13 08:30,27,15,12,0,0,0
2021-11-13 08:45,41,24,17,0,0,0
2021-11-13 09:00,28,22,6,0,0,0
2021-11-13 09:15,37,23,14,0,0,0
2021-11-13 09:30,53,45,8,0,0,0
2021-11-13 09:45,62,44,18,0,0,0
2021-11-13 10:00,44,36,8,0,0,0
2021-11-13 10:15,55,41,14,0,0,0
2021-11-13 10:30,63,50,13,0,0,0
2021-11-13 10:45,52,39,13,0,0,0
2021-11-13 11:00,57,41,16,0,0,0
2021-11-13 11:15,71,46,25,0,0,0
2021-11-13 11:30,73,52,21,0,0,0
2021-11-13 11:45,75,48,27,0,0,0
2021-11-13 12:00,83,41,42,0,0,0
2021-11-13 12:15,76,43,33,0,0,0
2021-11-13 12:30,87,53,34,0,0,0
2021-11-13 12:45,78,35,43,0,0,0
2021-11-13 13:00,77,39,38,0,0,0
2021-11-13 13:15,54,21,33,0,0,0
2021-11-13 13:30,81,41,40,0,0,0
2021-11-13 13:45,66,29,37,0,0,0
2021-11-13 14:00,51,22,29,0,0,0
2021-11-13 14:15,61,24,37,0,0,0
2021-11-13 14:30,72,35,37,0,0,0
2021-11-13 14:45,71,35,36,0,0,0
2021-11-13 15:00,72,25,47,0,0,0
2021-11-13 15:15,40,15,25,0,0,0
2021-11-13 15:30,46,20,26,0,0,0
2021-11-13 15:45,39,16,23,0,0,0
2021-11-13 16:00,66,22,44,0,0,0
2021-11-13 16:15,56,23,33,0,0,0
2021-11-13 16:30,44,15,29,0,0,0
2021-11-13 16:45,57,30,27,0,0,0
2021-11-13 17:00,53,16,37,0,0,0
2021-11-13 17:15,57,17,40,0,0,0
2021-11-13 17:30,44,16,28,0,0,0
2021-11-13 17:45,53,29,24,0,0,0
2021-11-13 18:00,50,12,38,0,0,0
2021-11-13 18:15,39,15,24,0,0,0
2021-11-13 18:30,53,24,29,0,0,0
2021-11-13 18:45,42,23,19,0,0,0
2021-11-13 19:00,50,25,25,0,0,0
2021-11-13 19:15,49,25,24,0,0,0
2021-11-13 19:30,30,15,15,0,0,0
2021-11-13 19:45,55,27,28,0,0,0
2021-11-13 20:00,34,15,19,0,0,0
2021-11-13 20:15,28,12,16,0,0,0
2021-11-13 20:30,23,13,10,0,0,0
2021-11-13 20:45,21,10,11,0,0,0
2021-11-13 21:00,14,5,9,0,0,0
2021-11-13 21:15,22,12,10,0,0,0
2021-11-13 21:30,15,7,8,0,0,0
2021-11-13 21:45,14,3,11,0,0,0
2021-11-13 22:00,22,2,20,0,0,0
2021-11-13 22:15,26,7,19,0,0,0
2021-11-13 22:30,11,2,9,0,0,0
2021-11-13 22:45,25,4,21,0,0,0
2021-11-13 23:00,18,9,9,0,0,0
2021-11-13 23:15,8,3,5,0,0,0
2021-11-13 23:30,23,13,10,0,0,0
2021-11-13 23:45,6,1,5,0,0,0
2021-11-14 00:00,15,4,11,0,0,0
2021-11-14 00:15,8,2,6,0,0,0
2021-11-14 00:30,8,3,5,0,0,0
2021-11-14 00:45,15,2,13,0,0,0
2021-11-14 01:00,17,3,14,0,0,0
2021-11-14 01:15,11,7,4,0,0,0
2021-11-14 01:30,6,5,1,0,0,0
2021-11-14 01:45,7,2,5,0,0,0
2021-11-14 02:00,8,2,6,0,0,0
2021-11-14 02:15,6,2,4,0,0,0
2021-11-14 02:30,8,0,8,0,0,0
2021-11-14 02:45,7,0,7,0,0,0
2021-11-14 03:00,4,0,4,0,0,0
2021-11-14 03:15,5,3,2,0,0,0
2021-11-14 03:30,10,3,7,0,0,0
2021-11-14 03:45,2,1,1,0,0,0
2021-11-14 04:00,4,1,3,0,0,0
2021-11-14 04:15,5,0,5,0,0,0
2021-11-14 04:30,5,1,4,0,0,0
2021-11-14 04:45,5,0,5,0,0,0
2021-11-14 05:00,0,0,0,0,0,0
2021-11-14 05:15,3,1,2,0,0,0
2021-11-14 05:30,6,0,6,0,0,0
2021-11-14 05:45,8,1,7,0,0,0
2021-11-14 06:00,5,1,4,0,0,0
2021-11-14 06:15,2,0,2,0,0,0
2021-11-14 06:30,7,4,3,0,0,0
2021-11-14 06:45,5,3,2,0,0,0
2021-11-14 07:00,3,2,1,0,0,0
2021-11-14 07:15,2,1,1,0,0,0
2021-11-14 07:30,4,1,3,0,0,0
2021-11-14 07:45,6,3,3,0,0,0
2021-11-14 08:00,7,5,2,0,0,0
2021-11-14 08:15,13,9,4,0,0,0
2021-11-14 08:30,9,3,6,0,0,0
2021-11-14 08:45,21,11,10,0,0,0
2021-11-14 09:00,7,3,4,0,0,0
2021-11-14 09:15,16,13,3,0,0,0
2021-11-14 09:30,22,15,7,0,0,0
2021-11-14 09:45,39,21,18,0,0,0
2021-11-14 10:00,21,13,8,0,0,0
2021-11-14 10:15,17,11,6,0,0,0
2021-11-14 10:30,20,12,8,0,0,0
2021-11-14 10:45,17,8,9,0,0,0
2021-11-14 11:00,13,6,7,0,0,0
2021-11-14 11:15,38,31,7,0,0,0
2021-11-14 11:30,26,10,16,0,0,0
2021-11-14 11:45,29,15,14,0,0,0
2021-11-14 12:00,30,14,16,0,0,0
2021-11-14 12:15,27,11,16,0,0,0
2021-11-14 12:30,28,11,17,0,0,0
2021-11-14 12:45,25,12,13,0,0,0
2021-11-14 13:00,33,14,19,0,0,0
2021-11-14 13:15,42,15,27,0,0,0
2021-11-14 13:30,32,12,20,0,0,0
2021-11-14 13:45,38,14,24,0,0,0
2021-11-14 14:00,66,37,29,0,0,0
2021-11-14 14:15,54,26,28,0,0,0
2021-11-14 14:30,36,18,18,0,0,0
2021-11-14 14:45,39,19,20,0,0,0
2021-11-14 15:00,42,20,22,0,0,0
2021-11-14 15:15,34,16,18,0,0,0
2021-11-14 15:30,48,24,24,0,0,0
2021-11-14 15:45,49,9,40,0,0,0
2021-11-14 16:00,31,15,16,0,0,0
2021-11-14 16:15,46,13,33,0,0,0
2021-11-14 16:30,43,20,23,0,0,0
2021-11-14 16:45,44,21,23,0,0,0
2021-11-14 17:00,30,10,20,0,0,0
2021-11-14 17:15,39,20,19,0,0,0
2021-11-14 17:30,32,11,21,0,0,0
2021-11-14 17:45,46,23,23,0,0,0
2021-11-14 18:00,40,29,11,0,0,0
2021-11-14 18:15,37,24,13,0,0,0
2021-11-14 18:30,28,12,16,0,0,0
2021-11-14 18:45,31,14,17,0,0,0
2021-11-14 19:00,25,10,15,0,0,0
2021-11-14 19:15,20,8,12,0,0,0
2021-11-14 19:30,15,2,13,0,0,0
2021-11-14 19:45,25,9,16,0,0,0
2021-11-14 20:00,26,8,18,0,0,0
2021-11-14 20:15,14,2,12,0,0,0
2021-11-14 20:30,16,5,11,0,0,0
2021-11-14 20:45,9,1,8,0,0,0
2021-11-14 21:00,19,6,13,0,0,0
2021-11-14 21:15,18,7,11,0,0,0
2021-11-14 21:30,19,2,17,0,0,0
2021-11-14 21:45,8,2,6,0,0,0
2021-11-14 22:00,14,3,11,0,0,0
2021-11-14 22:15,12,2,10,0,0,0
2021-11-14 22:30,11,2,9,0,0,0
2021-11-14 22:45,4,1,3,0,0,0
2021-11-14 23:00,5,2,3,0,0,0
2021-11-14 23:15,12,1,11,0,0,0
2021-11-14 23:30,8,0,8,0,0,0
2021-11-14 23:45,2,1,1,0,0,0
2021-11-15 00:00,5,1,4,0,0,0
2021-11-15 00:15,1,0,1,0,0,0
2021-11-15 00:30,1,0,1,0,0,0
2021-11-15 00:45,3,0,3,0,0,0
2021-11-15 01:00,0,0,0,0,0,0
2021-11-15 01:15,1,1,0,0,0,0
2021-11-15 01:30,0,0,0,0,0,0
2021-11-15 01:45,2,2,0,0,0,0
2021-11-15 02:00,0,0,0,0,0,0
2021-11-15 02:15,1,0,1,0,0,0
2021-11-15 02:30,0,0,0,0,0,0
2021-11-15 02:45,1,0,1,0,0,0
2021-11-15 03:00,0,0,0,0,0,0
2021-11-15 03:15,1,0,1,0,0,0
2021-11-15 03:30,0,0,0,0,0,0
2021-11-15 03:45,0,0,0,0,0,0
2021-11-15 04:00,1,1,0,0,0,0
2021-11-15 04:15,1,0,1,0,0,0
2021-11-15 04:30,0,0,0,0,0,0
2021-11-15 04:45,1,1,0,0,0,0
2021-11-15 05:00,1,1,0,0,0,0
2021-11-15 05:15,2,0,2,0,0,0
2021-11-15 05:30,5,3,2,0,0,0
2021-11-15 05:45,7,3,4,0,0,0
2021-11-15 06:00,4,2,2,0,0,0
2021-11-15 06:15,26,11,15,0,0,0
2021-11-15 06:30,41,17,24,0,0,0
2021-11-15 06:45,63,26,37,0,0,0
2021-11-15 07:00,52,15,37,0,0,0
2021-11-15 07:15,74,32,42,0,0,0
2021-11-15 07:30,138,69,69,0,0,0
2021-11-15 07:45,272,133,139,0,0,0
2021-11-15 08:00,378,183,195,0,0,0
2021-11-15 08:15,163,59,104,0,0,0
2021-11-15 08:30,100,52,48,0,0,0
2021-11-15 08:45,181,93,88,0,0,0
2021-11-15 09:00,82,33,49,0,0,0
2021-11-15 09:15,75,32,43,0,0,0
2021-11-15 09:30,68,30,38,0,0,0
2021-11-15 09:45,201,127,74,0,0,0
2021-11-15 10:00,237,112,125,0,0,0
2021-11-15 10:15,91,48,43,0,0,0
2021-11-15 10:30,64,30,34,0,0,0
2021-11-15 10:45,60,30,30,0,0,0
2021-11-15 11:00,59,30,29,0,0,0
2021-11-15 11:15,69,28,41,0,0,0
2021-11-15 11:30,85,31,54,0,0,0
2021-11-15 11:45,236,79,157,0,0,0
2021-11-15 12:00,185,75,110,0,0,0
2021-11-15 12:15,104,33,71,0,0,0
2021-11-15 12:30,110,44,66,0,0,0
2021-11-15 12:45,130,42,88,0,0,0
2021-11-15 13:00,117,55,62,0,0,0
2021-11-15 13:15,105,43,62,0,0,0
2021-11-15 13:30,132,31,101,0,0,0
2021-11-15 13:45,191,78,113,0,0,0
2021-11-15 14:00,158,62,96,0,0,0
2021-11-15 14:15,113,53,60,0,0,0
2021-11-15 14:30,116,35,81,0,0,0
2021-11-15 14:45,131,74,57,0,0,0
2021-11-15 15:00,110,56,54,0,0,0
2021-11-15 15:15,129,56,73,0,0,0
2021-11-15 15:30,119,61,58,0,0,0
2021-11-15 15:45,277,181,96,0,0,0
2021-11-15 16:00,206,113,93,0,0,0
2021-11-15 16:15,140,85,55,0,0,0
2021-11-15 16:30,132,67,65,0,0,0
2021-11-15 16:45,142,71,71,0,0,0
2021-11-15 17:00,116,70,46,0,0,0
2021-11-15 17:15,158,90,68,0,0,0
2021-11-15 17:30,137,74,63,0,0,0
2021-11-15 17:45,194,105,89,0,0,0
2021-11-15 18:00,138,65,73,0,0,0
2021-11-15 18:15,100,41,59,0,0,0
2021-11-15 18:30,78,35,43,0,0,0
2021-11-15 18:45,81,31,50,0,0,0
2021-11-15 19:00,58,28,30,0,0,0
2021-11-15 19:15,63,24,39,0,0,0
2021-11-15 19:30,57,22,35,0,0,0
2021-11-15 19:45,84,34,50,0,0,0
2021-11-15 20:00,57,19,38,0,0,0
2021-11-15 20:15,51,15,36,0,0,0
2021-11-15 20:30,36,11,25,0,0,0
2021-11-15 20:45,26,10,16,0,0,0
2021-11-15 21:00,26,11,15,0,0,0
2021-11-15 21:15,17,4,13,0,0,0
2021-11-15 21:30,25,6,19,0,0,0
2021-11-15 21:45,26,5,21,0,0,0
2021-11-15 22:00,17,2,15,0,0,0
2021-11-15 22:15,29,14,15,0,0,0
2021-11-15 22:30,18,11,7,0,0,0
2021-11-15 22:45,8,3,5,0,0,0
2021-11-15 23:00,21,7,14,0,0,0
2021-11-15 23:15,9,4,5,0,0,0
2021-11-15 23:30,17,5,12,0,0,0
2021-11-15 23:45,9,0,9,0,0,0
2021-11-16 00:00,9,2,7,0,0,0
2021-11-16 00:15,11,5,6,0,0,0
2021-11-16 00:30,3,0,3,0,0,0
2021-11-16 00:45,1,0,1,0,0,0
2021-11-16 01:00,4,0,4,0,0,0
2021-11-16 01:15,3,3,0,0,0,0
2021-11-16 01:30,2,0,2,0,0,0
2021-11-16 01:45,0,0,0,0,0,0
2021-11-16 02:00,1,1,0,0,0,0
2021-11-16 02:15,0,0,0,0,0,0
2021-11-16 02:30,1,0,1,0,0,0
2021-11-16 02:45,0,0,0,0,0,0
2021-11-16 03:00,0,0,0,0,0,0
2021-11-16 03:15,1,0,1,0,0,0
2021-11-16 03:30,0,0,0,0,0,0
2021-11-16 03:45,1,1,0,0,0,0
2021-11-16 04:00,0,0,0,0,0,0
2021-11-16 04:15,1,0,1,0,0,0
2021-11-16 04:30,0,0,0,0,0,0
2021-11-16 04:45,3,2,1,0,0,0
2021-11-16 05:00,1,0,1,0,0,0
2021-11-16 05:15,2,0,2,0,0,0
2021-11-16 05:30,9,2,7,0,0,0
2021-11-16 05:45,6,2,4,0,0,0
2021-11-16 06:00,6,4,2,0,0,0
2021-11-16 06:15,22,8,14,0,0,0
2021-11-16 06:30,25,15,10,0,0,0
2021-11-16 06:45,39,19,20,0,0,0
2021-11-16 07:00,54,18,36,0,0,0
2021-11-16 07:15,68,26,42,0,0,0
2021-11-16 07:30,154,65,89,0,0,0
2021-11-16 07:45,316,135,181,0,0,0
2021-11-16 08:00,365,188,177,0,0,0
2021-11-16 08:15,149,68,81,0,0,0
2021-11-16 08:30,110,47,63,0,0,0
2021-11-16 08:45,148,64,84,0,0,0
2021-11-16 09:00,92,37,55,0,0,0
2021-11-16 09:15,71,35,36,0,0,0
2021-11-16 09:30,82,31,51,0,0,0
2021-11-16 09:45,257,156,101,0,0,0
2021-11-16 10:00,230,114,116,0,0,0
2021-11-16 10:15,89,50,39,0,0,0
2021-11-16 10:30,56,26,30,0,0,0
2021-11-16 10:45,60,29,31,0,0,0
2021-11-16 11:00,39,23,16,0,0,0
2021-11-16 11:15,58,23,35,0,0,0
2021-11-16 11:30,88,38,50,0,0,0
2021-11-16 11:45,217,102,115,0,0,0
2021-11-16 12:00,166,86,80,0,0,0
2021-11-16 12:15,79,38,41,0,0,0
2021-11-16 12:30,93,46,47,0,0,0
2021-11-16 12:45,124,65,59,0,0,0
2021-11-16 13:00,131,59,72,0,0,0
2021-11-16 13:15,97,40,57,0,0,0
2021-11-16 13:30,189,56,133,0,0,0
2021-11-16 13:45,263,108,155,0,0,0
2021-11-16 14:00,196,73,123,0,0,0
2021-11-16 14:15,112,56,56,0,0,0
2021-11-16 14:30,109,37,72,0,0,0
2021-11-16 14:45,100,46,54,0,0,0
2021-11-16 15:00,85,39,46,0,0,0
2021-11-16 15:15,108,52,56,0,0,0
2021-11-16 15:30,110,55,55,0,0,0
2021-11-16 15:45,249,130,119,0,0,0
2021-11-16 16:00,287,156,131,0,0,0
2021-11-16 16:15,115,60,55,0,0,0
2021-11-16 16:30,137,85,52,0,0,0
2021-11-16 16:45,146,64,82,0,0,0
2021-11-16 17:00,132,81,51,0,0,0
2021-11-16 17:15,115,59,56,0,0,0
2021-11-16 17:30,127,57,70,0,0,0
2021-11-16 17:45,269,155,114,0,0,0
2021-11-16 18:00,187,92,95,0,0,0
2021-11-16 18:15,111,59,52,0,0,0
2021-11-16 18:30,80,28,52,0,0,0
2021-11-16 18:45,89,37,52,0,0,0
2021-11-16 19:00,61,29,32,0,0,0
2021-11-16 19:15,81,49,32,0,0,0
2021-11-16 19:30,74,31,43,0,0,0
2021-11-16 19:45,88,32,56,0,0,0
2021-11-16 20:00,74,30,44,0,0,0
2021-11-16 20:15,35,11,24,0,0,0
2021-11-16 20:30,23,6,17,0,0,0
2021-11-16 20:45,25,15,10,0,0,0
2021-11-16 21:00,33,11,22,0,0,0
2021-11-16 21:15,26,15,11,0,0,0
2021-11-16 21:30,27,11,16,0,0,0
2021-11-16 21:45,35,9,26,0,0,0
2021-11-16 22:00,35,8,27,0,0,0
2021-11-16 22:15,24,13,11,0,0,0
2021-11-16 22:30,24,4,20,0,0,0
2021-11-16 22:45,17,3,14,0,0,0
2021-11-16 23:00,11,3,8,0,0,0
2021-11-16 23:15,23,10,13,0,0,0
2021-11-16 23:30,10,4,6,0,0,0
2021-11-16 23:45,7,6,1,0,0,0
2021-11-17 00:00,7,1,6,0,0,0
2021-11-17 00:15,0,0,0,0,0,0
2021-11-17 00:30,3,0,3,0,0,0
2021-11-17 00:45,4,2,2,0,0,0
2021-11-17 01:00,3,1,2,0,0,0
2021-11-17 01:15,1,0,1,0,0,0
2021-11-17 01:30,5,1,4,0,0,0
2021-11-17 01:45,0,0,0,0,0,0
2021-11-17 02:00,1,0,1,0,0,0
2021-11-17 02:15,0,0,0,0,0,0
2021-11-17 02:30,1,1,0,0,0,0
2021-11-17 02:45,0,0,0,0,0,0
2021-11-17 03:00,0,0,0,0,0,0
2021-11-17 03:15,0,0,0,0,0,0
2021-11-17 03:30,0,0,0,0,0,0
2021-11-17 03:45,2,1,1,0,0,0
2021-11-17 04:00,0,0,0,0,0,0
2021-11-17 04:15,1,0,1,0,0,0
2021-11-17 04:30,1,1,0,0,0,0
2021-11-17 04:45,1,1,0,0,0,0
2021-11-17 05:00,1,0,1,0,0,0
2021-11-17 05:15,3,0,3,0,0,0
2021-11-17 05:30,12,4,8,0,0,0
2021-11-17 05:45,8,4,4,0,0,0
2021-11-17 06:00,8,1,7,0,0,0
2021-11-17 06:15,26,8,18,0,0,0
2021-11-17 06:30,30,18,12,0,0,0
2021-11-17 06:45,49,25,24,0,0,0
2021-11-17 07:00,66,17,49,0,0,0
2021-11-17 07:15,51,17,34,0,0,0
2021-11-17 07:30,153,78,75,0,0,0
2021-11-17 07:45,293,121,172,0,0,0
2021-11-17 08:00,362,202,160,0,0,0
2021-11-17 08:15,148,68,80,0,0,0
2021-11-17 08:30,114,48,66,0,0,0
2021-11-17 08:45,135,52,83,0,0,0
2021-11-17 09:00,107,47,60,0,0,0
2021-11-17 09:15,68,35,33,0,0,0
2021-11-17 09:30,97,48,49,0,0,0
2021-11-17 09:45,213,112,101,0,0,0
2021-11-17 10:00,254,123,131,0,0,0
2021-11-17 10:15,97,49,48,0,0,0
2021-11-17 10:30,55,27,28,0,0,0
2021-11-17 10:45,63,26,37,0,0,0
2021-11-17 11:00,61,32,29,0,0,0
2021-11-17 11:15,90,47,43,0,0,0
2021-11-17 11:30,99,47,52,0,0,0
2021-11-17 11:45,235,108,127,0,0,0
2021-11-17 12:00,212,116,96,0,0,0
2021-11-17 12:15,130,64,66,0,0,0
2021-11-17 12:30,90,24,66,0,0,0
2021-11-17 12:45,105,39,66,0,0,0
2021-11-17 13:00,121,57,64,0,0,0
2021-11-17 13:15,91,43,48,0,0,0
2021-11-17 13:30,189,80,109,0,0,0
2021-11-17 13:45,209,91,118,0,0,0
2021-11-17 14:00,192,82,110,0,0,0
2021-11-17 14:15,108,44,64,0,0,0
2021-11-17 14:30,125,33,92,0,0,0
2021-11-17 14:45,107,46,61,0,0,0
2021-11-17 15:00,122,66,56,0,0,0
2021-11-17 15:15,120,51,69,0,0,0
2021-11-17 15:30,131,85,46,0,0,0
2021-11-17 15:45,227,127,100,0,0,0
2021-11-17 16:00,196,96,100,0,0,0
2021-11-17 16:15,159,81,78,0,0,0
2021-11-17 16:30,151,82,69,0,0,0
2021-11-17 16:45,145,65,80,0,0,0
2021-11-17 17:00,134,74,60,0,0,0
2021-11-17 17:15,137,79,58,0,0,0
2021-11-17 17:30,146,85,61,0,0,0
2021-11-17 17:45,225,123,102,0,0,0
2021-11-17 18:00,144,77,67,0,0,0
2021-11-17 18:15,109,34,75,0,0,0
2021-11-17 18:30,79,27,52,0,0,0
2021-11-17 18:45,90,46,44,0,0,0
2021-11-17 19:00,76,34,42,0,0,0
2021-11-17 19:15,77,42,35,0,0,0
2021-11-17 19:30,67,33,34,0,0,0
2021-11-17 19:45,70,26,44,0,0,0
2021-11-17 20:00,64,29,35,0,0,0
2021-11-17 20:15,64,33,31,0,0,0
2021-11-17 20:30,35,14,21,0,0,0
2021-11-17 20:45,33,15,18,0,0,0
2021-11-17 21:00,44,18,26,0,0,0
2021-11-17 21:15,40,10,30,0,0,0
2021-11-17 21:30,27,11,16,0,0,0
2021-11-17 21:45,40,11,29,0,0,0
2021-11-17 22:00,33,9,24,0,0,0
2021-11-17 22:15,27,6,21,0,0,0
2021-11-17 22:30,25,6,19,0,0,0
2021-11-17 22:45,18,7,11,0,0,0
2021-11-17 23:00,15,1,14,0,0,0
2021-11-17 23:15,12,8,4,0,0,0
2021-11-17 23:30,8,1,7,0,0,0
2021-11-17 23:45,10,5,5,0,0,0
2021-11-18 00:00,7,3,4,0,0,0
2021-11-18 00:15,7,2,5,0,0,0
2021-11-18 00:30,2,0,2,0,0,0
2021-11-18 00:45,9,3,6,0,0,0
2021-11-18 01:00,3,0,3,0,0,0
2021-11-18 01:15,4,3,1,0,0,0
2021-11-18 01:30,5,0,5,0,0,0
2021-11-18 01:45,7,3,4,0,0,0
2021-11-18 02:00,2,0,2,0,0,0
2021-11-18 02:15,6,2,4,0,0,0
2021-11-18 02:30,5,1,4,0,0,0
2021-11-18 02:45,3,0,3,0,0,0
2021-11-18 03:00,6,0,6,0,0,0
2021-11-18 03:15,4,0,4,0,0,0
2021-11-18 03:30,1,0,1,0,0,0
2021-11-18 03:45,5,2,3,0,0,0
2021-11-18 04:00,2,0,2,0,0,0
2021-11-18 04:15,2,0,2,0,0,0
2021-11-18 04:30,1,0,1,0,0,0
2021-11-18 04:45,3,2,1,0,0,0
2021-11-18 05:00,0,0,0,0,0,0
2021-11-18 05:15,2,0,2,0,0,0
2021-11-18 05:30,9,4,5,0,0,0
2021-11-18 05:45,12,5,7,0,0,0
2021-11-18 06:00,7,4,3,0,0,0
2021-11-18 06:15,23,11,12,0,0,0
2021-11-18 06:30,31,16,15,0,0,0
2021-11-18 06:45,46,15,31,0,0,0
2021-11-18 07:00,65,24,41,0,0,0
2021-11-18 07:15,99,31,68,0,0,0
2021-11-18 07:30,142,56,86,0,0,0
2021-11-18 07:45,261,120,141,0,0,0
2021-11-18 08:00,312,162,150,0,0,0
2021-11-18 08:15,150,62,88,0,0,0
2021-11-18 08:30,124,59,65,0,0,0
2021-11-18 08:45,163,91,72,0,0,0
2021-11-18 09:00,94,47,47,0,0,0
2021-11-18 09:15,67,28,39,0,0,0
2021-11-18 09:30,92,43,49,0,0,0
2021-11-18 09:45,163,90,73,0,0,0
2021-11-18 10:00,280,128,152,0,0,0
2021-11-18 10:15,74,39,35,0,0,0
2021-11-18 10:30,66,41,25,0,0,0
2021-11-18 10:45,91,37,54,0,0,0
2021-11-18 11:00,61,28,33,0,0,0
2021-11-18 11:15,72,41,31,0,0,0
2021-11-18 11:30,95,49,46,0,0,0
2021-11-18 11:45,213,85,128,0,0,0
2021-11-18 12:00,172,93,79,0,0,0
2021-11-18 12:15,130,59,71,0,0,0
2021-11-18 12:30,94,40,54,0,0,0
2021-11-18 12:45,161,75,86,0,0,0
2021-11-18 13:00,100,41,59,0,0,0
2021-11-18 13:15,113,40,73,0,0,0
2021-11-18 13:30,181,52,129,0,0,0
2021-11-18 13:45,217,99,118,0,0,0
2021-11-18 14:00,210,92,118,0,0,0
2021-11-18 14:15,112,48,64,0,0,0
2021-11-18 14:30,120,51,69,0,0,0
2021-11-18 14:45,119,68,51,0,0,0
2021-11-18 15:00,107,55,52,0,0,0
2021-11-18 15:15,104,63,41,0,0,0
2021-11-18 15:30,183,83,100,0,0,0
2021-11-18 15:45,253,153,100,0,0,0
2021-11-18 16:00,180,106,74,0,0,0
2021-11-18 16:15,133,72,61,0,0,0
2021-11-18 16:30,154,92,62,0,0,0
2021-11-18 16:45,157,86,71,0,0,0
2021-11-18 17:00,142,81,61,0,0,0
2021-11-18 17:15,132,64,68,0,0,0
2021-11-18 17:30,121,67,54,0,0,0
2021-11-18 17:45,179,95,84,0,0,0
2021-11-18 18:00,132,81,51,0,0,0
2021-11-18 18:15,97,48,49,0,0,0
2021-11-18 18:30,99,53,46,0,0,0
2021-11-18 18:45,101,59,42,0,0,0
2021-11-18 19:00,61,26,35,0,0,0
2021-11-18 19:15,67,34,33,0,0,0
2021-11-18 19:30,74,23,51,0,0,0
2021-11-18 19:45,57,25,32,0,0,0
2021-11-18 20:00,46,27,19,0,0,0
2021-11-18 20:15,48,23,25,0,0,0
2021-11-18 20:30,40,19,21,0,0,0
2021-11-18 20:45,46,28,18,0,0,0
2021-11-18 21:00,33,21,12,0,0,0
2021-11-18 21:15,27,10,17,0,0,0
2021-11-18 21:30,24,11,13,0,0,0
2021-11-18 21:45,39,11,28,0,0,0
2021-11-18 22:00,18,5,13,0,0,0
2021-11-18 22:15,24,8,16,0,0,0
2021-11-18 22:30,27,13,14,0,0,0
2021-11-18 22:45,16,7,9,0,0,0
2021-11-18 23:00,25,2,23,0,0,0
2021-11-18 23:15,11,3,8,0,0,0
2021-11-18 23:30,14,4,10,0,0,0
2021-11-18 23:45,21,3,18,0,0,0
2021-11-19 00:00,7,4,3,0,0,0
2021-11-19 00:15,5,2,3,0,0,0
2021-11-19 00:30,6,3,3,0,0,0
2021-11-19 00:45,4,1,3,0,0,0
2021-11-19 01:00,7,3,4,0,0,0
2021-11-19 01:15,5,2,3,0,0,0
2021-11-19 01:30,7,0,7,0,0,0
2021-11-19 01:45,4,0,4,0,0,0
2021-11-19 02:00,6,1,5,0,0,0
2021-11-19 02:15,7,1,6,0,0,0
2021-11-19 02:30,5,1,4,0,0,0
2021-11-19 02:45,1,0,1,0,0,0
2021-11-19 03:00,0,0,0,0,0,0
2021-11-19 03:15,0,0,0,0,0,0
2021-11-19 03:30,5,0,5,0,0,0
2021-11-19 03:45,1,0,1,0,0,0
2021-11-19 04:00,3,0,3,0,0,0
2021-11-19 04:15,4,0,4,0,0,0
2021-11-19 04:30,6,1,5,0,0,0
2021-11-19 04:45,5,2,3,0,0,0
2021-11-19 05:00,1,1,0,0,0,0
2021-11-19 05:15,0,0,0,0,0,0
2021-11-19 05:30,9,3,6,0,0,0
2021-11-19 05:45,7,3,4,0,0,0
2021-11-19 06:00,5,2,3,0,0,0
2021-11-19 06:15,17,4,13,0,0,0
2021-11-19 06:30,25,15,10,0,0,0
2021-11-19 06:45,33,10,23,0,0,0
2021-11-19 07:00,48,12,36,0,0,0
2021-11-19 07:15,59,25,34,0,0,0
2021-11-19 07:30,85,46,39,0,0,0
2021-11-19 07:45,242,116,126,0,0,0
2021-11-19 08:00,301,156,145,0,0,0
2021-11-19 08:15,122,51,71,0,0,0
2021-11-19 08:30,85,34,51,0,0,0
2021-11-19 08:45,98,38,60,0,0,0
2021-11-19 09:00,84,43,41,0,0,0
2021-11-19 09:15,57,25,32,0,0,0
2021-11-19 09:30,59,27,32,0,0,0
2021-11-19 09:45,189,84,105,0,0,0
2021-11-19 10:00,125,69,56,0,0,0
2021-11-19 10:15,48,29,19,0,0,0
2021-11-19 10:30,70,32,38,0,0,0
2021-11-19 10:45,60,32,28,0,0,0
2021-11-19 11:00,73,40,33,0,0,0
2021-11-19 11:15,50,28,22,0,0,0
2021-11-19 11:30,102,67,35,0,0,0
2021-11-19 11:45,118,62,56,0,0,0
2021-11-19 12:00,130,70,60,0,0,0
2021-11-19 12:15,105,56,49,0,0,0
2021-11-19 12:30,88,49,39,0,0,0
2021-11-19 12:45,123,47,76,0,0,0
2021-11-19 13:00,107,54,53,0,0,0
2021-11-19 13:15,95,44,51,0,0,0
2021-11-19 13:30,154,41,113,0,0,0
2021-11-19 13:45,117,54,63,0,0,0
2021-11-19 14:00,125,52,73,0,0,0
2021-11-19 14:15,108,43,65,0,0,0
2021-11-19 14:30,125,67,58,0,0,0
2021-11-19 14:45,137,73,64,0,0,0
2021-11-19 15:00,118,61,57,0,0,0
2021-11-19 15:15,123,61,62,0,0,0
2021-11-19 15:30,120,58,62,0,0,0
2021-11-19 15:45,145,80,65,0,0,0
2021-11-19 16:00,106,61,45,0,0,0
2021-11-19 16:15,87,39,48,0,0,0
2021-11-19 16:30,115,70,45,0,0,0
2021-11-19 16:45,116,60,56,0,0,0
2021-11-19 17:00,93,54,39,0,0,0
2021-11-19 17:15,106,65,41,0,0,0
2021-11-19 17:30,90,55,35,0,0,0
2021-11-19 17:45,74,41,33,0,0,0
2021-11-19 18:00,83,47,36,0,0,0
2021-11-19 18:15,78,36,42,0,0,0
2021-11-19 18:30,72,29,43,0,0,0
2021-11-19 18:45,63,27,36,0,0,0
2021-11-19 19:00,77,34,43,0,0,0
2021-11-19 19:15,54,25,29,0,0,0
2021-11-19 19:30,52,25,27,0,0,0
2021-11-19 19:45,32,15,17,0,0,0
2021-11-19 20:00,45,25,20,0,0,0
2021-11-19 20:15,30,16,14,0,0,0
2021-11-19 20:30,21,10,11,0,0,0
2021-11-19 20:45,29,19,10,0,0,0
2021-11-19 21:00,22,12,10,0,0,0
2021-11-19 21:15,31,18,13,0,0,0
2021-11-19 21:30,23,7,16,0,0,0
2021-11-19 21:45,20,11,9,0,0,0
2021-11-19 22:00,22,10,12,0,0,0
2021-11-19 22:15,20,8,12,0,0,0
2021-11-19 22:30,20,11,9,0,0,0
2021-11-19 22:45,23,3,20,0,0,0
2021-11-19 23:00,23,5,18,0,0,0
2021-11-19 23:15,15,2,13,0,0,0
2021-11-19 23:30,10,7,3,0,0,0
2021-11-19 23:45,15,9,6,0,0,0
2021-11-20 00:00,25,8,17,0,0,0
2021-11-20 00:15,19,4,15,0,0,0
2021-11-20 00:30,20,3,17,0,0,0
2021-11-20 00:45,16,2,14,0,0,0
2021-11-20 01:00,7,4,3,0,0,0
2021-11-20 01:15,16,6,10,0,0,0
2021-11-20 01:30,12,0,12,0,0,0
2021-11-20 01:45,13,5,8,0,0,0
2021-11-20 02:00,11,2,9,0,0,0
2021-11-20 02:15,6,4,2,0,0,0
2021-11-20 02:30,8,2,6,0,0,0
2021-11-20 02:45,5,0,5,0,0,0
2021-11-20 03:00,8,2,6,0,0,0
2021-11-20 03:15,2,0,2,0,0,0
2021-11-20 03:30,5,1,4,0,0,0
2021-11-20 03:45,3,0,3,0,0,0
2021-11-20 04:00,6,1,5,0,0,0
2021-11-20 04:15,4,1,3,0,0,0
2021-11-20 04:30,3,1,2,0,0,0
2021-11-20 04:45,3,0,3,0,0,0
2021-11-20 05:00,1,1,0,0,0,0
2021-11-20 05:15,6,3,3,0,0,0
2021-11-20 05:30,4,0,4,0,0,0
2021-11-20 05:45,3,1,2,0,0,0
2021-11-20 06:00,2,1,1,0,0,0
2021-11-20 06:15,1,1,0,0,0,0
2021-11-20 06:30,3,2,1,0,0,0
2021-11-20 06:45,13,7,6,0,0,0
2021-11-20 07:00,6,4,2,0,0,0
2021-11-20 07:15,3,2,1,0,0,0
2021-11-20 07:30,10,8,2,0,0,0
2021-11-20 07:45,18,9,9,0,0,0
2021-11-20 08:00,21,11,10,0,0,0
2021-11-20 08:15,20,12,8,0,0,0
2021-11-20 08:30,21,16,5,0,0,0
2021-11-20 08:45,54,39,15,0,0,0
2021-11-20 09:00,34,25,9,0,0,0
2021-11-20 09:15,42,26,16,0,0,0
2021-11-20 09:30,40,32,8,0,0,0
2021-11-20 09:45,79,59,20,0,0,0
2021-11-20 10:00,52,38,14,0,0,0
2021-11-20 10:15,77,56,21,0,0,0
2021-11-20 10:30,77,54,23,0,0,0
2021-11-20 10:45,100,66,34,0,0,0
2021-11-20 11:00,65,38,27,0,0,0
2021-11-20 11:15,84,58,26,0,0,0
2021-11-20 11:30,88,51,37,0,0,0
2021-11-20 11:45,84,47,37,0,0,0
2021-11-20 12:00,92,52,40,0,0,0
2021-11-20 12:15,105,54,51,0,0,0
2021-11-20 12:30,69,24,45,0,0,0
2021-11-20 12:45,86,55,31,0,0,0
2021-11-20 13:00,60,23,37,0,0,0
2021-11-20 13:15,83,38,45,0,0,0
2021-11-20 13:30,74,31,43,0,0,0
2021-11-20 13:45,74,30,44,0,0,0
2021-11-20 14:00,56,22,34,0,0,0
2021-11-20 14:15,73,28,45,0,0,0
2021-11-20 14:30,55,19,36,0,0,0
2021-11-20 14:45,44,13,31,0,0,0
2021-11-20 15:00,72,31,41,0,0,0
2021-11-20 15:15,51,13,38,0,0,0
2021-11-20 15:30,60,27,33,0,0,0
2021-11-20 15:45,81,29,52,0,0,0
2021-11-20 16:00,73,26,47,0,0,0
2021-11-20 16:15,54,19,35,0,0,0
2021-11-20 16:30,42,16,26,0,0,0
2021-11-20 16:45,47,19,28,0,0,0
2021-11-20 17:00,60,23,37,0,0,0
2021-11-20 17:15,52,17,35,0,0,0
2021-11-20 17:30,35,18,17,0,0,0
2021-11-20 17:45,43,22,21,0,0,0
2021-11-20 18:00,66,32,34,0,0,0
2021-11-20 18:15,45,15,30,0,0,0
2021-11-20 18:30,37,16,21,0,0,0
2021-11-20 18:45,62,37,25,0,0,0
2021-11-20 19:00,44,23,21,0,0,0
2021-11-20 19:15,48,31,17,0,0,0
2021-11-20 19:30,39,24,15,0,0,0
2021-11-20 19:45,34,12,22,0,0,0
2021-11-20 20:00,23,10,13,0,0,0
2021-11-20 20:15,22,12,10,0,0,0
2021-11-20 20:30,25,13,12,0,0,0
2021-11-20 20:45,31,16,15,0,0,0
2021-11-20 21:00,34,16,18,0,0,0
2021-11-20 21:15,15,2,13,0,0,0
2021-11-20 21:30,5,4,1,0,0,0
2021-11-20 21:45,29,11,18,0,0,0
2021-11-20 22:00,18,9,9,0,0,0
2021-11-20 22:15,26,8,18,0,0,0
2021-11-20 22:30,14,8,6,0,0,0
2021-11-20 22:45,16,5,11,0,0,0
2021-11-20 23:00,22,7,15,0,0,0
2021-11-20 23:15,17,3,14,0,0,0
2021-11-20 23:30,25,13,12,0,0,0
2021-11-20 23:45,19,2,17,0,0,0
2021-11-21 00:00,24,8,16,0,0,0
2021-11-21 00:15,21,2,19,0,0,0
2021-11-21 00:30,16,10,6,0,0,0
2021-11-21 00:45,11,7,4,0,0,0
2021-11-21 01:00,10,1,9,0,0,0
2021-11-21 01:15,16,12,4,0,0,0
2021-11-21 01:30,14,4,10,0,0,0
2021-11-21 01:45,15,11,4,0,0,0
2021-11-21 02:00,4,2,2,0,0,0
2021-11-21 02:15,11,3,8,0,0,0
2021-11-21 02:30,7,2,5,0,0,0
2021-11-21 02:45,9,1,8,0,0,0
2021-11-21 03:00,7,3,4,0,0,0
2021-11-21 03:15,4,3,1,0,0,0
2021-11-21 03:30,8,3,5,0,0,0
2021-11-21 03:45,9,4,5,0,0,0
2021-11-21 04:00,8,3,5,0,0,0
2021-11-21 04:15,0,0,0,0,0,0
2021-11-21 04:30,7,3,4,0,0,0
2021-11-21 04:45,14,5,9,0,0,0
2021-11-21 05:00,2,0,2,0,0,0
2021-11-21 05:15,5,0,5,0,0,0
2021-11-21 05:30,7,0,7,0,0,0
2021-11-21 05:45,1,0,1,0,0,0
2021-11-21 06:00,2,2,0,0,0,0
2021-11-21 06:15,6,0,6,0,0,0
2021-11-21 06:30,6,3,3,0,0,0
2021-11-21 06:45,5,2,3,0,0,0
2021-11-21 07:00,2,2,0,0,0,0
2021-11-21 07:15,4,2,2,0,0,0
2021-11-21 07:30,2,1,1,0,0,0
2021-11-21 07:45,9,2,7,0,0,0
2021-11-21 08:00,2,2,0,0,0,0
2021-11-21 08:15,9,0,9,0,0,0
2021-11-21 08:30,16,9,7,0,0,0
2021-11-21 08:45,13,11,2,0,0,0
2021-11-21 09:00,7,5,2,0,0,0
2021-11-21 09:15,11,7,4,0,0,0
2021-11-21 09:30,15,7,8,0,0,0
2021-11-21 09:45,15,12,3,0,0,0
2021-11-21 10:00,14,7,7,0,0,0
2021-11-21 10:15,12,8,4,0,0,0
2021-11-21 10:30,14,5,9,0,0,0
2021-11-21 10:45,32,18,14,0,0,0
2021-11-21 11:00,21,13,8,0,0,0
2021-11-21 11:15,18,10,8,0,0,0
2021-11-21 11:30,20,13,7,0,0,0
2021-11-21 11:45,21,15,6,0,0,0
2021-11-21 12:00,23,10,13,0,0,0
2021-11-21 12:15,36,22,14,0,0,0
2021-11-21 12:30,33,16,17,0,0,0
2021-11-21 12:45,36,22,14,0,0,0
2021-11-21 13:00,17,7,10,0,0,0
2021-11-21 13:15,33,10,23,0,0,0
2021-11-21 13:30,34,18,16,0,0,0
2021-11-21 13:45,46,24,22,0,0,0
2021-11-21 14:00,53,26,27,0,0,0
2021-11-21 14:15,51,29,22,0,0,0
2021-11-21 14:30,37,20,17,0,0,0
2021-11-21 14:45,49,24,25,0,0,0
2021-11-21 15:00,32,20,12,0,0,0
2021-11-21 15:15,42,20,22,0,0,0
2021-11-21 15:30,63,33,30,0,0,0
2021-11-21 15:45,48,19,29,0,0,0
2021-11-21 16:00,55,29,26,0,0,0
2021-11-21 16:15,37,15,22,0,0,0
2021-11-21 16:30,45,13,32,0,0,0
2021-11-21 16:45,47,11,36,0,0,0
2021-11-21 17:00,50,14,36,0,0,0
2021-11-21 17:15,23,12,11,0,0,0
2021-11-21 17:30,40,27,13,0,0,0
2021-11-21 17:45,38,17,21,0,0,0
2021-11-21 18:00,39,23,16,0,0,0
2021-11-21 18:15,31,6,25,0,0,0
2021-11-21 18:30,27,11,16,0,0,0
2021-11-21 18:45,37,17,20,0,0,0
2021-11-21 19:00,17,8,9,0,0,0
2021-11-21 19:15,28,14,14,0,0,0
2021-11-21 19:30,19,9,10,0,0,0
2021-11-21 19:45,22,10,12,0,0,0
2021-11-21 20:00,21,5,16,0,0,0
2021-11-21 20:15,20,8,12,0,0,0
2021-11-21 20:30,34,12,22,0,0,0
2021-11-21 20:45,14,4,10,0,0,0
2021-11-21 21:00,20,7,13,0,0,0
2021-11-21 21:15,9,2,7,0,0,0
2021-11-21 21:30,10,0,10,0,0,0
2021-11-21 21:45,14,2,12,0,0,0
2021-11-21 22:00,15,2,13,0,0,0
2021-11-21 22:15,3,1,2,0,0,0
2021-11-21 22:30,5,1,4,0,0,0
2021-11-21 22:45,12,4,8,0,0,0
2021-11-21 23:00,4,1,3,0,0,0
2021-11-21 23:15,7,1,6,0,0,0
2021-11-21 23:30,3,2,1,0,0,0
2021-11-21 23:45,1,0,1,0,0,0
2021-11-22 00:00,0,0,0,0,0,0
2021-11-22 00:15,3,1,2,0,0,0
2021-11-22 00:30,0,0,0,0,0,0
2021-11-22 00:45,1,1,0,0,0,0
2021-11-22 01:00,5,3,2,0,0,0
2021-11-22 01:15,2,1,1,0,0,0
2021-11-22 01:30,0,0,0,0,0,0
2021-11-22 01:45,0,0,0,0,0,0
2021-11-22 02:00,2,2,0,0,0,0
2021-11-22 02:15,1,0,1,0,0,0
2021-11-22 02:30,0,0,0,0,0,0
2021-11-22 02:45,0,0,0,0,0,0
2021-11-22 03:00,1,0,1,0,0,0
2021-11-22 03:15,0,0,0,0,0,0
2021-11-22 03:30,0,0,0,0,0,0
2021-11-22 03:45,0,0,0,0,0,0
2021-11-22 04:00,0,0,0,0,0,0
2021-11-22 04:15,1,0,1,0,0,0
2021-11-22 04:30,0,0,0,0,0,0
2021-11-22 04:45,0,0,0,0,0,0
2021-11-22 05:00,2,0,2,0,0,0
2021-11-22 05:15,3,1,2,0,0,0
2021-11-22 05:30,10,7,3,0,0,0
2021-11-22 05:45,14,4,10,0,0,0
2021-11-22 06:00,5,2,3,0,0,0
2021-11-22 06:15,19,7,12,0,0,0
2021-11-22 06:30,54,18,36,0,0,0
2021-11-22 06:45,57,22,35,0,0,0
2021-11-22 07:00,56,19,37,0,0,0
2021-11-22 07:15,73,22,51,0,0,0
2021-11-22 07:30,138,66,72,0,0,0
2021-11-22 07:45,263,121,142,0,0,0
2021-11-22 08:00,306,177,129,0,0,0
2021-11-22 08:15,134,52,82,0,0,0
2021-11-22 08:30,100,50,50,0,0,0
2021-11-22 08:45,136,48,88,0,0,0
2021-11-22 09:00,98,42,56,0,0,0
2021-11-22 09:15,76,33,43,0,0,0
2021-11-22 09:30,85,47,38,0,0,0
2021-11-22 09:45,162,77,85,0,0,0
2021-11-22 10:00,236,110,126,0,0,0
2021-11-22 10:15,67,28,39,0,0,0
2021-11-22 10:30,75,39,36,0,0,0
2021-11-22 10:45,90,49,41,0,0,0
2021-11-22 11:00,78,39,39,0,0,0
2021-11-22 11:15,71,34,37,0,0,0
2021-11-22 11:30,134,56,78,0,0,0
2021-11-22 11:45,171,68,103,0,0,0
2021-11-22 12:00,215,97,118,0,0,0
2021-11-22 12:15,123,46,77,0,0,0
2021-11-22 12:30,108,38,70,0,0,0
2021-11-22 12:45,148,55,93,0,0,0
2021-11-22 13:00,91,42,49,0,0,0
2021-11-22 13:15,98,44,54,0,0,0
2021-11-22 13:30,167,41,126,0,0,0
2021-11-22 13:45,206,84,122,0,0,0
2021-11-22 14:00,187,78,109,0,0,0
2021-11-22 14:15,99,47,52,0,0,0
2021-11-22 14:30,136,52,84,0,0,0
2021-11-22 14:45,108,44,64,0,0,0
2021-11-22 15:00,129,63,66,0,0,0
2021-11-22 15:15,119,68,51,0,0,0
2021-11-22 15:30,151,83,68,0,0,0
2021-11-22 15:45,216,109,107,0,0,0
2021-11-22 16:00,206,107,99,0,0,0
2021-11-22 16:15,180,103,77,0,0,0
2021-11-22 16:30,122,74,48,0,0,0
2021-11-22 16:45,151,86,65,0,0,0
2021-11-22 17:00,148,100,48,0,0,0
2021-11-22 17:15,149,75,74,0,0,0
2021-11-22 17:30,154,84,70,0,0,0
2021-11-22 17:45,220,127,93,0,0,0
2021-11-22 18:00,170,94,76,0,0,0
2021-11-22 18:15,121,57,64,0,0,0
2021-11-22 18:30,93,41,52,0,0,0
2021-11-22 18:45,103,41,62,0,0,0
2021-11-22 19:00,80,43,37,0,0,0
2021-11-22 19:15,69,24,45,0,0,0
2021-11-22 19:30,89,35,54,0,0,0
2021-11-22 19:45,77,24,53,0,0,0
2021-11-22 20:00,57,10,47,0,0,0
2021-11-22 20:15,66,7,59,0,0,0
2021-11-22 20:30,54,7,47,0,0,0
2021-11-22 20:45,29,10,19,0,0,0
2021-11-22 21:00,33,15,18,0,0,0
2021-11-22 21:15,30,12,18,0,0,0
2021-11-22 21:30,26,7,19,0,0,0
2021-11-22 21:45,22,5,17,0,0,0
2021-11-22 22:00,22,6,16,0,0,0
2021-11-22 22:15,11,2,9,0,0,0
2021-11-22 22:30,28,11,17,0,0,0
2021-11-22 22:45,11,4,7,0,0,0
2021-11-22 23:00,13,3,10,0,0,0
2021-11-22 23:15,13,5,8,0,0,0
2021-11-22 23:30,10,3,7,0,0,0
2021-11-22 23:45,17,4,13,0,0,0
2021-11-23 00:00,7,2,5,0,0,0
2021-11-23 00:15,6,3,3,0,0,0
2021-11-23 00:30,2,2,0,0,0,0
2021-11-23 00:45,3,2,1,0,0,0
2021-11-23 01:00,1,1,0,0,0,0
2021-11-23 01:15,1,0,1,0,0,0
2021-11-23 01:30,1,0,1,0,0,0
2021-11-23 01:45,3,1,2,0,0,0
2021-11-23 02:00,1,1,0,0,0,0
2021-11-23 02:15,0,0,0,0,0,0
2021-11-23 02:30,0,0,0,0,0,0
2021-11-23 02:45,0,0,0,0,0,0
2021-11-23 03:00,1,1,0,0,0,0
2021-11-23 03:15,0,0,0,0,0,0
2021-11-23 03:30,0,0,0,0,0,0
2021-11-23 03:45,0,0,0,0,0,0
2021-11-23 04:00,1,1,0,0,0,0
2021-11-23 04:15,1,0,1,0,0,0
2021-11-23 04:30,0,0,0,0,0,0
2021-11-23 04:45,0,0,0,0,0,0
2021-11-23 05:00,3,0,3,0,0,0
2021-11-23 05:15,2,0,2,0,0,0
2021-11-23 05:30,9,3,6,0,0,0
2021-11-23 05:45,7,4,3,0,0,0
2021-11-23 06:00,8,4,4,0,0,0
2021-11-23 06:15,21,6,15,0,0,0
2021-11-23 06:30,30,10,20,0,0,0
2021-11-23 06:45,41,16,25,0,0,0
2021-11-23 07:00,64,19,45,0,0,0
2021-11-23 07:15,73,26,47,0,0,0
2021-11-23 07:30,130,63,67,0,0,0
2021-11-23 07:45,263,107,156,0,0,0
2021-11-23 08:00,328,162,166,0,0,0
2021-11-23 08:15,162,71,91,0,0,0
2021-11-23 08:30,116,49,67,0,0,0
2021-11-23 08:45,126,48,78,0,0,0
2021-11-23 09:00,79,30,49,0,0,0
2021-11-23 09:15,64,30,34,0,0,0
2021-11-23 09:30,73,31,42,0,0,0
2021-11-23 09:45,191,108,83,0,0,0
2021-11-23 10:00,227,97,130,0,0,0
2021-11-23 10:15,65,34,31,0,0,0
2021-11-23 10:30,59,37,22,0,0,0
2021-11-23 10:45,72,44,28,0,0,0
2021-11-23 11:00,53,14,39,0,0,0
2021-11-23 11:15,60,30,30,0,0,0
2021-11-23 11:30,77,32,45,0,0,0
2021-11-23 11:45,181,71,110,0,0,0
2021-11-23 12:00,181,89,92,0,0,0
2021-11-23 12:15,119,48,71,0,0,0
2021-11-23 12:30,106,40,66,0,0,0
2021-11-23 12:45,104,44,60,0,0,0
2021-11-23 13:00,101,45,56,0,0,0
2021-11-23 13:15,98,35,63,0,0,0
2021-11-23 13:30,173,47,126,0,0,0
2021-11-23 13:45,207,84,123,0,0,0
2021-11-23 14:00,170,70,100,0,0,0
2021-11-23 14:15,123,50,73,0,0,0
2021-11-23 14:30,140,45,95,0,0,0
2021-11-23 14:45,113,59,54,0,0,0
2021-11-23 15:00,121,73,48,0,0,0
2021-11-23 15:15,94,42,52,0,0,0
2021-11-23 15:30,122,67,55,0,0,0
2021-11-23 15:45,235,129,106,0,0,0
2021-11-23 16:00,212,131,81,0,0,0
2021-11-23 16:15,119,59,60,0,0,0
2021-11-23 16:30,153,80,73,0,0,0
2021-11-23 16:45,163,107,56,0,0,0
2021-11-23 17:00,147,95,52,0,0,0
2021-11-23 17:15,149,106,43,0,0,0
2021-11-23 17:30,110,54,56,0,0,0
2021-11-23 17:45,192,104,88,0,0,0
2021-11-23 18:00,162,83,79,0,0,0
2021-11-23 18:15,118,68,50,0,0,0
2021-11-23 18:30,116,57,59,0,0,0
2021-11-23 18:45,101,45,56,0,0,0
2021-11-23 19:00,69,33,36,0,0,0
2021-11-23 19:15,81,36,45,0,0,0
2021-11-23 19:30,58,25,33,0,0,0
2021-11-23 19:45,93,35,58,0,0,0
2021-11-23 20:00,61,17,44,0,0,0
2021-11-23 20:15,70,17,53,0,0,0
2021-11-23 20:30,40,14,26,0,0,0
2021-11-23 20:45,44,15,29,0,0,0
2021-11-23 21:00,35,12,23,0,0,0
2021-11-23 21:15,33,15,18,0,0,0
2021-11-23 21:30,30,14,16,0,0,0
2021-11-23 21:45,21,5,16,0,0,0
2021-11-23 22:00,39,12,27,0,0,0
2021-11-23 22:15,28,6,22,0,0,0
2021-11-23 22:30,16,3,13,0,0,0
2021-11-23 22:45,18,1,17,0,0,0
2021-11-23 23:00,12,4,8,0,0,0
2021-11-23 23:15,5,0,5,0,0,0
2021-11-23 23:30,9,0,9,0,0,0
2021-11-23 23:45,7,3,4,0,0,0
2021-11-24 00:00,1,0,1,0,0,0
2021-11-24 00:15,5,2,3,0,0,0
2021-11-24 00:30,3,1,2,0,0,0
2021-11-24 00:45,1,0,1,0,0,0
2021-11-24 01:00,3,2,1,0,0,0
2021-11-24 01:15,2,0,2,0,0,0
2021-11-24 01:30,2,0,2,0,0,0
2021-11-24 01:45,0,0,0,0,0,0
2021-11-24 02:00,2,0,2,0,0,0
2021-11-24 02:15,0,0,0,0,0,0
2021-11-24 02:30,0,0,0,0,0,0
2021-11-24 02:45,1,0,1,0,0,0
2021-11-24 03:00,3,0,3,0,0,0
2021-11-24 03:15,1,1,0,0,0,0
2021-11-24 03:30,1,0,1,0,0,0
2021-11-24 03:45,0,0,0,0,0,0
2021-11-24 04:00,0,0,0,0,0,0
2021-11-24 04:15,1,0,1,0,0,0
2021-11-24 04:30,1,0,1,0,0,0
2021-11-24 04:45,1,0,1,0,0,0
2021-11-24 05:00,0,0,0,0,0,0
2021-11-24 05:15,2,0,2,0,0,0
2021-11-24 05:30,11,5,6,0,0,0
2021-11-24 05:45,7,5,2,0,0,0
2021-11-24 06:00,3,1,2,0,0,0
2021-11-24 06:15,21,6,15,0,0,0
2021-11-24 06:30,37,17,20,0,0,0
2021-11-24 06:45,53,23,30,0,0,0
2021-11-24 07:00,55,19,36,0,0,0
2021-11-24 07:15,63,25,38,0,0,0
2021-11-24 07:30,138,53,85,0,0,0
2021-11-24 07:45,280,137,143,0,0,0
2021-11-24 08:00,371,208,163,0,0,0
2021-11-24 08:15,164,76,88,0,0,0
2021-11-24 08:30,91,48,43,0,0,0
2021-11-24 08:45,123,74,49,0,0,0
2021-11-24 09:00,111,48,63,0,0,0
2021-11-24 09:15,70,28,42,0,0,0
2021-11-24 09:30,108,47,61,0,0,0
2021-11-24 09:45,189,110,79,0,0,0
2021-11-24 10:00,245,116,129,0,0,0
2021-11-24 10:15,104,42,62,0,0,0
2021-11-24 10:30,101,59,42,0,0,0
2021-11-24 10:45,88,48,40,0,0,0
2021-11-24 11:00,86,47,39,0,0,0
2021-11-24 11:15,111,51,60,0,0,0
2021-11-24 11:30,125,67,58,0,0,0
2021-11-24 11:45,239,88,151,0,0,0
2021-11-24 12:00,221,117,104,0,0,0
2021-11-24 12:15,117,62,55,0,0,0
2021-11-24 12:30,101,46,55,0,0,0
2021-11-24 12:45,145,69,76,0,0,0
2021-11-24 13:00,162,76,86,0,0,0
2021-11-24 13:15,99,50,49,0,0,0
2021-11-24 13:30,168,52,116,0,0,0
2021-11-24 13:45,203,73,130,0,0,0
2021-11-24 14:00,186,61,125,0,0,0
2021-11-24 14:15,128,55,73,0,0,0
2021-11-24 14:30,152,59,93,0,0,0
2021-11-24 14:45,110,56,54,0,0,0
2021-11-24 15:00,112,62,50,0,0,0
2021-11-24 15:15,118,67,51,0,0,0
2021-11-24 15:30,154,86,68,0,0,0
2021-11-24 15:45,212,113,99,0,0,0
2021-11-24 16:00,236,124,112,0,0,0
2021-11-24 16:15,116,62,54,0,0,0
2021-11-24 16:30,122,66,56,0,0,0
2021-11-24 16:45,172,95,77,0,0,0
2021-11-24 17:00,135,81,54,0,0,0
2021-11-24 17:15,144,91,53,0,0,0
2021-11-24 17:30,149,79,70,0,0,0
2021-11-24 17:45,250,157,93,0,0,0
2021-11-24 18:00,178,114,64,0,0,0
2021-11-24 18:15,130,74,56,0,0,0
2021-11-24 18:30,95,46,49,0,0,0
2021-11-24 18:45,74,34,40,0,0,0
2021-11-24 19:00,81,36,45,0,0,0
2021-11-24 19:15,97,53,44,0,0,0
2021-11-24 19:30,59,20,39,0,0,0
2021-11-24 19:45,71,25,46,0,0,0
2021-11-24 20:00,90,20,70,0,0,0
2021-11-24 20:15,91,16,75,0,0,0
2021-11-24 20:30,62,15,47,0,0,0
2021-11-24 20:45,47,9,38,0,0,0
2021-11-24 21:00,44,23,21,0,0,0
2021-11-24 21:15,35,15,20,0,0,0
2021-11-24 21:30,19,3,16,0,0,0
2021-11-24 21:45,28,3,25,0,0,0
2021-11-24 22:00,27,12,15,0,0,0
2021-11-24 22:15,23,9,14,0,0,0
2021-11-24 22:30,22,8,14,0,0,0
2021-11-24 22:45,10,3,7,0,0,0
2021-11-24 23:00,20,7,13,0,0,0
2021-11-24 23:15,15,3,12,0,0,0
2021-11-24 23:30,22,1,21,0,0,0
2021-11-24 23:45,10,2,8,0,0,0
2021-11-25 00:00,7,0,7,0,0,0
2021-11-25 00:15,14,3,11,0,0,0
2021-11-25 00:30,16,4,12,0,0,0
2021-11-25 00:45,10,1,9,0,0,0
2021-11-25 01:00,11,6,5,0,0,0
2021-11-25 01:15,1,1,0,0,0,0
2021-11-25 01:30,7,0,7,0,0,0
2021-11-25 01:45,7,4,3,0,0,0
2021-11-25 02:00,2,0,2,0,0,0
2021-11-25 02:15,1,0,1,0,0,0
2021-11-25 02:30,2,1,1,0,0,0
2021-11-25 02:45,1,1,0,0,0,0
2021-11-25 03:00,1,0,1,0,0,0
2021-11-25 03:15,0,0,0,0,0,0
2021-11-25 03:30,0,0,0,0,0,0
2021-11-25 03:45,1,0,1,0,0,0
2021-11-25 04:00,0,0,0,0,0,0
2021-11-25 04:15,1,0,1,0,0,0
2021-11-25 04:30,1,0,1,0,0,0
2021-11-25 04:45,0,0,0,0,0,0
2021-11-25 05:00,0,0,0,0,0,0
2021-11-25 05:15,2,0,2,0,0,0
2021-11-25 05:30,9,2,7,0,0,0
2021-11-25 05:45,9,3,6,0,0,0
2021-11-25 06:00,7,4,3,0,0,0
2021-11-25 06:15,23,8,15,0,0,0
2021-11-25 06:30,24,10,14,0,0,0
2021-11-25 06:45,44,13,31,0,0,0
2021-11-25 07:00,55,23,32,0,0,0
2021-11-25 07:15,83,30,53,0,0,0
2021-11-25 07:30,146,56,90,0,0,0
2021-11-25 07:45,263,115,148,0,0,0
2021-11-25 08:00,319,181,138,0,0,0
2021-11-25 08:15,136,57,79,0,0,0
2021-11-25 08:30,98,45,53,0,0,0
2021-11-25 08:45,126,59,67,0,0,0
2021-11-25 09:00,98,51,47,0,0,0
2021-11-25 09:15,78,36,42,0,0,0
2021-11-25 09:30,96,54,42,0,0,0
2021-11-25 09:45,201,98,103,0,0,0
2021-11-25 10:00,226,84,142,0,0,0
2021-11-25 10:15,66,30,36,0,0,0
2021-11-25 10:30,82,31,51,0,0,0
2021-11-25 10:45,53,31,22,0,0,0
2021-11-25 11:00,80,38,42,0,0,0
2021-11-25 11:15,60,26,34,0,0,0
2021-11-25 11:30,95,47,48,0,0,0
2021-11-25 11:45,206,99,107,0,0,0
2021-11-25 12:00,182,101,81,0,0,0
2021-11-25 12:15,111,57,54,0,0,0
2021-11-25 12:30,91,27,64,0,0,0
2021-11-25 12:45,131,60,71,0,0,0
2021-11-25 13:00,108,53,55,0,0,0
2021-11-25 13:15,83,43,40,0,0,0
2021-11-25 13:30,142,45,97,0,0,0
2021-11-25 13:45,187,76,111,0,0,0
2021-11-25 14:00,142,61,81,0,0,0
2021-11-25 14:15,97,49,48,0,0,0
2021-11-25 14:30,126,44,82,0,0,0
2021-11-25 14:45,94,52,42,0,0,0
2021-11-25 15:00,108,46,62,0,0,0
2021-11-25 15:15,99,49,50,0,0,0
2021-11-25 15:30,123,60,63,0,0,0
2021-11-25 15:45,243,122,121,0,0,0
2021-11-25 16:00,217,121,96,0,0,0
2021-11-25 16:15,133,80,53,0,0,0
2021-11-25 16:30,154,94,60,0,0,0
2021-11-25 16:45,147,97,50,0,0,0
2021-11-25 17:00,120,71,49,0,0,0
2021-11-25 17:15,121,61,60,0,0,0
2021-11-25 17:30,141,77,64,0,0,0
2021-11-25 17:45,170,88,82,0,0,0
2021-11-25 18:00,164,97,67,0,0,0
2021-11-25 18:15,118,61,57,0,0,0
2021-11-25 18:30,105,47,58,0,0,0
2021-11-25 18:45,87,48,39,0,0,0
2021-11-25 19:00,96,64,32,0,0,0
2021-11-25 19:15,86,42,44,0,0,0
2021-11-25 19:30,68,19,49,0,0,0
2021-11-25 19:45,79,31,48,0,0,0
2021-11-25 20:00,82,16,66,0,0,0
2021-11-25 20:15,65,13,52,0,0,0
2021-11-25 20:30,42,7,35,0,0,0
2021-11-25 20:45,22,7,15,0,0,0
2021-11-25 21:00,30,10,20,0,0,0
2021-11-25 21:15,25,11,14,0,0,0
2021-11-25 21:30,25,7,18,0,0,0
2021-11-25 21:45,19,3,16,0,0,0
2021-11-25 22:00,37,7,30,0,0,0
2021-11-25 22:15,30,18,12,0,0,0
2021-11-25 22:30,20,5,15,0,0,0
2021-11-25 22:45,18,5,13,0,0,0
2021-11-25 23:00,14,2,12,0,0,0
2021-11-25 23:15,9,2,7,0,0,0
2021-11-25 23:30,7,1,6,0,0,0
2021-11-25 23:45,12,1,11,0,0,0
2021-11-26 00:00,9,3,6,0,0,0
2021-11-26 00:15,9,0,9,0,0,0
2021-11-26 00:30,8,2,6,0,0,0
2021-11-26 00:45,5,3,2,0,0,0
2021-11-26 01:00,6,5,1,0,0,0
2021-11-26 01:15,4,1,3,0,0,0
2021-11-26 01:30,4,2,2,0,0,0
2021-11-26 01:45,2,0,2,0,0,0
2021-11-26 02:00,0,0,0,0,0,0
2021-11-26 02:15,0,0,0,0,0,0
2021-11-26 02:30,2,2,0,0,0,0
2021-11-26 02:45,1,0,1,0,0,0
2021-11-26 03:00,0,0,0,0,0,0
2021-11-26 03:15,1,0,1,0,0,0
2021-11-26 03:30,0,0,0,0,0,0
2021-11-26 03:45,2,2,0,0,0,0
2021-11-26 04:00,1,1,0,0,0,0
2021-11-26 04:15,1,0,1,0,0,0
2021-11-26 04:30,0,0,0,0,0,0
2021-11-26 04:45,0,0,0,0,0,0
2021-11-26 05:00,0,0,0,0,0,0
2021-11-26 05:15,1,0,1,0,0,0
2021-11-26 05:30,8,1,7,0,0,0
2021-11-26 05:45,8,3,5,0,0,0
2021-11-26 06:00,4,3,1,0,0,0
2021-11-26 06:15,21,7,14,0,0,0
2021-11-26 06:30,32,14,18,0,0,0
2021-11-26 06:45,32,6,26,0,0,0
2021-11-26 07:00,39,14,25,0,0,0
2021-11-26 07:15,46,17,29,0,0,0
2021-11-26 07:30,110,50,60,0,0,0
2021-11-26 07:45,238,113,125,0,0,0
2021-11-26 08:00,274,149,125,0,0,0
2021-11-26 08:15,152,69,83,0,0,0
2021-11-26 08:30,82,38,44,0,0,0
2021-11-26 08:45,105,41,64,0,0,0
2021-11-26 09:00,76,30,46,0,0,0
2021-11-26 09:15,69,35,34,0,0,0
2021-11-26 09:30,57,30,27,0,0,0
2021-11-26 09:45,133,66,67,0,0,0
2021-11-26 10:00,127,61,66,0,0,0
2021-11-26 10:15,51,28,23,0,0,0
2021-11-26 10:30,82,47,35,0,0,0
2021-11-26 10:45,66,37,29,0,0,0
2021-11-26 11:00,70,43,27,0,0,0
2021-11-26 11:15,68,45,23,0,0,0
2021-11-26 11:30,69,41,28,0,0,0
2021-11-26 11:45,111,64,47,0,0,0
2021-11-26 12:00,100,52,48,0,0,0
2021-11-26 12:15,106,46,60,0,0,0
2021-11-26 12:30,94,41,53,0,0,0
2021-11-26 12:45,99,54,45,0,0,0
2021-11-26 13:00,120,54,66,0,0,0
2021-11-26 13:15,106,40,66,0,0,0
2021-11-26 13:30,168,46,122,0,0,0
2021-11-26 13:45,162,57,105,0,0,0
2021-11-26 14:00,149,73,76,0,0,0
2021-11-26 14:15,116,53,63,0,0,0
2021-11-26 14:30,118,36,82,0,0,0
2021-11-26 14:45,97,52,45,0,0,0
2021-11-26 15:00,126,72,54,0,0,0
2021-11-26 15:15,116,64,52,0,0,0
2021-11-26 15:30,89,45,44,0,0,0
2021-11-26 15:45,107,60,47,0,0,0
2021-11-26 16:00,117,67,50,0,0,0
2021-11-26 16:15,113,76,37,0,0,0
2021-11-26 16:30,100,60,40,0,0,0
2021-11-26 16:45,102,57,45,0,0,0
2021-11-26 17:00,84,50,34,0,0,0
2021-11-26 17:15,92,60,32,0,0,0
2021-11-26 17:30,83,46,37,0,0,0
2021-11-26 17:45,87,38,49,0,0,0
2021-11-26 18:00,101,52,49,0,0,0
2021-11-26 18:15,70,30,40,0,0,0
2021-11-26 18:30,54,23,31,0,0,0
2021-11-26 18:45,69,29,40,0,0,0
2021-11-26 19:00,49,28,21,0,0,0
2021-11-26 19:15,52,27,25,0,0,0
2021-11-26 19:30,59,21,38,0,0,0
2021-11-26 19:45,41,22,19,0,0,0
2021-11-26 20:00,29,11,18,0,0,0
2021-11-26 20:15,23,6,17,0,0,0
2021-11-26 20:30,30,13,17,0,0,0
2021-11-26 20:45,26,9,17,0,0,0
2021-11-26 21:00,26,12,14,0,0,0
2021-11-26 21:15,34,13,21,0,0,0
2021-11-26 21:30,24,6,18,0,0,0
2021-11-26 21:45,21,4,17,0,0,0
2021-11-26 22:00,33,13,20,0,0,0
2021-11-26 22:15,19,6,13,0,0,0
2021-11-26 22:30,9,5,4,0,0,0
2021-11-26 22:45,20,10,10,0,0,0
2021-11-26 23:00,16,4,12,0,0,0
2021-11-26 23:15,19,4,15,0,0,0
2021-11-26 23:30,18,3,15,0,0,0
2021-11-26 23:45,16,4,12,0,0,0
2021-11-27 00:00,15,5,10,0,0,0
2021-11-27 00:15,14,3,11,0,0,0
2021-11-27 00:30,8,1,7,0,0,0
2021-11-27 00:45,14,6,8,0,0,0
2021-11-27 01:00,12,4,8,0,0,0
2021-11-27 01:15,7,0,7,0,0,0
2021-11-27 01:30,8,2,6,0,0,0
2021-11-27 01:45,7,0,7,0,0,0
2021-11-27 02:00,7,0,7,0,0,0
2021-11-27 02:15,1,1,0,0,0,0
2021-11-27 02:30,10,2,8,0,0,0
2021-11-27 02:45,8,1,7,0,0,0
2021-11-27 03:00,2,0,2,0,0,0
2021-11-27 03:15,4,2,2,0,0,0
2021-11-27 03:30,5,0,5,0,0,0
2021-11-27 03:45,2,0,2,0,0,0
2021-11-27 04:00,2,0,2,0,0,0
2021-11-27 04:15,5,2,3,0,0,0
2021-11-27 04:30,2,0,2,0,0,0
2021-11-27 04:45,3,0,3,0,0,0
2021-11-27 05:00,3,1,2,0,0,0
2021-11-27 05:15,3,0,3,0,0,0
2021-11-27 05:30,3,0,3,0,0,0
2021-11-27 05:45,6,2,4,0,0,0
2021-11-27 06:00,1,1,0,0,0,0
2021-11-27 06:15,1,0,1,0,0,0
2021-11-27 06:30,10,8,2,0,0,0
2021-11-27 06:45,10,8,2,0,0,0
2021-11-27 07:00,4,2,2,0,0,0
2021-11-27 07:15,9,6,3,0,0,0
2021-11-27 07:30,16,8,8,0,0,0
2021-11-27 07:45,12,8,4,0,0,0
2021-11-27 08:00,19,11,8,0,0,0
2021-11-27 08:15,17,13,4,0,0,0
2021-11-27 08:30,24,19,5,0,0,0
2021-11-27 08:45,49,38,11,0,0,0
2021-11-27 09:00,50,34,16,0,0,0
2021-11-27 09:15,27,16,11,0,0,0
2021-11-27 09:30,53,31,22,0,0,0
2021-11-27 09:45,62,40,22,0,0,0
2021-11-27 10:00,69,43,26,0,0,0
2021-11-27 10:15,63,45,18,0,0,0
2021-11-27 10:30,61,41,20,0,0,0
2021-11-27 10:45,64,43,21,0,0,0
2021-11-27 11:00,51,33,18,0,0,0
2021-11-27 11:15,68,38,30,0,0,0
2021-11-27 11:30,63,25,38,0,0,0
2021-11-27 11:45,84,47,37,0,0,0
2021-11-27 12:00,72,28,44,0,0,0
2021-11-27 12:15,82,51,31,0,0,0
2021-11-27 12:30,63,30,33,0,0,0
2021-11-27 12:45,77,42,35,0,0,0
2021-11-27 13:00,59,19,40,0,0,0
2021-11-27 13:15,82,41,41,0,0,0
2021-11-27 13:30,60,24,36,0,0,0
2021-11-27 13:45,65,35,30,0,0,0
2021-11-27 14:00,77,36,41,0,0,0
2021-11-27 14:15,83,32,51,0,0,0
2021-11-27 14:30,60,26,34,0,0,0
2021-11-27 14:45,59,23,36,0,0,0
2021-11-27 15:00,56,21,35,0,0,0
2021-11-27 15:15,55,23,32,0,0,0
2021-11-27 15:30,59,18,41,0,0,0
2021-11-27 15:45,73,34,39,0,0,0
2021-11-27 16:00,57,26,31,0,0,0
2021-11-27 16:15,51,27,24,0,0,0
2021-11-27 16:30,53,25,28,0,0,0
2021-11-27 16:45,64,30,34,0,0,0
2021-11-27 17:00,53,30,23,0,0,0
2021-11-27 17:15,60,30,30,0,0,0
2021-11-27 17:30,45,12,33,0,0,0
2021-11-27 17:45,54,24,30,0,0,0
2021-11-27 18:00,52,21,31,0,0,0
2021-11-27 18:15,43,23,20,0,0,0
2021-11-27 18:30,50,18,32,0,0,0
2021-11-27 18:45,45,24,21,0,0,0
2021-11-27 19:00,48,16,32,0,0,0
2021-11-27 19:15,45,26,19,0,0,0
2021-11-27 19:30,37,17,20,0,0,0
2021-11-27 19:45,53,23,30,0,0,0
2021-11-27 20:00,43,19,24,0,0,0
2021-11-27 20:15,31,8,23,0,0,0
2021-11-27 20:30,20,7,13,0,0,0
2021-11-27 20:45,21,9,12,0,0,0
2021-11-27 21:00,20,6,14,0,0,0
2021-11-27 21:15,25,3,22,0,0,0
2021-11-27 21:30,20,2,18,0,0,0
2021-11-27 21:45,34,6,28,0,0,0
2021-11-27 22:00,14,3,11,0,0,0
2021-11-27 22:15,9,4,5,0,0,0
2021-11-27 22:30,7,1,6,0,0,0
2021-11-27 22:45,11,4,7,0,0,0
2021-11-27 23:00,10,2,8,0,0,0
2021-11-27 23:15,17,7,10,0,0,0
2021-11-27 23:30,17,5,12,0,0,0
2021-11-27 23:45,8,1,7,0,0,0
2021-11-28 00:00,11,2,9,0,0,0
2021-11-28 00:15,8,3,5,0,0,0
2021-11-28 00:30,8,2,6,0,0,0
2021-11-28 00:45,11,1,10,0,0,0
2021-11-28 01:00,16,1,15,0,0,0
2021-11-28 01:15,17,8,9,0,0,0
2021-11-28 01:30,11,3,8,0,0,0
2021-11-28 01:45,12,8,4,0,0,0
2021-11-28 02:00,7,1,6,0,0,0
2021-11-28 02:15,26,8,18,0,0,0
2021-11-28 02:30,10,5,5,0,0,0
2021-11-28 02:45,6,1,5,0,0,0
2021-11-28 03:00,10,0,10,0,0,0
2021-11-28 03:15,5,1,4,0,0,0
2021-11-28 03:30,4,4,0,0,0,0
2021-11-28 03:45,1,0,1,0,0,0
2021-11-28 04:00,4,0,4,0,0,0
2021-11-28 04:15,2,1,1,0,0,0
2021-11-28 04:30,4,1,3,0,0,0
2021-11-28 04:45,0,0,0,0,0,0
2021-11-28 05:00,0,0,0,0,0,0
2021-11-28 05:15,1,1,0,0,0,0
2021-11-28 05:30,1,0,1,0,0,0
2021-11-28 05:45,2,0,2,0,0,0
2021-11-28 06:00,2,2,0,0,0,0
2021-11-28 06:15,2,0,2,0,0,0
2021-11-28 06:30,7,5,2,0,0,0
2021-11-28 06:45,4,2,2,0,0,0
2021-11-28 07:00,2,1,1,0,0,0
2021-11-28 07:15,3,0,3,0,0,0
2021-11-28 07:30,7,5,2,0,0,0
2021-11-28 07:45,8,5,3,0,0,0
2021-11-28 08:00,9,6,3,0,0,0
2021-11-28 08:15,8,1,7,0,0,0
2021-11-28 08:30,8,4,4,0,0,0
2021-11-28 08:45,19,14,5,0,0,0
2021-11-28 09:00,8,6,2,0,0,0
2021-11-28 09:15,9,4,5,0,0,0
2021-11-28 09:30,19,17,2,0,0,0
2021-11-28 09:45,15,12,3,0,0,0
2021-11-28 10:00,27,16,11,0,0,0
2021-11-28 10:15,27,14,13,0,0,0
2021-11-28 10:30,28,15,13,0,0,0
2021-11-28 10:45,40,26,14,0,0,0
2021-11-28 11:00,28,14,14,0,0,0
2021-11-28 11:15,18,8,10,0,0,0
2021-11-28 11:30,25,12,13,0,0,0
2021-11-28 11:45,31,9,22,0,0,0
2021-11-28 12:00,32,14,18,0,0,0
2021-11-28 12:15,35,13,22,0,0,0
2021-11-28 12:30,26,9,17,0,0,0
2021-11-28 12:45,35,18,17,0,0,0
2021-11-28 13:00,34,8,26,0,0,0
2021-11-28 13:15,35,15,20,0,0,0
2021-11-28 13:30,20,13,7,0,0,0
2021-11-28 13:45,41,23,18,0,0,0
2021-11-28 14:00,46,23,23,0,0,0
2021-11-28 14:15,25,12,13,0,0,0
2021-11-28 14:30,47,17,30,0,0,0
2021-11-28 14:45,37,21,16,0,0,0
2021-11-28 15:00,40,18,22,0,0,0
2021-11-28 15:15,45,34,11,0,0,0
2021-11-28 15:30,61,26,35,0,0,0
2021-11-28 15:45,73,42,31,0,0,0
2021-11-28 16:00,51,27,24,0,0,0
2021-11-28 16:15,39,26,13,0,0,0
2021-11-28 16:30,44,16,28,0,0,0
2021-11-28 16:45,46,13,33,0,0,0
2021-11-28 17:00,34,18,16,0,0,0
2021-11-28 17:15,49,28,21,0,0,0
2021-11-28 17:30,23,10,13,0,0,0
2021-11-28 17:45,43,20,23,0,0,0
2021-11-28 18:00,48,27,21,0,0,0
2021-11-28 18:15,42,18,24,0,0,0
2021-11-28 18:30,24,7,17,0,0,0
2021-11-28 18:45,30,13,17,0,0,0
2021-11-28 19:00,25,8,17,0,0,0
2021-11-28 19:15,28,6,22,0,0,0
2021-11-28 19:30,24,3,21,0,0,0
2021-11-28 19:45,32,8,24,0,0,0
2021-11-28 20:00,25,4,21,0,0,0
2021-11-28 20:15,27,6,21,0,0,0
2021-11-28 20:30,21,7,14,0,0,0
2021-11-28 20:45,11,6,5,0,0,0
2021-11-28 21:00,24,14,10,0,0,0
2021-11-28 21:15,14,4,10,0,0,0
2021-11-28 21:30,6,1,5,0,0,0
2021-11-28 21:45,6,2,4,0,0,0
2021-11-28 22:00,13,1,12,0,0,0
2021-11-28 22:15,10,3,7,0,0,0
2021-11-28 22:30,12,3,9,0,0,0
2021-11-28 22:45,13,3,10,0,0,0
2021-11-28 23:00,3,1,2,0,0,0
2021-11-28 23:15,5,0,5,0,0,0
2021-11-28 23:30,2,2,0,0,0,0
2021-11-28 23:45,5,1,4,0,0,0
2021-11-29 00:00,3,2,1,0,0,0
2021-11-29 00:15,3,0,3,0,0,0
2021-11-29 00:30,1,1,0,0,0,0
2021-11-29 00:45,4,4,0,0,0,0
2021-11-29 01:00,3,0,3,0,0,0
2021-11-29 01:15,1,1,0,0,0,0
2021-11-29 01:30,0,0,0,0,0,0
2021-11-29 01:45,1,1,0,0,0,0
2021-11-29 02:00,1,0,1,0,0,0
2021-11-29 02:15,0,0,0,0,0,0
2021-11-29 02:30,0,0,0,0,0,0
2021-11-29 02:45,0,0,0,0,0,0
2021-11-29 03:00,1,0,1,0,0,0
2021-11-29 03:15,0,0,0,0,0,0
2021-11-29 03:30,0,0,0,0,0,0
2021-11-29 03:45,0,0,0,0,0,0
2021-11-29 04:00,1,0,1,0,0,0
2021-11-29 04:15,1,0,1,0,0,0
2021-11-29 04:30,0,0,0,0,0,0
2021-11-29 04:45,0,0,0,0,0,0
2021-11-29 05:00,0,0,0,0,0,0
2021-11-29 05:15,1,1,0,0,0,0
2021-11-29 05:30,8,4,4,0,0,0
2021-11-29 05:45,4,3,1,0,0,0
2021-11-29 06:00,10,5,5,0,0,0
2021-11-29 06:15,27,9,18,0,0,0
2021-11-29 06:30,35,11,24,0,0,0
2021-11-29 06:45,44,9,35,0,0,0
2021-11-29 07:00,55,18,37,0,0,0
2021-11-29 07:15,68,27,41,0,0,0
2021-11-29 07:30,104,48,56,0,0,0
2021-11-29 07:45,234,113,121,0,0,0
2021-11-29 08:00,316,159,157,0,0,0
2021-11-29 08:15,121,40,81,0,0,0
2021-11-29 08:30,74,31,43,0,0,0
2021-11-29 08:45,111,39,72,0,0,0
2021-11-29 09:00,97,36,61,0,0,0
2021-11-29 09:15,52,26,26,0,0,0
2021-11-29 09:30,67,27,40,0,0,0
2021-11-29 09:45,173,99,74,0,0,0
2021-11-29 10:00,171,72,99,0,0,0
2021-11-29 10:15,51,24,27,0,0,0
2021-11-29 10:30,44,23,21,0,0,0
2021-11-29 10:45,64,34,30,0,0,0
2021-11-29 11:00,61,24,37,0,0,0
2021-11-29 11:15,60,35,25,0,0,0
2021-11-29 11:30,72,31,41,0,0,0
2021-11-29 11:45,163,61,102,0,0,0
2021-11-29 12:00,158,61,97,0,0,0
2021-11-29 12:15,98,38,60,0,0,0
2021-11-29 12:30,100,42,58,0,0,0
2021-11-29 12:45,135,50,85,0,0,0
2021-11-29 13:00,120,54,66,0,0,0
2021-11-29 13:15,96,47,49,0,0,0
2021-11-29 13:30,132,50,82,0,0,0
2021-11-29 13:45,150,66,84,0,0,0
2021-11-29 14:00,172,73,99,0,0,0
2021-11-29 14:15,102,39,63,0,0,0
2021-11-29 14:30,103,42,61,0,0,0
2021-11-29 14:45,106,53,53,0,0,0
2021-11-29 15:00,87,51,36,0,0,0
2021-11-29 15:15,127,74,53,0,0,0
2021-11-29 15:30,146,84,62,0,0,0
2021-11-29 15:45,240,134,106,0,0,0
2021-11-29 16:00,198,103,95,0,0,0
2021-11-29 16:15,127,79,48,0,0,0
2021-11-29 16:30,153,90,63,0,0,0
2021-11-29 16:45,132,77,55,0,0,0
2021-11-29 17:00,121,81,40,0,0,0
2021-11-29 17:15,120,72,48,0,0,0
2021-11-29 17:30,119,64,55,0,0,0
2021-11-29 17:45,186,108,78,0,0,0
2021-11-29 18:00,116,52,64,0,0,0
2021-11-29 18:15,99,51,48,0,0,0
2021-11-29 18:30,85,34,51,0,0,0
2021-11-29 18:45,83,27,56,0,0,0
2021-11-29 19:00,70,25,45,0,0,0
2021-11-29 19:15,70,26,44,0,0,0
2021-11-29 19:30,68,28,40,0,0,0
2021-11-29 19:45,57,19,38,0,0,0
2021-11-29 20:00,51,14,37,0,0,0
2021-11-29 20:15,63,12,51,0,0,0
2021-11-29 20:30,48,18,30,0,0,0
2021-11-29 20:45,17,6,11,0,0,0
2021-11-29 21:00,32,12,20,0,0,0
2021-11-29 21:15,25,8,17,0,0,0
2021-11-29 21:30,24,7,17,0,0,0
2021-11-29 21:45,20,2,18,0,0,0
2021-11-29 22:00,24,3,21,0,0,0
2021-11-29 22:15,29,6,23,0,0,0
2021-11-29 22:30,17,8,9,0,0,0
2021-11-29 22:45,16,5,11,0,0,0
2021-11-29 23:00,15,3,12,0,0,0
2021-11-29 23:15,9,5,4,0,0,0
2021-11-29 23:30,8,1,7,0,0,0
2021-11-29 23:45,9,4,5,0,0,0
