Datetime,100034982 (Hüfferstraße),101034982 (Hüfferstraße stadteinwärts),102034982 (Hüfferstraße stadtauswärts),100034982-status,101034982-status,102034982-status
2022-07-01 00:00,8,3,5,0,0,0
2022-07-01 00:15,4,0,4,0,0,0
2022-07-01 00:30,7,0,7,0,0,0
2022-07-01 00:45,3,1,2,0,0,0
2022-07-01 01:00,10,4,6,0,0,0
2022-07-01 01:15,3,0,3,0,0,0
2022-07-01 01:30,2,0,2,0,0,0
2022-07-01 01:45,7,3,4,0,0,0
2022-07-01 02:00,1,1,0,0,0,0
2022-07-01 02:15,3,1,2,0,0,0
2022-07-01 02:30,0,0,0,0,0,0
2022-07-01 02:45,2,2,0,0,0,0
2022-07-01 03:00,3,0,3,0,0,0
2022-07-01 03:15,5,0,5,0,0,0
2022-07-01 03:30,2,1,1,0,0,0
2022-07-01 03:45,2,0,2,0,0,0
2022-07-01 04:00,2,0,2,0,0,0
2022-07-01 04:15,3,0,3,0,0,0
2022-07-01 04:30,3,0,3,0,0,0
2022-07-01 04:45,2,1,1,0,0,0
2022-07-01 05:00,5,1,4,0,0,0
2022-07-01 05:15,2,1,1,0,0,0
2022-07-01 05:30,27,4,23,0,0,0
2022-07-01 05:45,12,2,10,0,0,0
2022-07-01 06:00,5,2,3,0,0,0
2022-07-01 06:15,13,2,11,0,0,0
2022-07-01 06:30,29,9,20,0,0,0
2022-07-01 06:45,35,6,29,0,0,0
2022-07-01 07:00,59,17,42,0,0,0
2022-07-01 07:15,76,20,56,0,0,0
2022-07-01 07:30,85,36,49,0,0,0
2022-07-01 07:45,148,54,94,0,0,0
2022-07-01 08:00,172,53,119,0,0,0
2022-07-01 08:15,122,43,79,0,0,0
2022-07-01 08:30,96,46,50,0,0,0
2022-07-01 08:45,133,51,82,0,0,0
2022-07-01 09:00,108,50,58,0,0,0
2022-07-01 09:15,84,36,48,0,0,0
2022-07-01 09:30,79,37,42,0,0,0
2022-07-01 09:45,143,68,75,0,0,0
2022-07-01 10:00,168,80,88,0,0,0
2022-07-01 10:15,80,47,33,0,0,0
2022-07-01 10:30,79,40,39,0,0,0
2022-07-01 10:45,85,45,40,0,0,0
2022-07-01 11:00,75,38,37,0,0,0
2022-07-01 11:15,64,35,29,0,0,0
2022-07-01 11:30,75,26,49,0,0,0
2022-07-01 11:45,127,79,48,0,0,0
2022-07-01 12:00,130,71,59,0,0,0
2022-07-01 12:15,96,54,42,0,0,0
2022-07-01 12:30,94,35,59,0,0,0
2022-07-01 12:45,105,62,43,0,0,0
2022-07-01 13:00,98,39,59,0,0,0
2022-07-01 13:15,115,46,69,0,0,0
2022-07-01 13:30,94,54,40,0,0,0
2022-07-01 13:45,142,78,64,0,0,0
2022-07-01 14:00,134,62,72,0,0,0
2022-07-01 14:15,124,71,53,0,0,0
2022-07-01 14:30,97,42,55,0,0,0
2022-07-01 14:45,105,45,60,0,0,0
2022-07-01 15:00,122,73,49,0,0,0
2022-07-01 15:15,118,69,49,0,0,0
2022-07-01 15:30,94,43,51,0,0,0
2022-07-01 15:45,128,85,43,0,0,0
2022-07-01 16:00,144,84,60,0,0,0
2022-07-01 16:15,119,73,46,0,0,0
2022-07-01 16:30,107,53,54,0,0,0
2022-07-01 16:45,106,51,55,0,0,0
2022-07-01 17:00,107,63,44,0,0,0
2022-07-01 17:15,94,46,48,0,0,0
2022-07-01 17:30,103,57,46,0,0,0
2022-07-01 17:45,100,52,48,0,0,0
2022-07-01 18:00,82,38,44,0,0,0
2022-07-01 18:15,67,40,27,0,0,0
2022-07-01 18:30,73,34,39,0,0,0
2022-07-01 18:45,93,49,44,0,0,0
2022-07-01 19:00,98,57,41,0,0,0
2022-07-01 19:15,63,32,31,0,0,0
2022-07-01 19:30,67,34,33,0,0,0
2022-07-01 19:45,66,25,41,0,0,0
2022-07-01 20:00,71,31,40,0,0,0
2022-07-01 20:15,66,26,40,0,0,0
2022-07-01 20:30,47,13,34,0,0,0
2022-07-01 20:45,48,22,26,0,0,0
2022-07-01 21:00,51,28,23,0,0,0
2022-07-01 21:15,47,11,36,0,0,0
2022-07-01 21:30,34,12,22,0,0,0
2022-07-01 21:45,38,11,27,0,0,0
2022-07-01 22:00,41,18,23,0,0,0
2022-07-01 22:15,46,8,38,0,0,0
2022-07-01 22:30,24,2,22,0,0,0
2022-07-01 22:45,30,3,27,0,0,0
2022-07-01 23:00,41,9,32,0,0,0
2022-07-01 23:15,34,6,28,0,0,0
2022-07-01 23:30,37,7,30,0,0,0
2022-07-01 23:45,31,7,24,0,0,0
2022-07-02 00:00,16,4,12,0,0,0
2022-07-02 00:15,33,6,27,0,0,0
2022-07-02 00:30,22,8,14,0,0,0
2022-07-02 00:45,25,7,18,0,0,0
2022-07-02 01:00,12,2,10,0,0,0
2022-07-02 01:15,28,16,12,0,0,0
2022-07-02 01:30,14,5,9,0,0,0
2022-07-02 01:45,14,9,5,0,0,0
2022-07-02 02:00,9,5,4,0,0,0
2022-07-02 02:15,9,5,4,0,0,0
2022-07-02 02:30,15,11,4,0,0,0
2022-07-02 02:45,4,1,3,0,0,0
2022-07-02 03:00,8,2,6,0,0,0
2022-07-02 03:15,9,1,8,0,0,0
2022-07-02 03:30,7,1,6,0,0,0
2022-07-02 03:45,8,4,4,0,0,0
2022-07-02 04:00,2,1,1,0,0,0
2022-07-02 04:15,5,3,2,0,0,0
2022-07-02 04:30,2,0,2,0,0,0
2022-07-02 04:45,0,0,0,0,0,0
2022-07-02 05:00,4,2,2,0,0,0
2022-07-02 05:15,11,8,3,0,0,0
2022-07-02 05:30,12,0,12,0,0,0
2022-07-02 05:45,9,2,7,0,0,0
2022-07-02 06:00,10,8,2,0,0,0
2022-07-02 06:15,5,2,3,0,0,0
2022-07-02 06:30,7,3,4,0,0,0
2022-07-02 06:45,24,16,8,0,0,0
2022-07-02 07:00,13,10,3,0,0,0
2022-07-02 07:15,12,12,0,0,0,0
2022-07-02 07:30,20,11,9,0,0,0
2022-07-02 07:45,27,19,8,0,0,0
2022-07-02 08:00,20,12,8,0,0,0
2022-07-02 08:15,23,12,11,0,0,0
2022-07-02 08:30,53,34,19,0,0,0
2022-07-02 08:45,40,29,11,0,0,0
2022-07-02 09:00,36,23,13,0,0,0
2022-07-02 09:15,67,43,24,0,0,0
2022-07-02 09:30,59,44,15,0,0,0
2022-07-02 09:45,94,66,28,0,0,0
2022-07-02 10:00,44,25,19,0,0,0
2022-07-02 10:15,74,41,33,0,0,0
2022-07-02 10:30,76,56,20,0,0,0
2022-07-02 10:45,98,59,39,0,0,0
2022-07-02 11:00,74,50,24,0,0,0
2022-07-02 11:15,89,43,46,0,0,0
2022-07-02 11:30,114,73,41,0,0,0
2022-07-02 11:45,106,64,42,0,0,0
2022-07-02 12:00,102,65,37,0,0,0
2022-07-02 12:15,84,59,25,0,0,0
2022-07-02 12:30,85,46,39,0,0,0
2022-07-02 12:45,83,39,44,0,0,0
2022-07-02 13:00,113,52,61,0,0,0
2022-07-02 13:15,78,37,41,0,0,0
2022-07-02 13:30,117,50,67,0,0,0
2022-07-02 13:45,94,37,57,0,0,0
2022-07-02 14:00,107,38,69,0,0,0
2022-07-02 14:15,109,41,68,0,0,0
2022-07-02 14:30,83,34,49,0,0,0
2022-07-02 14:45,96,42,54,0,0,0
2022-07-02 15:00,69,21,48,0,0,0
2022-07-02 15:15,90,51,39,0,0,0
2022-07-02 15:30,74,33,41,0,0,0
2022-07-02 15:45,91,31,60,0,0,0
2022-07-02 16:00,81,33,48,0,0,0
2022-07-02 16:15,62,24,38,0,0,0
2022-07-02 16:30,67,30,37,0,0,0
2022-07-02 16:45,78,35,43,0,0,0
2022-07-02 17:00,84,35,49,0,0,0
2022-07-02 17:15,66,33,33,0,0,0
2022-07-02 17:30,75,28,47,0,0,0
2022-07-02 17:45,63,27,36,0,0,0
2022-07-02 18:00,68,31,37,0,0,0
2022-07-02 18:15,73,21,52,0,0,0
2022-07-02 18:30,56,30,26,0,0,0
2022-07-02 18:45,75,41,34,0,0,0
2022-07-02 19:00,49,26,23,0,0,0
2022-07-02 19:15,51,24,27,0,0,0
2022-07-02 19:30,66,29,37,0,0,0
2022-07-02 19:45,69,33,36,0,0,0
2022-07-02 20:00,61,34,27,0,0,0
2022-07-02 20:15,32,16,16,0,0,0
2022-07-02 20:30,42,20,22,0,0,0
2022-07-02 20:45,44,13,31,0,0,0
2022-07-02 21:00,59,23,36,0,0,0
2022-07-02 21:15,31,8,23,0,0,0
2022-07-02 21:30,48,12,36,0,0,0
2022-07-02 21:45,35,15,20,0,0,0
2022-07-02 22:00,31,14,17,0,0,0
2022-07-02 22:15,33,11,22,0,0,0
2022-07-02 22:30,25,8,17,0,0,0
2022-07-02 22:45,26,6,20,0,0,0
2022-07-02 23:00,31,4,27,0,0,0
2022-07-02 23:15,30,11,19,0,0,0
2022-07-02 23:30,27,13,14,0,0,0
2022-07-02 23:45,13,1,12,0,0,0
2022-07-03 00:00,17,3,14,0,0,0
2022-07-03 00:15,23,3,20,0,0,0
2022-07-03 00:30,13,0,13,0,0,0
2022-07-03 00:45,24,6,18,0,0,0
2022-07-03 01:00,14,3,11,0,0,0
2022-07-03 01:15,11,0,11,0,0,0
2022-07-03 01:30,14,4,10,0,0,0
2022-07-03 01:45,1,0,1,0,0,0
2022-07-03 02:00,9,0,9,0,0,0
2022-07-03 02:15,9,6,3,0,0,0
2022-07-03 02:30,8,3,5,0,0,0
2022-07-03 02:45,0,0,0,0,0,0
2022-07-03 03:00,11,3,8,0,0,0
2022-07-03 03:15,8,0,8,0,0,0
2022-07-03 03:30,6,2,4,0,0,0
2022-07-03 03:45,7,0,7,0,0,0
2022-07-03 04:00,6,0,6,0,0,0
2022-07-03 04:15,1,0,1,0,0,0
2022-07-03 04:30,10,1,9,0,0,0
2022-07-03 04:45,3,1,2,0,0,0
2022-07-03 05:00,3,1,2,0,0,0
2022-07-03 05:15,4,0,4,0,0,0
2022-07-03 05:30,6,1,5,0,0,0
2022-07-03 05:45,9,2,7,0,0,0
2022-07-03 06:00,7,2,5,0,0,0
2022-07-03 06:15,9,6,3,0,0,0
2022-07-03 06:30,4,4,0,0,0,0
2022-07-03 06:45,10,4,6,0,0,0
2022-07-03 07:00,2,1,1,0,0,0
2022-07-03 07:15,5,1,4,0,0,0
2022-07-03 07:30,5,3,2,0,0,0
2022-07-03 07:45,15,4,11,0,0,0
2022-07-03 08:00,8,5,3,0,0,0
2022-07-03 08:15,17,12,5,0,0,0
2022-07-03 08:30,11,4,7,0,0,0
2022-07-03 08:45,17,10,7,0,0,0
2022-07-03 09:00,22,18,4,0,0,0
2022-07-03 09:15,26,9,17,0,0,0
2022-07-03 09:30,20,12,8,0,0,0
2022-07-03 09:45,18,10,8,0,0,0
2022-07-03 10:00,32,19,13,0,0,0
2022-07-03 10:15,37,19,18,0,0,0
2022-07-03 10:30,26,18,8,0,0,0
2022-07-03 10:45,44,29,15,0,0,0
2022-07-03 11:00,39,25,14,0,0,0
2022-07-03 11:15,42,21,21,0,0,0
2022-07-03 11:30,32,13,19,0,0,0
2022-07-03 11:45,35,15,20,0,0,0
2022-07-03 12:00,39,18,21,0,0,0
2022-07-03 12:15,64,28,36,0,0,0
2022-07-03 12:30,40,19,21,0,0,0
2022-07-03 12:45,53,17,36,0,0,0
2022-07-03 13:00,42,15,27,0,0,0
2022-07-03 13:15,53,21,32,0,0,0
2022-07-03 13:30,38,12,26,0,0,0
2022-07-03 13:45,66,26,40,0,0,0
2022-07-03 14:00,70,37,33,0,0,0
2022-07-03 14:15,50,24,26,0,0,0
2022-07-03 14:30,54,31,23,0,0,0
2022-07-03 14:45,63,26,37,0,0,0
2022-07-03 15:00,53,24,29,0,0,0
2022-07-03 15:15,40,25,15,0,0,0
2022-07-03 15:30,48,30,18,0,0,0
2022-07-03 15:45,44,27,17,0,0,0
2022-07-03 16:00,43,21,22,0,0,0
2022-07-03 16:15,59,26,33,0,0,0
2022-07-03 16:30,45,11,34,0,0,0
2022-07-03 16:45,80,30,50,0,0,0
2022-07-03 17:00,75,39,36,0,0,0
2022-07-03 17:15,56,20,36,0,0,0
2022-07-03 17:30,44,16,28,0,0,0
2022-07-03 17:45,66,36,30,0,0,0
2022-07-03 18:00,48,28,20,0,0,0
2022-07-03 18:15,37,10,27,0,0,0
2022-07-03 18:30,36,22,14,0,0,0
2022-07-03 18:45,42,16,26,0,0,0
2022-07-03 19:00,70,35,35,0,0,0
2022-07-03 19:15,44,22,22,0,0,0
2022-07-03 19:30,57,23,34,0,0,0
2022-07-03 19:45,54,23,31,0,0,0
2022-07-03 20:00,43,14,29,0,0,0
2022-07-03 20:15,35,13,22,0,0,0
2022-07-03 20:30,37,11,26,0,0,0
2022-07-03 20:45,36,9,27,0,0,0
2022-07-03 21:00,31,8,23,0,0,0
2022-07-03 21:15,38,12,26,0,0,0
2022-07-03 21:30,32,6,26,0,0,0
2022-07-03 21:45,15,3,12,0,0,0
2022-07-03 22:00,21,7,14,0,0,0
2022-07-03 22:15,18,4,14,0,0,0
2022-07-03 22:30,17,2,15,0,0,0
2022-07-03 22:45,20,4,16,0,0,0
2022-07-03 23:00,11,3,8,0,0,0
2022-07-03 23:15,14,3,11,0,0,0
2022-07-03 23:30,8,2,6,0,0,0
2022-07-03 23:45,3,1,2,0,0,0
2022-07-04 00:00,3,1,2,0,0,0
2022-07-04 00:15,2,1,1,0,0,0
2022-07-04 00:30,2,0,2,0,0,0
2022-07-04 00:45,5,0,5,0,0,0
2022-07-04 01:00,1,1,0,0,0,0
2022-07-04 01:15,0,0,0,0,0,0
2022-07-04 01:30,2,0,2,0,0,0
2022-07-04 01:45,3,1,2,0,0,0
2022-07-04 02:00,0,0,0,0,0,0
2022-07-04 02:15,0,0,0,0,0,0
2022-07-04 02:30,0,0,0,0,0,0
2022-07-04 02:45,0,0,0,0,0,0
2022-07-04 03:00,0,0,0,0,0,0
2022-07-04 03:15,0,0,0,0,0,0
2022-07-04 03:30,0,0,0,0,0,0
2022-07-04 03:45,1,1,0,0,0,0
2022-07-04 04:00,1,0,1,0,0,0
2022-07-04 04:15,2,0,2,0,0,0
2022-07-04 04:30,1,0,1,0,0,0
2022-07-04 04:45,1,1,0,0,0,0
2022-07-04 05:00,1,1,0,0,0,0
2022-07-04 05:15,8,5,3,0,0,0
2022-07-04 05:30,12,5,7,0,0,0
2022-07-04 05:45,18,3,15,0,0,0
2022-07-04 06:00,8,3,5,0,0,0
2022-07-04 06:15,22,10,12,0,0,0
2022-07-04 06:30,51,14,37,0,0,0
2022-07-04 06:45,42,11,31,0,0,0
2022-07-04 07:00,65,17,48,0,0,0
2022-07-04 07:15,81,27,54,0,0,0
2022-07-04 07:30,116,56,60,0,0,0
2022-07-04 07:45,149,63,86,0,0,0
2022-07-04 08:00,139,36,103,0,0,0
2022-07-04 08:15,121,43,78,0,0,0
2022-07-04 08:30,99,48,51,0,0,0
2022-07-04 08:45,147,62,85,0,0,0
2022-07-04 09:00,102,56,46,0,0,0
2022-07-04 09:15,96,52,44,0,0,0
2022-07-04 09:30,104,46,58,0,0,0
2022-07-04 09:45,117,60,57,0,0,0
2022-07-04 10:00,154,63,91,0,0,0
2022-07-04 10:15,64,33,31,0,0,0
2022-07-04 10:30,72,37,35,0,0,0
2022-07-04 10:45,99,50,49,0,0,0
2022-07-04 11:00,91,45,46,0,0,0
2022-07-04 11:15,94,54,40,0,0,0
2022-07-04 11:30,107,61,46,0,0,0
2022-07-04 11:45,161,79,82,0,0,0
2022-07-04 12:00,188,112,76,0,0,0
2022-07-04 12:15,134,57,77,0,0,0
2022-07-04 12:30,97,34,63,0,0,0
2022-07-04 12:45,93,38,55,0,0,0
2022-07-04 13:00,95,35,60,0,0,0
2022-07-04 13:15,83,44,39,0,0,0
2022-07-04 13:30,105,53,52,0,0,0
2022-07-04 13:45,159,55,104,0,0,0
2022-07-04 14:00,155,73,82,0,0,0
2022-07-04 14:15,105,53,52,0,0,0
2022-07-04 14:30,127,60,67,0,0,0
2022-07-04 14:45,127,66,61,0,0,0
2022-07-04 15:00,94,49,45,0,0,0
2022-07-04 15:15,123,69,54,0,0,0
2022-07-04 15:30,127,72,55,0,0,0
2022-07-04 15:45,181,95,86,0,0,0
2022-07-04 16:00,195,115,80,0,0,0
2022-07-04 16:15,120,73,47,0,0,0
2022-07-04 16:30,125,68,57,0,0,0
2022-07-04 16:45,135,70,65,0,0,0
2022-07-04 17:00,127,58,69,0,0,0
2022-07-04 17:15,148,79,69,0,0,0
2022-07-04 17:30,143,62,81,0,0,0
2022-07-04 17:45,182,90,92,0,0,0
2022-07-04 18:00,178,70,108,0,0,0
2022-07-04 18:15,120,50,70,0,0,0
2022-07-04 18:30,89,34,55,0,0,0
2022-07-04 18:45,99,42,57,0,0,0
2022-07-04 19:00,72,26,46,0,0,0
2022-07-04 19:15,84,29,55,0,0,0
2022-07-04 19:30,78,28,50,0,0,0
2022-07-04 19:45,83,31,52,0,0,0
2022-07-04 20:00,63,27,36,0,0,0
2022-07-04 20:15,65,25,40,0,0,0
2022-07-04 20:30,49,20,29,0,0,0
2022-07-04 20:45,40,15,25,0,0,0
2022-07-04 21:00,65,35,30,0,0,0
2022-07-04 21:15,47,16,31,0,0,0
2022-07-04 21:30,37,19,18,0,0,0
2022-07-04 21:45,41,13,28,0,0,0
2022-07-04 22:00,43,18,25,0,0,0
2022-07-04 22:15,20,7,13,0,0,0
2022-07-04 22:30,38,9,29,0,0,0
2022-07-04 22:45,32,8,24,0,0,0
2022-07-04 23:00,12,3,9,0,0,0
2022-07-04 23:15,20,7,13,0,0,0
2022-07-04 23:30,5,1,4,0,0,0
2022-07-04 23:45,9,3,6,0,0,0
2022-07-05 00:00,13,3,10,0,0,0
2022-07-05 00:15,6,1,5,0,0,0
2022-07-05 00:30,2,1,1,0,0,0
2022-07-05 00:45,4,0,4,0,0,0
2022-07-05 01:00,4,1,3,0,0,0
2022-07-05 01:15,5,5,0,0,0,0
2022-07-05 01:30,4,1,3,0,0,0
2022-07-05 01:45,0,0,0,0,0,0
2022-07-05 02:00,4,0,4,0,0,0
2022-07-05 02:15,0,0,0,0,0,0
2022-07-05 02:30,2,1,1,0,0,0
2022-07-05 02:45,2,2,0,0,0,0
2022-07-05 03:00,0,0,0,0,0,0
2022-07-05 03:15,0,0,0,0,0,0
2022-07-05 03:30,4,1,3,0,0,0
2022-07-05 03:45,1,0,1,0,0,0
2022-07-05 04:00,1,1,0,0,0,0
2022-07-05 04:15,0,0,0,0,0,0
2022-07-05 04:30,1,0,1,0,0,0
2022-07-05 04:45,2,0,2,0,0,0
2022-07-05 05:00,0,0,0,0,0,0
2022-07-05 05:15,7,5,2,0,0,0
2022-07-05 05:30,13,4,9,0,0,0
2022-07-05 05:45,21,7,14,0,0,0
2022-07-05 06:00,16,9,7,0,0,0
2022-07-05 06:15,18,10,8,0,0,0
2022-07-05 06:30,61,23,38,0,0,0
2022-07-05 06:45,74,22,52,0,0,0
2022-07-05 07:00,79,21,58,0,0,0
2022-07-05 07:15,80,23,57,0,0,0
2022-07-05 07:30,116,47,69,0,0,0
2022-07-05 07:45,184,81,103,0,0,0
2022-07-05 08:00,225,84,141,0,0,0
2022-07-05 08:15,158,77,81,0,0,0
2022-07-05 08:30,138,69,69,0,0,0
2022-07-05 08:45,134,38,96,0,0,0
2022-07-05 09:00,90,37,53,0,0,0
2022-07-05 09:15,89,38,51,0,0,0
2022-07-05 09:30,92,43,49,0,0,0
2022-07-05 09:45,168,78,90,0,0,0
2022-07-05 10:00,171,64,107,0,0,0
2022-07-05 10:15,90,41,49,0,0,0
2022-07-05 10:30,91,43,48,0,0,0
2022-07-05 10:45,72,49,23,0,0,0
2022-07-05 11:00,67,25,42,0,0,0
2022-07-05 11:15,76,43,33,0,0,0
2022-07-05 11:30,104,62,42,0,0,0
2022-07-05 11:45,159,84,75,0,0,0
2022-07-05 12:00,159,78,81,0,0,0
2022-07-05 12:15,109,47,62,0,0,0
2022-07-05 12:30,99,41,58,0,0,0
2022-07-05 12:45,120,53,67,0,0,0
2022-07-05 13:00,123,60,63,0,0,0
2022-07-05 13:15,87,30,57,0,0,0
2022-07-05 13:30,131,59,72,0,0,0
2022-07-05 13:45,197,86,111,0,0,0
2022-07-05 14:00,187,98,89,0,0,0
2022-07-05 14:15,114,60,54,0,0,0
2022-07-05 14:30,132,84,48,0,0,0
2022-07-05 14:45,137,77,60,0,0,0
2022-07-05 15:00,104,51,53,0,0,0
2022-07-05 15:15,138,78,60,0,0,0
2022-07-05 15:30,157,95,62,0,0,0
2022-07-05 15:45,209,105,104,0,0,0
2022-07-05 16:00,227,126,101,0,0,0
2022-07-05 16:15,140,83,57,0,0,0
2022-07-05 16:30,139,70,69,0,0,0
2022-07-05 16:45,190,120,70,0,0,0
2022-07-05 17:00,190,104,86,0,0,0
2022-07-05 17:15,162,91,71,0,0,0
2022-07-05 17:30,161,84,77,0,0,0
2022-07-05 17:45,191,93,98,0,0,0
2022-07-05 18:00,166,89,77,0,0,0
2022-07-05 18:15,135,59,76,0,0,0
2022-07-05 18:30,88,35,53,0,0,0
2022-07-05 18:45,108,49,59,0,0,0
2022-07-05 19:00,84,24,60,0,0,0
2022-07-05 19:15,84,47,37,0,0,0
2022-07-05 19:30,75,34,41,0,0,0
2022-07-05 19:45,75,30,45,0,0,0
2022-07-05 20:00,59,35,24,0,0,0
2022-07-05 20:15,81,23,58,0,0,0
2022-07-05 20:30,49,16,33,0,0,0
2022-07-05 20:45,60,25,35,0,0,0
2022-07-05 21:00,48,16,32,0,0,0
2022-07-05 21:15,44,16,28,0,0,0
2022-07-05 21:30,40,12,28,0,0,0
2022-07-05 21:45,51,15,36,0,0,0
2022-07-05 22:00,32,13,19,0,0,0
2022-07-05 22:15,34,5,29,0,0,0
2022-07-05 22:30,19,6,13,0,0,0
2022-07-05 22:45,35,6,29,0,0,0
2022-07-05 23:00,45,13,32,0,0,0
2022-07-05 23:15,23,10,13,0,0,0
2022-07-05 23:30,11,5,6,0,0,0
2022-07-05 23:45,11,2,9,0,0,0
2022-07-06 00:00,11,1,10,0,0,0
2022-07-06 00:15,8,2,6,0,0,0
2022-07-06 00:30,9,2,7,0,0,0
2022-07-06 00:45,4,1,3,0,0,0
2022-07-06 01:00,5,3,2,0,0,0
2022-07-06 01:15,1,0,1,0,0,0
2022-07-06 01:30,3,2,1,0,0,0
2022-07-06 01:45,6,2,4,0,0,0
2022-07-06 02:00,4,2,2,0,0,0
2022-07-06 02:15,0,0,0,0,0,0
2022-07-06 02:30,1,1,0,0,0,0
2022-07-06 02:45,2,1,1,0,0,0
2022-07-06 03:00,0,0,0,0,0,0
2022-07-06 03:15,0,0,0,0,0,0
2022-07-06 03:30,0,0,0,0,0,0
2022-07-06 03:45,2,1,1,0,0,0
2022-07-06 04:00,1,1,0,0,0,0
2022-07-06 04:15,2,0,2,0,0,0
2022-07-06 04:30,1,0,1,0,0,0
2022-07-06 04:45,1,1,0,0,0,0
2022-07-06 05:00,1,0,1,0,0,0
2022-07-06 05:15,4,4,0,0,0,0
2022-07-06 05:30,21,6,15,0,0,0
2022-07-06 05:45,23,8,15,0,0,0
2022-07-06 06:00,13,7,6,0,0,0
2022-07-06 06:15,22,9,13,0,0,0
2022-07-06 06:30,37,13,24,0,0,0
2022-07-06 06:45,66,24,42,0,0,0
2022-07-06 07:00,68,22,46,0,0,0
2022-07-06 07:15,94,34,60,0,0,0
2022-07-06 07:30,109,41,68,0,0,0
2022-07-06 07:45,203,87,116,0,0,0
2022-07-06 08:00,219,78,141,0,0,0
2022-07-06 08:15,115,50,65,0,0,0
2022-07-06 08:30,101,55,46,0,0,0
2022-07-06 08:45,147,64,83,0,0,0
2022-07-06 09:00,136,79,57,0,0,0
2022-07-06 09:15,97,50,47,0,0,0
2022-07-06 09:30,113,68,45,0,0,0
2022-07-06 09:45,149,83,66,0,0,0
2022-07-06 10:00,164,60,104,0,0,0
2022-07-06 10:15,100,56,44,0,0,0
2022-07-06 10:30,96,42,54,0,0,0
2022-07-06 10:45,101,56,45,0,0,0
2022-07-06 11:00,83,40,43,0,0,0
2022-07-06 11:15,102,50,52,0,0,0
2022-07-06 11:30,126,71,55,0,0,0
2022-07-06 11:45,131,64,67,0,0,0
2022-07-06 12:00,207,92,115,0,0,0
2022-07-06 12:15,124,51,73,0,0,0
2022-07-06 12:30,120,49,71,0,0,0
2022-07-06 12:45,136,61,75,0,0,0
2022-07-06 13:00,110,49,61,0,0,0
2022-07-06 13:15,128,58,70,0,0,0
2022-07-06 13:30,137,63,74,0,0,0
2022-07-06 13:45,172,61,111,0,0,0
2022-07-06 14:00,157,88,69,0,0,0
2022-07-06 14:15,120,55,65,0,0,0
2022-07-06 14:30,125,72,53,0,0,0
2022-07-06 14:45,132,70,62,0,0,0
2022-07-06 15:00,96,47,49,0,0,0
2022-07-06 15:15,124,62,62,0,0,0
2022-07-06 15:30,142,70,72,0,0,0
2022-07-06 15:45,188,113,75,0,0,0
2022-07-06 16:00,186,99,87,0,0,0
2022-07-06 16:15,125,68,57,0,0,0
2022-07-06 16:30,128,70,58,0,0,0
2022-07-06 16:45,163,95,68,0,0,0
2022-07-06 17:00,139,81,58,0,0,0
2022-07-06 17:15,133,74,59,0,0,0
2022-07-06 17:30,126,62,64,0,0,0
2022-07-06 17:45,171,88,83,0,0,0
2022-07-06 18:00,145,58,87,0,0,0
2022-07-06 18:15,122,45,77,0,0,0
2022-07-06 18:30,107,48,59,0,0,0
2022-07-06 18:45,92,32,60,0,0,0
2022-07-06 19:00,90,44,46,0,0,0
2022-07-06 19:15,103,42,61,0,0,0
2022-07-06 19:30,92,41,51,0,0,0
2022-07-06 19:45,102,50,52,0,0,0
2022-07-06 20:00,100,38,62,0,0,0
2022-07-06 20:15,68,22,46,0,0,0
2022-07-06 20:30,52,21,31,0,0,0
2022-07-06 20:45,35,13,22,0,0,0
2022-07-06 21:00,64,21,43,0,0,0
2022-07-06 21:15,31,16,15,0,0,0
2022-07-06 21:30,46,22,24,0,0,0
2022-07-06 21:45,48,14,34,0,0,0
2022-07-06 22:00,31,12,19,0,0,0
2022-07-06 22:15,31,11,20,0,0,0
2022-07-06 22:30,31,10,21,0,0,0
2022-07-06 22:45,40,13,27,0,0,0
2022-07-06 23:00,30,7,23,0,0,0
2022-07-06 23:15,23,5,18,0,0,0
2022-07-06 23:30,11,6,5,0,0,0
2022-07-06 23:45,10,2,8,0,0,0
2022-07-07 00:00,22,6,16,0,0,0
2022-07-07 00:15,11,3,8,0,0,0
2022-07-07 00:30,12,3,9,0,0,0
2022-07-07 00:45,9,1,8,0,0,0
2022-07-07 01:00,3,1,2,0,0,0
2022-07-07 01:15,5,4,1,0,0,0
2022-07-07 01:30,4,2,2,0,0,0
2022-07-07 01:45,11,5,6,0,0,0
2022-07-07 02:00,10,2,8,0,0,0
2022-07-07 02:15,3,0,3,0,0,0
2022-07-07 02:30,1,0,1,0,0,0
2022-07-07 02:45,0,0,0,0,0,0
2022-07-07 03:00,1,1,0,0,0,0
2022-07-07 03:15,0,0,0,0,0,0
2022-07-07 03:30,6,1,5,0,0,0
2022-07-07 03:45,3,0,3,0,0,0
2022-07-07 04:00,2,1,1,0,0,0
2022-07-07 04:15,0,0,0,0,0,0
2022-07-07 04:30,1,1,0,0,0,0
2022-07-07 04:45,0,0,0,0,0,0
2022-07-07 05:00,0,0,0,0,0,0
2022-07-07 05:15,3,3,0,0,0,0
2022-07-07 05:30,19,5,14,0,0,0
2022-07-07 05:45,12,4,8,0,0,0
2022-07-07 06:00,11,6,5,0,0,0
2022-07-07 06:15,14,5,9,0,0,0
2022-07-07 06:30,44,17,27,0,0,0
2022-07-07 06:45,46,14,32,0,0,0
2022-07-07 07:00,69,19,50,0,0,0
2022-07-07 07:15,81,29,52,0,0,0
2022-07-07 07:30,91,29,62,0,0,0
2022-07-07 07:45,140,62,78,0,0,0
2022-07-07 08:00,174,56,118,0,0,0
2022-07-07 08:15,90,44,46,0,0,0
2022-07-07 08:30,86,38,48,0,0,0
2022-07-07 08:45,97,43,54,0,0,0
2022-07-07 09:00,60,32,28,0,0,0
2022-07-07 09:15,66,31,35,0,0,0
2022-07-07 09:30,70,25,45,0,0,0
2022-07-07 09:45,104,53,51,0,0,0
2022-07-07 10:00,159,66,93,0,0,0
2022-07-07 10:15,58,32,26,0,0,0
2022-07-07 10:30,50,25,25,0,0,0
2022-07-07 10:45,78,39,39,0,0,0
2022-07-07 11:00,58,26,32,0,0,0
2022-07-07 11:15,74,37,37,0,0,0
2022-07-07 11:30,84,38,46,0,0,0
2022-07-07 11:45,144,74,70,0,0,0
2022-07-07 12:00,131,50,81,0,0,0
2022-07-07 12:15,92,40,52,0,0,0
2022-07-07 12:30,114,49,65,0,0,0
2022-07-07 12:45,100,49,51,0,0,0
2022-07-07 13:00,55,33,22,0,0,0
2022-07-07 13:15,70,27,43,0,0,0
2022-07-07 13:30,98,41,57,0,0,0
2022-07-07 13:45,148,69,79,0,0,0
2022-07-07 14:00,105,48,57,0,0,0
2022-07-07 14:15,81,40,41,0,0,0
2022-07-07 14:30,65,28,37,0,0,0
2022-07-07 14:45,139,81,58,0,0,0
2022-07-07 15:00,118,62,56,0,0,0
2022-07-07 15:15,89,45,44,0,0,0
2022-07-07 15:30,77,38,39,0,0,0
2022-07-07 15:45,138,77,61,0,0,0
2022-07-07 16:00,164,86,78,0,0,0
2022-07-07 16:15,132,80,52,0,0,0
2022-07-07 16:30,124,71,53,0,0,0
2022-07-07 16:45,130,77,53,0,0,0
2022-07-07 17:00,117,54,63,0,0,0
2022-07-07 17:15,129,68,61,0,0,0
2022-07-07 17:30,97,48,49,0,0,0
2022-07-07 17:45,152,85,67,0,0,0
2022-07-07 18:00,116,59,57,0,0,0
2022-07-07 18:15,117,53,64,0,0,0
2022-07-07 18:30,84,33,51,0,0,0
2022-07-07 18:45,67,26,41,0,0,0
2022-07-07 19:00,89,44,45,0,0,0
2022-07-07 19:15,65,29,36,0,0,0
2022-07-07 19:30,47,26,21,0,0,0
2022-07-07 19:45,51,22,29,0,0,0
2022-07-07 20:00,52,19,33,0,0,0
2022-07-07 20:15,57,30,27,0,0,0
2022-07-07 20:30,44,14,30,0,0,0
2022-07-07 20:45,41,15,26,0,0,0
2022-07-07 21:00,39,18,21,0,0,0
2022-07-07 21:15,37,14,23,0,0,0
2022-07-07 21:30,35,14,21,0,0,0
2022-07-07 21:45,34,11,23,0,0,0
2022-07-07 22:00,49,21,28,0,0,0
2022-07-07 22:15,33,9,24,0,0,0
2022-07-07 22:30,18,6,12,0,0,0
2022-07-07 22:45,24,4,20,0,0,0
2022-07-07 23:00,13,6,7,0,0,0
2022-07-07 23:15,14,3,11,0,0,0
2022-07-07 23:30,16,5,11,0,0,0
2022-07-07 23:45,11,2,9,0,0,0
2022-07-08 00:00,16,3,13,0,0,0
2022-07-08 00:15,14,7,7,0,0,0
2022-07-08 00:30,15,8,7,0,0,0
2022-07-08 00:45,8,4,4,0,0,0
2022-07-08 01:00,11,2,9,0,0,0
2022-07-08 01:15,3,1,2,0,0,0
2022-07-08 01:30,10,3,7,0,0,0
2022-07-08 01:45,2,0,2,0,0,0
2022-07-08 02:00,3,0,3,0,0,0
2022-07-08 02:15,1,0,1,0,0,0
2022-07-08 02:30,2,0,2,0,0,0
2022-07-08 02:45,0,0,0,0,0,0
2022-07-08 03:00,0,0,0,0,0,0
2022-07-08 03:15,1,0,1,0,0,0
2022-07-08 03:30,0,0,0,0,0,0
2022-07-08 03:45,2,1,1,0,0,0
2022-07-08 04:00,0,0,0,0,0,0
2022-07-08 04:15,0,0,0,0,0,0
2022-07-08 04:30,2,1,1,0,0,0
2022-07-08 04:45,1,1,0,0,0,0
2022-07-08 05:00,0,0,0,0,0,0
2022-07-08 05:15,6,5,1,0,0,0
2022-07-08 05:30,12,2,10,0,0,0
2022-07-08 05:45,24,6,18,0,0,0
2022-07-08 06:00,3,0,3,0,0,0
2022-07-08 06:15,17,4,13,0,0,0
2022-07-08 06:30,37,21,16,0,0,0
2022-07-08 06:45,50,17,33,0,0,0
2022-07-08 07:00,50,15,35,0,0,0
2022-07-08 07:15,65,25,40,0,0,0
2022-07-08 07:30,87,32,55,0,0,0
2022-07-08 07:45,164,64,100,0,0,0
2022-07-08 08:00,166,48,118,0,0,0
2022-07-08 08:15,154,59,95,0,0,0
2022-07-08 08:30,116,45,71,0,0,0
2022-07-08 08:45,141,68,73,0,0,0
2022-07-08 09:00,117,63,54,0,0,0
2022-07-08 09:15,99,48,51,0,0,0
2022-07-08 09:30,73,39,34,0,0,0
2022-07-08 09:45,126,75,51,0,0,0
2022-07-08 10:00,180,118,62,0,0,0
2022-07-08 10:15,126,80,46,0,0,0
2022-07-08 10:30,64,30,34,0,0,0
2022-07-08 10:45,96,38,58,0,0,0
2022-07-08 11:00,95,63,32,0,0,0
2022-07-08 11:15,86,44,42,0,0,0
2022-07-08 11:30,81,45,36,0,0,0
2022-07-08 11:45,124,64,60,0,0,0
2022-07-08 12:00,119,47,72,0,0,0
2022-07-08 12:15,115,54,61,0,0,0
2022-07-08 12:30,133,54,79,0,0,0
2022-07-08 12:45,101,55,46,0,0,0
2022-07-08 13:00,114,45,69,0,0,0
2022-07-08 13:15,93,45,48,0,0,0
2022-07-08 13:30,126,60,66,0,0,0
2022-07-08 13:45,132,70,62,0,0,0
2022-07-08 14:00,125,62,63,0,0,0
2022-07-08 14:15,103,56,47,0,0,0
2022-07-08 14:30,99,39,60,0,0,0
2022-07-08 14:45,159,83,76,0,0,0
2022-07-08 15:00,130,75,55,0,0,0
2022-07-08 15:15,133,67,66,0,0,0
2022-07-08 15:30,117,62,55,0,0,0
2022-07-08 15:45,132,88,44,0,0,0
2022-07-08 16:00,153,70,83,0,0,0
2022-07-08 16:15,119,75,44,0,0,0
2022-07-08 16:30,88,46,42,0,0,0
2022-07-08 16:45,94,44,50,0,0,0
2022-07-08 17:00,87,33,54,0,0,0
2022-07-08 17:15,122,60,62,0,0,0
2022-07-08 17:30,96,44,52,0,0,0
2022-07-08 17:45,96,53,43,0,0,0
2022-07-08 18:00,114,48,66,0,0,0
2022-07-08 18:15,76,39,37,0,0,0
2022-07-08 18:30,94,57,37,0,0,0
2022-07-08 18:45,92,45,47,0,0,0
2022-07-08 19:00,103,53,50,0,0,0
2022-07-08 19:15,64,33,31,0,0,0
2022-07-08 19:30,91,33,58,0,0,0
2022-07-08 19:45,49,14,35,0,0,0
2022-07-08 20:00,72,29,43,0,0,0
2022-07-08 20:15,59,26,33,0,0,0
2022-07-08 20:30,42,17,25,0,0,0
2022-07-08 20:45,54,19,35,0,0,0
2022-07-08 21:00,57,20,37,0,0,0
2022-07-08 21:15,53,24,29,0,0,0
2022-07-08 21:30,41,23,18,0,0,0
2022-07-08 21:45,44,19,25,0,0,0
2022-07-08 22:00,37,13,24,0,0,0
2022-07-08 22:15,39,13,26,0,0,0
2022-07-08 22:30,30,9,21,0,0,0
2022-07-08 22:45,29,4,25,0,0,0
2022-07-08 23:00,26,3,23,0,0,0
2022-07-08 23:15,26,2,24,0,0,0
2022-07-08 23:30,30,9,21,0,0,0
2022-07-08 23:45,28,10,18,0,0,0
2022-07-09 00:00,18,0,18,0,0,0
2022-07-09 00:15,29,12,17,0,0,0
2022-07-09 00:30,18,5,13,0,0,0
2022-07-09 00:45,13,3,10,0,0,0
2022-07-09 01:00,23,7,16,0,0,0
2022-07-09 01:15,18,3,15,0,0,0
2022-07-09 01:30,8,2,6,0,0,0
2022-07-09 01:45,10,4,6,0,0,0
2022-07-09 02:00,11,2,9,0,0,0
2022-07-09 02:15,9,2,7,0,0,0
2022-07-09 02:30,11,0,11,0,0,0
2022-07-09 02:45,8,4,4,0,0,0
2022-07-09 03:00,15,1,14,0,0,0
2022-07-09 03:15,11,4,7,0,0,0
2022-07-09 03:30,6,1,5,0,0,0
2022-07-09 03:45,7,2,5,0,0,0
2022-07-09 04:00,8,0,8,0,0,0
2022-07-09 04:15,7,0,7,0,0,0
2022-07-09 04:30,4,0,4,0,0,0
2022-07-09 04:45,11,2,9,0,0,0
2022-07-09 05:00,3,2,1,0,0,0
2022-07-09 05:15,6,3,3,0,0,0
2022-07-09 05:30,5,1,4,0,0,0
2022-07-09 05:45,11,2,9,0,0,0
2022-07-09 06:00,4,1,3,0,0,0
2022-07-09 06:15,10,5,5,0,0,0
2022-07-09 06:30,7,3,4,0,0,0
2022-07-09 06:45,12,7,5,0,0,0
2022-07-09 07:00,13,10,3,0,0,0
2022-07-09 07:15,14,6,8,0,0,0
2022-07-09 07:30,28,11,17,0,0,0
2022-07-09 07:45,25,17,8,0,0,0
2022-07-09 08:00,29,19,10,0,0,0
2022-07-09 08:15,29,21,8,0,0,0
2022-07-09 08:30,33,19,14,0,0,0
2022-07-09 08:45,50,38,12,0,0,0
2022-07-09 09:00,53,32,21,0,0,0
2022-07-09 09:15,54,43,11,0,0,0
2022-07-09 09:30,61,47,14,0,0,0
2022-07-09 09:45,79,51,28,0,0,0
2022-07-09 10:00,69,37,32,0,0,0
2022-07-09 10:15,86,51,35,0,0,0
2022-07-09 10:30,80,45,35,0,0,0
2022-07-09 10:45,94,56,38,0,0,0
2022-07-09 11:00,99,49,50,0,0,0
2022-07-09 11:15,103,43,60,0,0,0
2022-07-09 11:30,118,57,61,0,0,0
2022-07-09 11:45,73,51,22,0,0,0
2022-07-09 12:00,105,65,40,0,0,0
2022-07-09 12:15,111,60,51,0,0,0
2022-07-09 12:30,97,51,46,0,0,0
2022-07-09 12:45,94,44,50,0,0,0
2022-07-09 13:00,107,51,56,0,0,0
2022-07-09 13:15,108,39,69,0,0,0
2022-07-09 13:30,78,27,51,0,0,0
2022-07-09 13:45,95,42,53,0,0,0
2022-07-09 14:00,74,19,55,0,0,0
2022-07-09 14:15,90,47,43,0,0,0
2022-07-09 14:30,82,32,50,0,0,0
2022-07-09 14:45,80,31,49,0,0,0
2022-07-09 15:00,71,33,38,0,0,0
2022-07-09 15:15,80,41,39,0,0,0
2022-07-09 15:30,60,25,35,0,0,0
2022-07-09 15:45,66,33,33,0,0,0
2022-07-09 16:00,67,22,45,0,0,0
2022-07-09 16:15,69,37,32,0,0,0
2022-07-09 16:30,51,19,32,0,0,0
2022-07-09 16:45,65,32,33,0,0,0
2022-07-09 17:00,73,27,46,0,0,0
2022-07-09 17:15,51,25,26,0,0,0
2022-07-09 17:30,56,20,36,0,0,0
2022-07-09 17:45,54,29,25,0,0,0
2022-07-09 18:00,56,19,37,0,0,0
2022-07-09 18:15,88,31,57,0,0,0
2022-07-09 18:30,45,25,20,0,0,0
2022-07-09 18:45,69,27,42,0,0,0
2022-07-09 19:00,64,32,32,0,0,0
2022-07-09 19:15,47,26,21,0,0,0
2022-07-09 19:30,52,20,32,0,0,0
2022-07-09 19:45,53,30,23,0,0,0
2022-07-09 20:00,43,14,29,0,0,0
2022-07-09 20:15,49,31,18,0,0,0
2022-07-09 20:30,28,12,16,0,0,0
2022-07-09 20:45,30,11,19,0,0,0
2022-07-09 21:00,37,17,20,0,0,0
2022-07-09 21:15,28,12,16,0,0,0
2022-07-09 21:30,31,5,26,0,0,0
2022-07-09 21:45,38,11,27,0,0,0
2022-07-09 22:00,36,12,24,0,0,0
2022-07-09 22:15,45,6,39,0,0,0
2022-07-09 22:30,22,11,11,0,0,0
2022-07-09 22:45,17,5,12,0,0,0
2022-07-09 23:00,22,14,8,0,0,0
2022-07-09 23:15,28,8,20,0,0,0
2022-07-09 23:30,18,2,16,0,0,0
2022-07-09 23:45,22,12,10,0,0,0
2022-07-10 00:00,14,1,13,0,0,0
2022-07-10 00:15,13,9,4,0,0,0
2022-07-10 00:30,24,11,13,0,0,0
2022-07-10 00:45,8,1,7,0,0,0
2022-07-10 01:00,12,2,10,0,0,0
2022-07-10 01:15,21,2,19,0,0,0
2022-07-10 01:30,11,2,9,0,0,0
2022-07-10 01:45,9,1,8,0,0,0
2022-07-10 02:00,4,2,2,0,0,0
2022-07-10 02:15,11,2,9,0,0,0
2022-07-10 02:30,5,1,4,0,0,0
2022-07-10 02:45,5,2,3,0,0,0
2022-07-10 03:00,6,1,5,0,0,0
2022-07-10 03:15,8,0,8,0,0,0
2022-07-10 03:30,2,0,2,0,0,0
2022-07-10 03:45,4,1,3,0,0,0
2022-07-10 04:00,2,0,2,0,0,0
2022-07-10 04:15,3,0,3,0,0,0
2022-07-10 04:30,2,0,2,0,0,0
2022-07-10 04:45,2,0,2,0,0,0
2022-07-10 05:00,2,1,1,0,0,0
2022-07-10 05:15,4,1,3,0,0,0
2022-07-10 05:30,7,0,7,0,0,0
2022-07-10 05:45,8,1,7,0,0,0
2022-07-10 06:00,4,1,3,0,0,0
2022-07-10 06:15,1,1,0,0,0,0
2022-07-10 06:30,10,2,8,0,0,0
2022-07-10 06:45,11,7,4,0,0,0
2022-07-10 07:00,4,1,3,0,0,0
2022-07-10 07:15,5,3,2,0,0,0
2022-07-10 07:30,5,1,4,0,0,0
2022-07-10 07:45,11,6,5,0,0,0
2022-07-10 08:00,18,15,3,0,0,0
2022-07-10 08:15,16,13,3,0,0,0
2022-07-10 08:30,12,9,3,0,0,0
2022-07-10 08:45,18,12,6,0,0,0
2022-07-10 09:00,15,13,2,0,0,0
2022-07-10 09:15,20,11,9,0,0,0
2022-07-10 09:30,19,9,10,0,0,0
2022-07-10 09:45,35,24,11,0,0,0
2022-07-10 10:00,20,14,6,0,0,0
2022-07-10 10:15,25,8,17,0,0,0
2022-07-10 10:30,28,11,17,0,0,0
2022-07-10 10:45,60,47,13,0,0,0
2022-07-10 11:00,43,11,32,0,0,0
2022-07-10 11:15,47,15,32,0,0,0
2022-07-10 11:30,32,21,11,0,0,0
2022-07-10 11:45,46,17,29,0,0,0
2022-07-10 12:00,24,6,18,0,0,0
2022-07-10 12:15,38,24,14,0,0,0
2022-07-10 12:30,26,13,13,0,0,0
2022-07-10 12:45,19,7,12,0,0,0
2022-07-10 13:00,23,10,13,0,0,0
2022-07-10 13:15,28,7,21,0,0,0
2022-07-10 13:30,27,15,12,0,0,0
2022-07-10 13:45,25,11,14,0,0,0
2022-07-10 14:00,41,19,22,0,0,0
2022-07-10 14:15,43,22,21,0,0,0
2022-07-10 14:30,30,20,10,0,0,0
2022-07-10 14:45,32,18,14,0,0,0
2022-07-10 15:00,34,16,18,0,0,0
2022-07-10 15:15,44,19,25,0,0,0
2022-07-10 15:30,25,10,15,0,0,0
2022-07-10 15:45,28,12,16,0,0,0
2022-07-10 16:00,48,22,26,0,0,0
2022-07-10 16:15,20,7,13,0,0,0
2022-07-10 16:30,44,14,30,0,0,0
2022-07-10 16:45,35,10,25,0,0,0
2022-07-10 17:00,48,17,31,0,0,0
2022-07-10 17:15,39,18,21,0,0,0
2022-07-10 17:30,42,14,28,0,0,0
2022-07-10 17:45,39,23,16,0,0,0
2022-07-10 18:00,31,10,21,0,0,0
2022-07-10 18:15,40,16,24,0,0,0
2022-07-10 18:30,25,6,19,0,0,0
2022-07-10 18:45,22,10,12,0,0,0
2022-07-10 19:00,26,12,14,0,0,0
2022-07-10 19:15,34,12,22,0,0,0
2022-07-10 19:30,24,4,20,0,0,0
2022-07-10 19:45,24,11,13,0,0,0
2022-07-10 20:00,31,13,18,0,0,0
2022-07-10 20:15,23,8,15,0,0,0
2022-07-10 20:30,22,6,16,0,0,0
2022-07-10 20:45,24,3,21,0,0,0
2022-07-10 21:00,25,6,19,0,0,0
2022-07-10 21:15,25,12,13,0,0,0
2022-07-10 21:30,17,6,11,0,0,0
2022-07-10 21:45,23,8,15,0,0,0
2022-07-10 22:00,7,1,6,0,0,0
2022-07-10 22:15,8,2,6,0,0,0
2022-07-10 22:30,8,1,7,0,0,0
2022-07-10 22:45,9,2,7,0,0,0
2022-07-10 23:00,10,3,7,0,0,0
2022-07-10 23:15,5,3,2,0,0,0
2022-07-10 23:30,5,1,4,0,0,0
2022-07-10 23:45,3,2,1,0,0,0
2022-07-11 00:00,7,0,7,0,0,0
2022-07-11 00:15,2,0,2,0,0,0
2022-07-11 00:30,4,4,0,0,0,0
2022-07-11 00:45,1,1,0,0,0,0
2022-07-11 01:00,0,0,0,0,0,0
2022-07-11 01:15,8,2,6,0,0,0
2022-07-11 01:30,0,0,0,0,0,0
2022-07-11 01:45,0,0,0,0,0,0
2022-07-11 02:00,0,0,0,0,0,0
2022-07-11 02:15,0,0,0,0,0,0
2022-07-11 02:30,0,0,0,0,0,0
2022-07-11 02:45,0,0,0,0,0,0
2022-07-11 03:00,0,0,0,0,0,0
2022-07-11 03:15,1,1,0,0,0,0
2022-07-11 03:30,3,2,1,0,0,0
2022-07-11 03:45,1,1,0,0,0,0
2022-07-11 04:00,0,0,0,0,0,0
2022-07-11 04:15,0,0,0,0,0,0
2022-07-11 04:30,1,0,1,0,0,0
2022-07-11 04:45,2,2,0,0,0,0
2022-07-11 05:00,0,0,0,0,0,0
2022-07-11 05:15,1,0,1,0,0,0
2022-07-11 05:30,14,7,7,0,0,0
2022-07-11 05:45,16,3,13,0,0,0
2022-07-11 06:00,7,3,4,0,0,0
2022-07-11 06:15,11,2,9,0,0,0
2022-07-11 06:30,42,12,30,0,0,0
2022-07-11 06:45,57,20,37,0,0,0
2022-07-11 07:00,66,25,41,0,0,0
2022-07-11 07:15,83,38,45,0,0,0
2022-07-11 07:30,88,30,58,0,0,0
2022-07-11 07:45,143,51,92,0,0,0
2022-07-11 08:00,136,47,89,0,0,0
2022-07-11 08:15,110,51,59,0,0,0
2022-07-11 08:30,108,50,58,0,0,0
2022-07-11 08:45,124,46,78,0,0,0
2022-07-11 09:00,89,32,57,0,0,0
2022-07-11 09:15,51,28,23,0,0,0
2022-07-11 09:30,48,21,27,0,0,0
2022-07-11 09:45,88,53,35,0,0,0
2022-07-11 10:00,95,45,50,0,0,0
2022-07-11 10:15,57,23,34,0,0,0
2022-07-11 10:30,59,34,25,0,0,0
2022-07-11 10:45,66,35,31,0,0,0
2022-07-11 11:00,62,33,29,0,0,0
2022-07-11 11:15,90,40,50,0,0,0
2022-07-11 11:30,74,25,49,0,0,0
2022-07-11 11:45,102,45,57,0,0,0
2022-07-11 12:00,88,39,49,0,0,0
2022-07-11 12:15,86,37,49,0,0,0
2022-07-11 12:30,88,42,46,0,0,0
2022-07-11 12:45,84,37,47,0,0,0
2022-07-11 13:00,103,54,49,0,0,0
2022-07-11 13:15,96,37,59,0,0,0
2022-07-11 13:30,100,38,62,0,0,0
2022-07-11 13:45,114,69,45,0,0,0
2022-07-11 14:00,114,57,57,0,0,0
2022-07-11 14:15,90,49,41,0,0,0
2022-07-11 14:30,80,24,56,0,0,0
2022-07-11 14:45,108,70,38,0,0,0
2022-07-11 15:00,99,54,45,0,0,0
2022-07-11 15:15,110,63,47,0,0,0
2022-07-11 15:30,124,83,41,0,0,0
2022-07-11 15:45,151,97,54,0,0,0
2022-07-11 16:00,163,94,69,0,0,0
2022-07-11 16:15,168,81,87,0,0,0
2022-07-11 16:30,127,70,57,0,0,0
2022-07-11 16:45,122,55,67,0,0,0
2022-07-11 17:00,142,84,58,0,0,0
2022-07-11 17:15,149,69,80,0,0,0
2022-07-11 17:30,126,53,73,0,0,0
2022-07-11 17:45,178,97,81,0,0,0
2022-07-11 18:00,114,52,62,0,0,0
2022-07-11 18:15,89,33,56,0,0,0
2022-07-11 18:30,97,39,58,0,0,0
2022-07-11 18:45,86,35,51,0,0,0
2022-07-11 19:00,66,29,37,0,0,0
2022-07-11 19:15,73,30,43,0,0,0
2022-07-11 19:30,58,19,39,0,0,0
2022-07-11 19:45,82,26,56,0,0,0
2022-07-11 20:00,62,22,40,0,0,0
2022-07-11 20:15,70,21,49,0,0,0
2022-07-11 20:30,55,25,30,0,0,0
2022-07-11 20:45,24,9,15,0,0,0
2022-07-11 21:00,41,28,13,0,0,0
2022-07-11 21:15,31,17,14,0,0,0
2022-07-11 21:30,20,6,14,0,0,0
2022-07-11 21:45,19,11,8,0,0,0
2022-07-11 22:00,35,13,22,0,0,0
2022-07-11 22:15,22,10,12,0,0,0
2022-07-11 22:30,26,5,21,0,0,0
2022-07-11 22:45,22,5,17,0,0,0
2022-07-11 23:00,21,7,14,0,0,0
2022-07-11 23:15,13,4,9,0,0,0
2022-07-11 23:30,2,0,2,0,0,0
2022-07-11 23:45,15,4,11,0,0,0
2022-07-12 00:00,2,0,2,0,0,0
2022-07-12 00:15,6,0,6,0,0,0
2022-07-12 00:30,3,0,3,0,0,0
2022-07-12 00:45,6,3,3,0,0,0
2022-07-12 01:00,0,0,0,0,0,0
2022-07-12 01:15,5,3,2,0,0,0
2022-07-12 01:30,4,2,2,0,0,0
2022-07-12 01:45,2,1,1,0,0,0
2022-07-12 02:00,2,0,2,0,0,0
2022-07-12 02:15,0,0,0,0,0,0
2022-07-12 02:30,0,0,0,0,0,0
2022-07-12 02:45,4,1,3,0,0,0
2022-07-12 03:00,0,0,0,0,0,0
2022-07-12 03:15,1,1,0,0,0,0
2022-07-12 03:30,0,0,0,0,0,0
2022-07-12 03:45,1,0,1,0,0,0
2022-07-12 04:00,0,0,0,0,0,0
2022-07-12 04:15,2,2,0,0,0,0
2022-07-12 04:30,0,0,0,0,0,0
2022-07-12 04:45,2,0,2,0,0,0
2022-07-12 05:00,3,3,0,0,0,0
2022-07-12 05:15,0,0,0,0,0,0
2022-07-12 05:30,11,3,8,0,0,0
2022-07-12 05:45,19,8,11,0,0,0
2022-07-12 06:00,9,4,5,0,0,0
2022-07-12 06:15,21,7,14,0,0,0
2022-07-12 06:30,27,12,15,0,0,0
2022-07-12 06:45,65,19,46,0,0,0
2022-07-12 07:00,64,17,47,0,0,0
2022-07-12 07:15,78,19,59,0,0,0
2022-07-12 07:30,144,53,91,0,0,0
2022-07-12 07:45,162,50,112,0,0,0
2022-07-12 08:00,161,77,84,0,0,0
2022-07-12 08:15,118,59,59,0,0,0
2022-07-12 08:30,111,53,58,0,0,0
2022-07-12 08:45,117,51,66,0,0,0
2022-07-12 09:00,105,51,54,0,0,0
2022-07-12 09:15,82,41,41,0,0,0
2022-07-12 09:30,79,36,43,0,0,0
2022-07-12 09:45,95,36,59,0,0,0
2022-07-12 10:00,98,50,48,0,0,0
2022-07-12 10:15,93,48,45,0,0,0
2022-07-12 10:30,89,45,44,0,0,0
2022-07-12 10:45,115,69,46,0,0,0
2022-07-12 11:00,71,38,33,0,0,0
2022-07-12 11:15,85,48,37,0,0,0
2022-07-12 11:30,97,59,38,0,0,0
2022-07-12 11:45,130,81,49,0,0,0
2022-07-12 12:00,109,41,68,0,0,0
2022-07-12 12:15,134,72,62,0,0,0
2022-07-12 12:30,96,42,54,0,0,0
2022-07-12 12:45,115,66,49,0,0,0
2022-07-12 13:00,99,40,59,0,0,0
2022-07-12 13:15,126,53,73,0,0,0
2022-07-12 13:30,116,50,66,0,0,0
2022-07-12 13:45,137,63,74,0,0,0
2022-07-12 14:00,120,70,50,0,0,0
2022-07-12 14:15,155,81,74,0,0,0
2022-07-12 14:30,106,53,53,0,0,0
2022-07-12 14:45,110,62,48,0,0,0
2022-07-12 15:00,113,59,54,0,0,0
2022-07-12 15:15,141,83,58,0,0,0
2022-07-12 15:30,151,79,72,0,0,0
2022-07-12 15:45,154,89,65,0,0,0
2022-07-12 16:00,192,108,84,0,0,0
2022-07-12 16:15,137,68,69,0,0,0
2022-07-12 16:30,153,79,74,0,0,0
2022-07-12 16:45,138,75,63,0,0,0
2022-07-12 17:00,144,75,69,0,0,0
2022-07-12 17:15,140,57,83,0,0,0
2022-07-12 17:30,156,70,86,0,0,0
2022-07-12 17:45,166,81,85,0,0,0
2022-07-12 18:00,130,58,72,0,0,0
2022-07-12 18:15,120,64,56,0,0,0
2022-07-12 18:30,85,39,46,0,0,0
2022-07-12 18:45,108,51,57,0,0,0
2022-07-12 19:00,140,68,72,0,0,0
2022-07-12 19:15,96,42,54,0,0,0
2022-07-12 19:30,86,26,60,0,0,0
2022-07-12 19:45,61,25,36,0,0,0
2022-07-12 20:00,83,24,59,0,0,0
2022-07-12 20:15,47,17,30,0,0,0
2022-07-12 20:30,39,19,20,0,0,0
2022-07-12 20:45,33,12,21,0,0,0
2022-07-12 21:00,32,11,21,0,0,0
2022-07-12 21:15,36,21,15,0,0,0
2022-07-12 21:30,55,14,41,0,0,0
2022-07-12 21:45,32,7,25,0,0,0
2022-07-12 22:00,32,9,23,0,0,0
2022-07-12 22:15,27,8,19,0,0,0
2022-07-12 22:30,31,10,21,0,0,0
2022-07-12 22:45,19,7,12,0,0,0
2022-07-12 23:00,32,9,23,0,0,0
2022-07-12 23:15,29,6,23,0,0,0
2022-07-12 23:30,15,2,13,0,0,0
2022-07-12 23:45,6,1,5,0,0,0
2022-07-13 00:00,13,4,9,0,0,0
2022-07-13 00:15,6,0,6,0,0,0
2022-07-13 00:30,11,3,8,0,0,0
2022-07-13 00:45,3,1,2,0,0,0
2022-07-13 01:00,10,3,7,0,0,0
2022-07-13 01:15,5,0,5,0,0,0
2022-07-13 01:30,4,1,3,0,0,0
2022-07-13 01:45,0,0,0,0,0,0
2022-07-13 02:00,0,0,0,0,0,0
2022-07-13 02:15,1,0,1,0,0,0
2022-07-13 02:30,1,1,0,0,0,0
2022-07-13 02:45,1,0,1,0,0,0
2022-07-13 03:00,1,0,1,0,0,0
2022-07-13 03:15,2,0,2,0,0,0
2022-07-13 03:30,0,0,0,0,0,0
2022-07-13 03:45,2,1,1,0,0,0
2022-07-13 04:00,0,0,0,0,0,0
2022-07-13 04:15,2,1,1,0,0,0
2022-07-13 04:30,2,0,2,0,0,0
2022-07-13 04:45,0,0,0,0,0,0
2022-07-13 05:00,4,4,0,0,0,0
2022-07-13 05:15,3,3,0,0,0,0
2022-07-13 05:30,8,5,3,0,0,0
2022-07-13 05:45,19,5,14,0,0,0
2022-07-13 06:00,16,5,11,0,0,0
2022-07-13 06:15,11,7,4,0,0,0
2022-07-13 06:30,33,17,16,0,0,0
2022-07-13 06:45,66,20,46,0,0,0
2022-07-13 07:00,75,24,51,0,0,0
2022-07-13 07:15,113,50,63,0,0,0
2022-07-13 07:30,113,35,78,0,0,0
2022-07-13 07:45,163,77,86,0,0,0
2022-07-13 08:00,137,62,75,0,0,0
2022-07-13 08:15,140,67,73,0,0,0
2022-07-13 08:30,115,45,70,0,0,0
2022-07-13 08:45,153,77,76,0,0,0
2022-07-13 09:00,98,38,60,0,0,0
2022-07-13 09:15,94,44,50,0,0,0
2022-07-13 09:30,115,61,54,0,0,0
2022-07-13 09:45,145,68,77,0,0,0
2022-07-13 10:00,166,74,92,0,0,0
2022-07-13 10:15,129,78,51,0,0,0
2022-07-13 10:30,106,59,47,0,0,0
2022-07-13 10:45,120,74,46,0,0,0
2022-07-13 11:00,124,48,76,0,0,0
2022-07-13 11:15,104,55,49,0,0,0
2022-07-13 11:30,111,60,51,0,0,0
2022-07-13 11:45,147,94,53,0,0,0
2022-07-13 12:00,146,86,60,0,0,0
2022-07-13 12:15,146,74,72,0,0,0
2022-07-13 12:30,128,46,82,0,0,0
2022-07-13 12:45,172,82,90,0,0,0
2022-07-13 13:00,116,59,57,0,0,0
2022-07-13 13:15,165,83,82,0,0,0
2022-07-13 13:30,151,56,95,0,0,0
2022-07-13 13:45,146,66,80,0,0,0
2022-07-13 14:00,155,72,83,0,0,0
2022-07-13 14:15,114,52,62,0,0,0
2022-07-13 14:30,82,45,37,0,0,0
2022-07-13 14:45,125,47,78,0,0,0
2022-07-13 15:00,125,78,47,0,0,0
2022-07-13 15:15,118,60,58,0,0,0
2022-07-13 15:30,150,92,58,0,0,0
2022-07-13 15:45,151,87,64,0,0,0
2022-07-13 16:00,164,84,80,0,0,0
2022-07-13 16:15,130,73,57,0,0,0
2022-07-13 16:30,111,53,58,0,0,0
2022-07-13 16:45,130,60,70,0,0,0
2022-07-13 17:00,114,53,61,0,0,0
2022-07-13 17:15,122,69,53,0,0,0
2022-07-13 17:30,116,59,57,0,0,0
2022-07-13 17:45,149,59,90,0,0,0
2022-07-13 18:00,119,58,61,0,0,0
2022-07-13 18:15,116,40,76,0,0,0
2022-07-13 18:30,96,51,45,0,0,0
2022-07-13 18:45,92,49,43,0,0,0
2022-07-13 19:00,76,41,35,0,0,0
2022-07-13 19:15,75,39,36,0,0,0
2022-07-13 19:30,63,25,38,0,0,0
2022-07-13 19:45,67,29,38,0,0,0
2022-07-13 20:00,56,22,34,0,0,0
2022-07-13 20:15,59,29,30,0,0,0
2022-07-13 20:30,50,17,33,0,0,0
2022-07-13 20:45,52,26,26,0,0,0
2022-07-13 21:00,38,21,17,0,0,0
2022-07-13 21:15,41,15,26,0,0,0
2022-07-13 21:30,52,14,38,0,0,0
2022-07-13 21:45,36,12,24,0,0,0
2022-07-13 22:00,56,16,40,0,0,0
2022-07-13 22:15,43,13,30,0,0,0
2022-07-13 22:30,27,8,19,0,0,0
2022-07-13 22:45,23,6,17,0,0,0
2022-07-13 23:00,27,3,24,0,0,0
2022-07-13 23:15,13,4,9,0,0,0
2022-07-13 23:30,22,6,16,0,0,0
2022-07-13 23:45,18,5,13,0,0,0
2022-07-14 00:00,14,0,14,0,0,0
2022-07-14 00:15,10,2,8,0,0,0
2022-07-14 00:30,18,13,5,0,0,0
2022-07-14 00:45,7,4,3,0,0,0
2022-07-14 01:00,6,1,5,0,0,0
2022-07-14 01:15,5,0,5,0,0,0
2022-07-14 01:30,7,4,3,0,0,0
2022-07-14 01:45,6,2,4,0,0,0
2022-07-14 02:00,2,0,2,0,0,0
2022-07-14 02:15,6,0,6,0,0,0
2022-07-14 02:30,7,0,7,0,0,0
2022-07-14 02:45,5,0,5,0,0,0
2022-07-14 03:00,3,0,3,0,0,0
2022-07-14 03:15,2,0,2,0,0,0
2022-07-14 03:30,1,0,1,0,0,0
2022-07-14 03:45,0,0,0,0,0,0
2022-07-14 04:00,9,0,9,0,0,0
2022-07-14 04:15,3,0,3,0,0,0
2022-07-14 04:30,1,0,1,0,0,0
2022-07-14 04:45,1,1,0,0,0,0
2022-07-14 05:00,0,0,0,0,0,0
2022-07-14 05:15,5,3,2,0,0,0
2022-07-14 05:30,7,3,4,0,0,0
2022-07-14 05:45,17,4,13,0,0,0
2022-07-14 06:00,15,4,11,0,0,0
2022-07-14 06:15,19,9,10,0,0,0
2022-07-14 06:30,39,12,27,0,0,0
2022-07-14 06:45,59,21,38,0,0,0
2022-07-14 07:00,69,20,49,0,0,0
2022-07-14 07:15,79,24,55,0,0,0
2022-07-14 07:30,123,43,80,0,0,0
2022-07-14 07:45,138,64,74,0,0,0
2022-07-14 08:00,147,62,85,0,0,0
2022-07-14 08:15,115,54,61,0,0,0
2022-07-14 08:30,108,56,52,0,0,0
2022-07-14 08:45,130,57,73,0,0,0
2022-07-14 09:00,86,38,48,0,0,0
2022-07-14 09:15,61,32,29,0,0,0
2022-07-14 09:30,104,55,49,0,0,0
2022-07-14 09:45,130,60,70,0,0,0
2022-07-14 10:00,131,67,64,0,0,0
2022-07-14 10:15,63,40,23,0,0,0
2022-07-14 10:30,103,57,46,0,0,0
2022-07-14 10:45,67,27,40,0,0,0
2022-07-14 11:00,103,49,54,0,0,0
2022-07-14 11:15,100,45,55,0,0,0
2022-07-14 11:30,80,53,27,0,0,0
2022-07-14 11:45,130,79,51,0,0,0
2022-07-14 12:00,102,57,45,0,0,0
2022-07-14 12:15,121,55,66,0,0,0
2022-07-14 12:30,80,31,49,0,0,0
2022-07-14 12:45,130,62,68,0,0,0
2022-07-14 13:00,106,51,55,0,0,0
2022-07-14 13:15,99,44,55,0,0,0
2022-07-14 13:30,120,53,67,0,0,0
2022-07-14 13:45,140,75,65,0,0,0
2022-07-14 14:00,125,63,62,0,0,0
2022-07-14 14:15,123,66,57,0,0,0
2022-07-14 14:30,84,34,50,0,0,0
2022-07-14 14:45,115,63,52,0,0,0
2022-07-14 15:00,108,54,54,0,0,0
2022-07-14 15:15,142,72,70,0,0,0
2022-07-14 15:30,153,74,79,0,0,0
2022-07-14 15:45,152,90,62,0,0,0
2022-07-14 16:00,204,95,109,0,0,0
2022-07-14 16:15,153,90,63,0,0,0
2022-07-14 16:30,158,90,68,0,0,0
2022-07-14 16:45,147,91,56,0,0,0
2022-07-14 17:00,173,91,82,0,0,0
2022-07-14 17:15,148,62,86,0,0,0
2022-07-14 17:30,133,67,66,0,0,0
2022-07-14 17:45,158,81,77,0,0,0
2022-07-14 18:00,125,56,69,0,0,0
2022-07-14 18:15,124,60,64,0,0,0
2022-07-14 18:30,142,61,81,0,0,0
2022-07-14 18:45,127,57,70,0,0,0
2022-07-14 19:00,100,52,48,0,0,0
2022-07-14 19:15,79,22,57,0,0,0
2022-07-14 19:30,68,30,38,0,0,0
2022-07-14 19:45,68,34,34,0,0,0
2022-07-14 20:00,85,34,51,0,0,0
2022-07-14 20:15,73,27,46,0,0,0
2022-07-14 20:30,71,20,51,0,0,0
2022-07-14 20:45,70,24,46,0,0,0
2022-07-14 21:00,63,28,35,0,0,0
2022-07-14 21:15,53,22,31,0,0,0
2022-07-14 21:30,55,14,41,0,0,0
2022-07-14 21:45,50,13,37,0,0,0
2022-07-14 22:00,56,16,40,0,0,0
2022-07-14 22:15,28,11,17,0,0,0
2022-07-14 22:30,45,5,40,0,0,0
2022-07-14 22:45,38,7,31,0,0,0
2022-07-14 23:00,44,9,35,0,0,0
2022-07-14 23:15,37,3,34,0,0,0
2022-07-14 23:30,26,3,23,0,0,0
2022-07-14 23:45,14,1,13,0,0,0
2022-07-15 00:00,18,2,16,0,0,0
2022-07-15 00:15,7,2,5,0,0,0
2022-07-15 00:30,4,0,4,0,0,0
2022-07-15 00:45,20,7,13,0,0,0
2022-07-15 01:00,16,1,15,0,0,0
2022-07-15 01:15,8,3,5,0,0,0
2022-07-15 01:30,4,0,4,0,0,0
2022-07-15 01:45,5,0,5,0,0,0
2022-07-15 02:00,7,2,5,0,0,0
2022-07-15 02:15,3,2,1,0,0,0
2022-07-15 02:30,0,0,0,0,0,0
2022-07-15 02:45,2,1,1,0,0,0
2022-07-15 03:00,1,1,0,0,0,0
2022-07-15 03:15,1,0,1,0,0,0
2022-07-15 03:30,1,1,0,0,0,0
2022-07-15 03:45,1,0,1,0,0,0
2022-07-15 04:00,2,0,2,0,0,0
2022-07-15 04:15,2,0,2,0,0,0
2022-07-15 04:30,0,0,0,0,0,0
2022-07-15 04:45,1,1,0,0,0,0
2022-07-15 05:00,0,0,0,0,0,0
2022-07-15 05:15,4,4,0,0,0,0
2022-07-15 05:30,15,4,11,0,0,0
2022-07-15 05:45,12,6,6,0,0,0
2022-07-15 06:00,15,4,11,0,0,0
2022-07-15 06:15,21,11,10,0,0,0
2022-07-15 06:30,30,8,22,0,0,0
2022-07-15 06:45,49,12,37,0,0,0
2022-07-15 07:00,44,24,20,0,0,0
2022-07-15 07:15,63,19,44,0,0,0
2022-07-15 07:30,83,41,42,0,0,0
2022-07-15 07:45,114,56,58,0,0,0
2022-07-15 08:00,108,44,64,0,0,0
2022-07-15 08:15,95,41,54,0,0,0
2022-07-15 08:30,83,32,51,0,0,0
2022-07-15 08:45,126,60,66,0,0,0
2022-07-15 09:00,81,28,53,0,0,0
2022-07-15 09:15,104,43,61,0,0,0
2022-07-15 09:30,91,40,51,0,0,0
2022-07-15 09:45,111,59,52,0,0,0
2022-07-15 10:00,99,60,39,0,0,0
2022-07-15 10:15,87,47,40,0,0,0
2022-07-15 10:30,68,25,43,0,0,0
2022-07-15 10:45,90,54,36,0,0,0
2022-07-15 11:00,73,45,28,0,0,0
2022-07-15 11:15,86,49,37,0,0,0
2022-07-15 11:30,100,59,41,0,0,0
2022-07-15 11:45,128,72,56,0,0,0
2022-07-15 12:00,136,79,57,0,0,0
2022-07-15 12:15,123,71,52,0,0,0
2022-07-15 12:30,97,34,63,0,0,0
2022-07-15 12:45,108,61,47,0,0,0
2022-07-15 13:00,100,58,42,0,0,0
2022-07-15 13:15,116,47,69,0,0,0
2022-07-15 13:30,87,34,53,0,0,0
2022-07-15 13:45,156,61,95,0,0,0
2022-07-15 14:00,125,70,55,0,0,0
2022-07-15 14:15,114,70,44,0,0,0
2022-07-15 14:30,113,56,57,0,0,0
2022-07-15 14:45,126,62,64,0,0,0
2022-07-15 15:00,112,56,56,0,0,0
2022-07-15 15:15,146,70,76,0,0,0
2022-07-15 15:30,112,68,44,0,0,0
2022-07-15 15:45,130,60,70,0,0,0
2022-07-15 16:00,157,70,87,0,0,0
2022-07-15 16:15,114,59,55,0,0,0
2022-07-15 16:30,98,42,56,0,0,0
2022-07-15 16:45,124,54,70,0,0,0
2022-07-15 17:00,87,38,49,0,0,0
2022-07-15 17:15,117,59,58,0,0,0
2022-07-15 17:30,121,59,62,0,0,0
2022-07-15 17:45,98,46,52,0,0,0
2022-07-15 18:00,109,28,81,0,0,0
2022-07-15 18:15,89,30,59,0,0,0
2022-07-15 18:30,93,41,52,0,0,0
2022-07-15 18:45,98,44,54,0,0,0
2022-07-15 19:00,104,55,49,0,0,0
2022-07-15 19:15,101,53,48,0,0,0
2022-07-15 19:30,64,33,31,0,0,0
2022-07-15 19:45,70,43,27,0,0,0
2022-07-15 20:00,73,41,32,0,0,0
2022-07-15 20:15,78,33,45,0,0,0
2022-07-15 20:30,65,27,38,0,0,0
2022-07-15 20:45,54,16,38,0,0,0
2022-07-15 21:00,65,40,25,0,0,0
2022-07-15 21:15,48,13,35,0,0,0
2022-07-15 21:30,62,40,22,0,0,0
2022-07-15 21:45,31,17,14,0,0,0
2022-07-15 22:00,46,30,16,0,0,0
2022-07-15 22:15,42,16,26,0,0,0
2022-07-15 22:30,38,13,25,0,0,0
2022-07-15 22:45,98,12,86,0,0,0
2022-07-15 23:00,52,6,46,0,0,0
2022-07-15 23:15,27,3,24,0,0,0
2022-07-15 23:30,57,10,47,0,0,0
2022-07-15 23:45,29,7,22,0,0,0
2022-07-16 00:00,30,3,27,0,0,0
2022-07-16 00:15,46,3,43,0,0,0
2022-07-16 00:30,20,2,18,0,0,0
2022-07-16 00:45,16,4,12,0,0,0
2022-07-16 01:00,13,5,8,0,0,0
2022-07-16 01:15,18,3,15,0,0,0
2022-07-16 01:30,8,2,6,0,0,0
2022-07-16 01:45,10,1,9,0,0,0
2022-07-16 02:00,6,0,6,0,0,0
2022-07-16 02:15,19,3,16,0,0,0
2022-07-16 02:30,6,0,6,0,0,0
2022-07-16 02:45,12,0,12,0,0,0
2022-07-16 03:00,5,0,5,0,0,0
2022-07-16 03:15,9,4,5,0,0,0
2022-07-16 03:30,7,0,7,0,0,0
2022-07-16 03:45,6,0,6,0,0,0
2022-07-16 04:00,1,0,1,0,0,0
2022-07-16 04:15,2,0,2,0,0,0
2022-07-16 04:30,1,0,1,0,0,0
2022-07-16 04:45,7,0,7,0,0,0
2022-07-16 05:00,1,0,1,0,0,0
2022-07-16 05:15,5,3,2,0,0,0
2022-07-16 05:30,3,0,3,0,0,0
2022-07-16 05:45,13,0,13,0,0,0
2022-07-16 06:00,5,2,3,0,0,0
2022-07-16 06:15,9,5,4,0,0,0
2022-07-16 06:30,14,13,1,0,0,0
2022-07-16 06:45,13,9,4,0,0,0
2022-07-16 07:00,12,9,3,0,0,0
2022-07-16 07:15,12,8,4,0,0,0
2022-07-16 07:30,31,18,13,0,0,0
2022-07-16 07:45,19,10,9,0,0,0
2022-07-16 08:00,25,17,8,0,0,0
2022-07-16 08:15,34,27,7,0,0,0
2022-07-16 08:30,23,18,5,0,0,0
2022-07-16 08:45,34,24,10,0,0,0
2022-07-16 09:00,46,33,13,0,0,0
2022-07-16 09:15,32,26,6,0,0,0
2022-07-16 09:30,55,31,24,0,0,0
2022-07-16 09:45,53,36,17,0,0,0
2022-07-16 10:00,70,37,33,0,0,0
2022-07-16 10:15,86,50,36,0,0,0
2022-07-16 10:30,90,63,27,0,0,0
2022-07-16 10:45,65,45,20,0,0,0
2022-07-16 11:00,72,49,23,0,0,0
2022-07-16 11:15,91,66,25,0,0,0
2022-07-16 11:30,68,42,26,0,0,0
2022-07-16 11:45,82,37,45,0,0,0
2022-07-16 12:00,84,47,37,0,0,0
2022-07-16 12:15,82,40,42,0,0,0
2022-07-16 12:30,125,78,47,0,0,0
2022-07-16 12:45,107,44,63,0,0,0
2022-07-16 13:00,70,26,44,0,0,0
2022-07-16 13:15,103,50,53,0,0,0
2022-07-16 13:30,89,37,52,0,0,0
2022-07-16 13:45,104,49,55,0,0,0
2022-07-16 14:00,102,36,66,0,0,0
2022-07-16 14:15,116,45,71,0,0,0
2022-07-16 14:30,102,46,56,0,0,0
2022-07-16 14:45,71,26,45,0,0,0
2022-07-16 15:00,81,32,49,0,0,0
2022-07-16 15:15,108,43,65,0,0,0
2022-07-16 15:30,82,31,51,0,0,0
2022-07-16 15:45,83,32,51,0,0,0
2022-07-16 16:00,91,38,53,0,0,0
2022-07-16 16:15,45,26,19,0,0,0
2022-07-16 16:30,111,58,53,0,0,0
2022-07-16 16:45,88,42,46,0,0,0
2022-07-16 17:00,68,33,35,0,0,0
2022-07-16 17:15,77,31,46,0,0,0
2022-07-16 17:30,83,33,50,0,0,0
2022-07-16 17:45,70,29,41,0,0,0
2022-07-16 18:00,93,43,50,0,0,0
2022-07-16 18:15,85,37,48,0,0,0
2022-07-16 18:30,76,20,56,0,0,0
2022-07-16 18:45,77,24,53,0,0,0
2022-07-16 19:00,53,21,32,0,0,0
2022-07-16 19:15,62,25,37,0,0,0
2022-07-16 19:30,45,15,30,0,0,0
2022-07-16 19:45,71,45,26,0,0,0
2022-07-16 20:00,76,27,49,0,0,0
2022-07-16 20:15,67,23,44,0,0,0
2022-07-16 20:30,50,25,25,0,0,0
2022-07-16 20:45,38,14,24,0,0,0
2022-07-16 21:00,46,21,25,0,0,0
2022-07-16 21:15,23,9,14,0,0,0
2022-07-16 21:30,50,20,30,0,0,0
2022-07-16 21:45,29,5,24,0,0,0
2022-07-16 22:00,39,20,19,0,0,0
2022-07-16 22:15,23,5,18,0,0,0
2022-07-16 22:30,41,18,23,0,0,0
2022-07-16 22:45,23,12,11,0,0,0
2022-07-16 23:00,25,2,23,0,0,0
2022-07-16 23:15,45,8,37,0,0,0
2022-07-16 23:30,22,7,15,0,0,0
2022-07-16 23:45,37,4,33,0,0,0
2022-07-17 00:00,16,7,9,0,0,0
2022-07-17 00:15,22,8,14,0,0,0
2022-07-17 00:30,12,6,6,0,0,0
2022-07-17 00:45,7,1,6,0,0,0
2022-07-17 01:00,8,2,6,0,0,0
2022-07-17 01:15,19,1,18,0,0,0
2022-07-17 01:30,17,5,12,0,0,0
2022-07-17 01:45,18,4,14,0,0,0
2022-07-17 02:00,4,0,4,0,0,0
2022-07-17 02:15,4,0,4,0,0,0
2022-07-17 02:30,2,0,2,0,0,0
2022-07-17 02:45,4,0,4,0,0,0
2022-07-17 03:00,11,3,8,0,0,0
2022-07-17 03:15,1,0,1,0,0,0
2022-07-17 03:30,7,2,5,0,0,0
2022-07-17 03:45,3,2,1,0,0,0
2022-07-17 04:00,2,0,2,0,0,0
2022-07-17 04:15,4,1,3,0,0,0
2022-07-17 04:30,9,3,6,0,0,0
2022-07-17 04:45,1,0,1,0,0,0
2022-07-17 05:00,1,0,1,0,0,0
2022-07-17 05:15,0,0,0,0,0,0
2022-07-17 05:30,9,1,8,0,0,0
2022-07-17 05:45,7,0,7,0,0,0
2022-07-17 06:00,7,0,7,0,0,0
2022-07-17 06:15,5,1,4,0,0,0
2022-07-17 06:30,5,5,0,0,0,0
2022-07-17 06:45,5,4,1,0,0,0
2022-07-17 07:00,1,1,0,0,0,0
2022-07-17 07:15,3,2,1,0,0,0
2022-07-17 07:30,7,2,5,0,0,0
2022-07-17 07:45,8,6,2,0,0,0
2022-07-17 08:00,8,1,7,0,0,0
2022-07-17 08:15,7,6,1,0,0,0
2022-07-17 08:30,20,13,7,0,0,0
2022-07-17 08:45,24,12,12,0,0,0
2022-07-17 09:00,12,9,3,0,0,0
2022-07-17 09:15,22,16,6,0,0,0
2022-07-17 09:30,25,10,15,0,0,0
2022-07-17 09:45,28,20,8,0,0,0
2022-07-17 10:00,33,21,12,0,0,0
2022-07-17 10:15,45,21,24,0,0,0
2022-07-17 10:30,31,20,11,0,0,0
2022-07-17 10:45,40,25,15,0,0,0
2022-07-17 11:00,52,21,31,0,0,0
2022-07-17 11:15,32,18,14,0,0,0
2022-07-17 11:30,43,27,16,0,0,0
2022-07-17 11:45,53,29,24,0,0,0
2022-07-17 12:00,63,22,41,0,0,0
2022-07-17 12:15,56,28,28,0,0,0
2022-07-17 12:30,43,19,24,0,0,0
2022-07-17 12:45,52,19,33,0,0,0
2022-07-17 13:00,63,33,30,0,0,0
2022-07-17 13:15,54,17,37,0,0,0
2022-07-17 13:30,67,44,23,0,0,0
2022-07-17 13:45,57,24,33,0,0,0
2022-07-17 14:00,52,19,33,0,0,0
2022-07-17 14:15,55,27,28,0,0,0
2022-07-17 14:30,63,34,29,0,0,0
2022-07-17 14:45,78,28,50,0,0,0
2022-07-17 15:00,59,33,26,0,0,0
2022-07-17 15:15,53,25,28,0,0,0
2022-07-17 15:30,83,45,38,0,0,0
2022-07-17 15:45,57,30,27,0,0,0
2022-07-17 16:00,56,26,30,0,0,0
2022-07-17 16:15,71,32,39,0,0,0
2022-07-17 16:30,63,25,38,0,0,0
2022-07-17 16:45,40,0,40,0,0,0
2022-07-17 17:00,79,36,43,0,0,0
2022-07-17 17:15,70,39,31,0,0,0
2022-07-17 17:30,75,31,44,0,0,0
2022-07-17 17:45,80,37,43,0,0,0
2022-07-17 18:00,67,25,42,0,0,0
2022-07-17 18:15,62,28,34,0,0,0
2022-07-17 18:30,67,34,33,0,0,0
2022-07-17 18:45,72,37,35,0,0,0
2022-07-17 19:00,78,26,52,0,0,0
2022-07-17 19:15,69,31,38,0,0,0
2022-07-17 19:30,60,23,37,0,0,0
2022-07-17 19:45,48,18,30,0,0,0
2022-07-17 20:00,59,20,39,0,0,0
2022-07-17 20:15,61,19,42,0,0,0
2022-07-17 20:30,44,14,30,0,0,0
2022-07-17 20:45,43,21,22,0,0,0
2022-07-17 21:00,34,12,22,0,0,0
2022-07-17 21:15,38,8,30,0,0,0
2022-07-17 21:30,22,5,17,0,0,0
2022-07-17 21:45,37,14,23,0,0,0
2022-07-17 22:00,39,12,27,0,0,0
2022-07-17 22:15,22,6,16,0,0,0
2022-07-17 22:30,22,5,17,0,0,0
2022-07-17 22:45,15,5,10,0,0,0
2022-07-17 23:00,18,1,17,0,0,0
2022-07-17 23:15,27,10,17,0,0,0
2022-07-17 23:30,7,3,4,0,0,0
2022-07-17 23:45,10,2,8,0,0,0
2022-07-18 00:00,4,3,1,0,0,0
2022-07-18 00:15,5,0,5,0,0,0
2022-07-18 00:30,7,5,2,0,0,0
2022-07-18 00:45,1,1,0,0,0,0
2022-07-18 01:00,0,0,0,0,0,0
2022-07-18 01:15,4,3,1,0,0,0
2022-07-18 01:30,2,0,2,0,0,0
2022-07-18 01:45,2,1,1,0,0,0
2022-07-18 02:00,2,1,1,0,0,0
2022-07-18 02:15,0,0,0,0,0,0
2022-07-18 02:30,1,0,1,0,0,0
2022-07-18 02:45,0,0,0,0,0,0
2022-07-18 03:00,1,0,1,0,0,0
2022-07-18 03:15,0,0,0,0,0,0
2022-07-18 03:30,0,0,0,0,0,0
2022-07-18 03:45,1,0,1,0,0,0
2022-07-18 04:00,0,0,0,0,0,0
2022-07-18 04:15,2,2,0,0,0,0
2022-07-18 04:30,1,0,1,0,0,0
2022-07-18 04:45,3,3,0,0,0,0
2022-07-18 05:00,0,0,0,0,0,0
2022-07-18 05:15,3,2,1,0,0,0
2022-07-18 05:30,11,2,9,0,0,0
2022-07-18 05:45,12,4,8,0,0,0
2022-07-18 06:00,17,7,10,0,0,0
2022-07-18 06:15,21,5,16,0,0,0
2022-07-18 06:30,41,12,29,0,0,0
2022-07-18 06:45,63,18,45,0,0,0
2022-07-18 07:00,48,15,33,0,0,0
2022-07-18 07:15,66,26,40,0,0,0
2022-07-18 07:30,92,33,59,0,0,0
2022-07-18 07:45,136,67,69,0,0,0
2022-07-18 08:00,100,43,57,0,0,0
2022-07-18 08:15,91,37,54,0,0,0
2022-07-18 08:30,75,37,38,0,0,0
2022-07-18 08:45,145,67,78,0,0,0
2022-07-18 09:00,75,34,41,0,0,0
2022-07-18 09:15,91,45,46,0,0,0
2022-07-18 09:30,91,42,49,0,0,0
2022-07-18 09:45,89,48,41,0,0,0
2022-07-18 10:00,68,31,37,0,0,0
2022-07-18 10:15,64,37,27,0,0,0
2022-07-18 10:30,65,34,31,0,0,0
2022-07-18 10:45,72,42,30,0,0,0
2022-07-18 11:00,65,30,35,0,0,0
2022-07-18 11:15,68,40,28,0,0,0
2022-07-18 11:30,105,58,47,0,0,0
2022-07-18 11:45,86,43,43,0,0,0
2022-07-18 12:00,103,44,59,0,0,0
2022-07-18 12:15,100,47,53,0,0,0
2022-07-18 12:30,101,51,50,0,0,0
2022-07-18 12:45,105,43,62,0,0,0
2022-07-18 13:00,65,30,35,0,0,0
2022-07-18 13:15,73,28,45,0,0,0
2022-07-18 13:30,87,39,48,0,0,0
2022-07-18 13:45,107,69,38,0,0,0
2022-07-18 14:00,86,48,38,0,0,0
2022-07-18 14:15,76,31,45,0,0,0
2022-07-18 14:30,92,49,43,0,0,0
2022-07-18 14:45,108,57,51,0,0,0
2022-07-18 15:00,107,54,53,0,0,0
2022-07-18 15:15,92,63,29,0,0,0
2022-07-18 15:30,82,40,42,0,0,0
2022-07-18 15:45,130,81,49,0,0,0
2022-07-18 16:00,115,54,61,0,0,0
2022-07-18 16:15,109,71,38,0,0,0
2022-07-18 16:30,97,56,41,0,0,0
2022-07-18 16:45,102,56,46,0,0,0
2022-07-18 17:00,96,49,47,0,0,0
2022-07-18 17:15,117,49,68,0,0,0
2022-07-18 17:30,110,43,67,0,0,0
2022-07-18 17:45,97,45,52,0,0,0
2022-07-18 18:00,108,50,58,0,0,0
2022-07-18 18:15,83,34,49,0,0,0
2022-07-18 18:30,73,27,46,0,0,0
2022-07-18 18:45,87,39,48,0,0,0
2022-07-18 19:00,78,31,47,0,0,0
2022-07-18 19:15,79,39,40,0,0,0
2022-07-18 19:30,65,19,46,0,0,0
2022-07-18 19:45,69,20,49,0,0,0
2022-07-18 20:00,84,24,60,0,0,0
2022-07-18 20:15,74,26,48,0,0,0
2022-07-18 20:30,46,12,34,0,0,0
2022-07-18 20:45,50,22,28,0,0,0
2022-07-18 21:00,42,16,26,0,0,0
2022-07-18 21:15,37,14,23,0,0,0
2022-07-18 21:30,49,17,32,0,0,0
2022-07-18 21:45,44,13,31,0,0,0
2022-07-18 22:00,59,15,44,0,0,0
2022-07-18 22:15,30,7,23,0,0,0
2022-07-18 22:30,31,4,27,0,0,0
2022-07-18 22:45,37,5,32,0,0,0
2022-07-18 23:00,22,8,14,0,0,0
2022-07-18 23:15,20,6,14,0,0,0
2022-07-18 23:30,18,4,14,0,0,0
2022-07-18 23:45,4,1,3,0,0,0
2022-07-19 00:00,20,5,15,0,0,0
2022-07-19 00:15,5,1,4,0,0,0
2022-07-19 00:30,3,0,3,0,0,0
2022-07-19 00:45,15,1,14,0,0,0
2022-07-19 01:00,4,0,4,0,0,0
2022-07-19 01:15,6,1,5,0,0,0
2022-07-19 01:30,4,1,3,0,0,0
2022-07-19 01:45,1,0,1,0,0,0
2022-07-19 02:00,3,0,3,0,0,0
2022-07-19 02:15,0,0,0,0,0,0
2022-07-19 02:30,0,0,0,0,0,0
2022-07-19 02:45,0,0,0,0,0,0
2022-07-19 03:00,0,0,0,0,0,0
2022-07-19 03:15,4,0,4,0,0,0
2022-07-19 03:30,2,0,2,0,0,0
2022-07-19 03:45,2,1,1,0,0,0
2022-07-19 04:00,3,0,3,0,0,0
2022-07-19 04:15,2,2,0,0,0,0
2022-07-19 04:30,0,0,0,0,0,0
2022-07-19 04:45,3,3,0,0,0,0
2022-07-19 05:00,1,1,0,0,0,0
2022-07-19 05:15,4,4,0,0,0,0
2022-07-19 05:30,18,6,12,0,0,0
2022-07-19 05:45,17,5,12,0,0,0
2022-07-19 06:00,10,0,10,0,0,0
2022-07-19 06:15,24,8,16,0,0,0
2022-07-19 06:30,33,9,24,0,0,0
2022-07-19 06:45,56,21,35,0,0,0
2022-07-19 07:00,60,22,38,0,0,0
2022-07-19 07:15,70,11,59,0,0,0
2022-07-19 07:30,101,44,57,0,0,0
2022-07-19 07:45,139,63,76,0,0,0
2022-07-19 08:00,108,46,62,0,0,0
2022-07-19 08:15,91,48,43,0,0,0
2022-07-19 08:30,99,53,46,0,0,0
2022-07-19 08:45,116,45,71,0,0,0
2022-07-19 09:00,89,35,54,0,0,0
2022-07-19 09:15,54,21,33,0,0,0
2022-07-19 09:30,91,50,41,0,0,0
2022-07-19 09:45,83,38,45,0,0,0
2022-07-19 10:00,51,29,22,0,0,0
2022-07-19 10:15,57,26,31,0,0,0
2022-07-19 10:30,63,29,34,0,0,0
2022-07-19 10:45,80,33,47,0,0,0
2022-07-19 11:00,85,47,38,0,0,0
2022-07-19 11:15,84,37,47,0,0,0
2022-07-19 11:30,76,39,37,0,0,0
2022-07-19 11:45,74,32,42,0,0,0
2022-07-19 12:00,98,42,56,0,0,0
2022-07-19 12:15,101,51,50,0,0,0
2022-07-19 12:30,67,36,31,0,0,0
2022-07-19 12:45,63,26,37,0,0,0
2022-07-19 13:00,75,21,54,0,0,0
2022-07-19 13:15,72,24,48,0,0,0
2022-07-19 13:30,75,39,36,0,0,0
2022-07-19 13:45,78,45,33,0,0,0
2022-07-19 14:00,45,17,28,0,0,0
2022-07-19 14:15,71,47,24,0,0,0
2022-07-19 14:30,82,56,26,0,0,0
2022-07-19 14:45,74,35,39,0,0,0
2022-07-19 15:00,83,51,32,0,0,0
2022-07-19 15:15,99,62,37,0,0,0
2022-07-19 15:30,84,48,36,0,0,0
2022-07-19 15:45,77,48,29,0,0,0
2022-07-19 16:00,79,54,25,0,0,0
2022-07-19 16:15,90,48,42,0,0,0
2022-07-19 16:30,106,59,47,0,0,0
2022-07-19 16:45,87,46,41,0,0,0
2022-07-19 17:00,76,39,37,0,0,0
2022-07-19 17:15,72,34,38,0,0,0
2022-07-19 17:30,59,21,38,0,0,0
2022-07-19 17:45,81,46,35,0,0,0
2022-07-19 18:00,57,17,40,0,0,0
2022-07-19 18:15,75,33,42,0,0,0
2022-07-19 18:30,68,32,36,0,0,0
2022-07-19 18:45,52,25,27,0,0,0
2022-07-19 19:00,41,16,25,0,0,0
2022-07-19 19:15,38,25,13,0,0,0
2022-07-19 19:30,45,17,28,0,0,0
2022-07-19 19:45,53,19,34,0,0,0
2022-07-19 20:00,43,17,26,0,0,0
2022-07-19 20:15,38,17,21,0,0,0
2022-07-19 20:30,27,7,20,0,0,0
2022-07-19 20:45,40,17,23,0,0,0
2022-07-19 21:00,38,17,21,0,0,0
2022-07-19 21:15,42,23,19,0,0,0
2022-07-19 21:30,28,7,21,0,0,0
2022-07-19 21:45,40,11,29,0,0,0
2022-07-19 22:00,35,14,21,0,0,0
2022-07-19 22:15,28,8,20,0,0,0
2022-07-19 22:30,23,2,21,0,0,0
2022-07-19 22:45,20,5,15,0,0,0
2022-07-19 23:00,25,12,13,0,0,0
2022-07-19 23:15,17,8,9,0,0,0
2022-07-19 23:30,12,3,9,0,0,0
2022-07-19 23:45,17,1,16,0,0,0
2022-07-20 00:00,18,5,13,0,0,0
2022-07-20 00:15,3,0,3,0,0,0
2022-07-20 00:30,5,1,4,0,0,0
2022-07-20 00:45,7,1,6,0,0,0
2022-07-20 01:00,8,2,6,0,0,0
2022-07-20 01:15,1,1,0,0,0,0
2022-07-20 01:30,1,0,1,0,0,0
2022-07-20 01:45,1,0,1,0,0,0
2022-07-20 02:00,3,0,3,0,0,0
2022-07-20 02:15,2,0,2,0,0,0
2022-07-20 02:30,1,1,0,0,0,0
2022-07-20 02:45,0,0,0,0,0,0
2022-07-20 03:00,2,0,2,0,0,0
2022-07-20 03:15,0,0,0,0,0,0
2022-07-20 03:30,0,0,0,0,0,0
2022-07-20 03:45,2,1,1,0,0,0
2022-07-20 04:00,3,0,3,0,0,0
2022-07-20 04:15,2,1,1,0,0,0
2022-07-20 04:30,0,0,0,0,0,0
2022-07-20 04:45,1,1,0,0,0,0
2022-07-20 05:00,1,0,1,0,0,0
2022-07-20 05:15,4,3,1,0,0,0
2022-07-20 05:30,17,1,16,0,0,0
2022-07-20 05:45,14,5,9,0,0,0
2022-07-20 06:00,8,3,5,0,0,0
2022-07-20 06:15,25,8,17,0,0,0
2022-07-20 06:30,37,19,18,0,0,0
2022-07-20 06:45,64,17,47,0,0,0
2022-07-20 07:00,66,22,44,0,0,0
2022-07-20 07:15,74,21,53,0,0,0
2022-07-20 07:30,95,42,53,0,0,0
2022-07-20 07:45,135,53,82,0,0,0
2022-07-20 08:00,106,39,67,0,0,0
2022-07-20 08:15,111,60,51,0,0,0
2022-07-20 08:30,110,55,55,0,0,0
2022-07-20 08:45,133,67,66,0,0,0
2022-07-20 09:00,70,26,44,0,0,0
2022-07-20 09:15,95,54,41,0,0,0
2022-07-20 09:30,99,47,52,0,0,0
2022-07-20 09:45,97,66,31,0,0,0
2022-07-20 10:00,73,42,31,0,0,0
2022-07-20 10:15,65,29,36,0,0,0
2022-07-20 10:30,99,43,56,0,0,0
2022-07-20 10:45,90,40,50,0,0,0
2022-07-20 11:00,70,32,38,0,0,0
2022-07-20 11:15,91,47,44,0,0,0
2022-07-20 11:30,87,39,48,0,0,0
2022-07-20 11:45,82,38,44,0,0,0
2022-07-20 12:00,86,41,45,0,0,0
2022-07-20 12:15,119,57,62,0,0,0
2022-07-20 12:30,102,44,58,0,0,0
2022-07-20 12:45,106,54,52,0,0,0
2022-07-20 13:00,63,31,32,0,0,0
2022-07-20 13:15,95,41,54,0,0,0
2022-07-20 13:30,88,40,48,0,0,0
2022-07-20 13:45,105,53,52,0,0,0
2022-07-20 14:00,71,34,37,0,0,0
2022-07-20 14:15,86,46,40,0,0,0
2022-07-20 14:30,75,36,39,0,0,0
2022-07-20 14:45,77,40,37,0,0,0
2022-07-20 15:00,79,39,40,0,0,0
2022-07-20 15:15,122,66,56,0,0,0
2022-07-20 15:30,102,46,56,0,0,0
2022-07-20 15:45,101,53,48,0,0,0
2022-07-20 16:00,72,42,30,0,0,0
2022-07-20 16:15,89,54,35,0,0,0
2022-07-20 16:30,103,61,42,0,0,0
2022-07-20 16:45,134,58,76,0,0,0
2022-07-20 17:00,104,47,57,0,0,0
2022-07-20 17:15,98,60,38,0,0,0
2022-07-20 17:30,86,45,41,0,0,0
2022-07-20 17:45,86,33,53,0,0,0
2022-07-20 18:00,77,38,39,0,0,0
2022-07-20 18:15,115,51,64,0,0,0
2022-07-20 18:30,86,34,52,0,0,0
2022-07-20 18:45,113,65,48,0,0,0
2022-07-20 19:00,60,24,36,0,0,0
2022-07-20 19:15,75,35,40,0,0,0
2022-07-20 19:30,66,30,36,0,0,0
2022-07-20 19:45,58,31,27,0,0,0
2022-07-20 20:00,54,17,37,0,0,0
2022-07-20 20:15,40,13,27,0,0,0
2022-07-20 20:30,48,21,27,0,0,0
2022-07-20 20:45,47,23,24,0,0,0
2022-07-20 21:00,41,30,11,0,0,0
2022-07-20 21:15,36,20,16,0,0,0
2022-07-20 21:30,38,12,26,0,0,0
2022-07-20 21:45,70,9,61,0,0,0
2022-07-20 22:00,21,7,14,0,0,0
2022-07-20 22:15,5,1,4,0,0,0
2022-07-20 22:30,13,3,10,0,0,0
2022-07-20 22:45,23,8,15,0,0,0
2022-07-20 23:00,13,7,6,0,0,0
2022-07-20 23:15,8,3,5,0,0,0
2022-07-20 23:30,11,5,6,0,0,0
2022-07-20 23:45,12,2,10,0,0,0
2022-07-21 00:00,5,3,2,0,0,0
2022-07-21 00:15,9,1,8,0,0,0
2022-07-21 00:30,5,1,4,0,0,0
2022-07-21 00:45,2,1,1,0,0,0
2022-07-21 01:00,8,0,8,0,0,0
2022-07-21 01:15,8,2,6,0,0,0
2022-07-21 01:30,4,0,4,0,0,0
2022-07-21 01:45,6,0,6,0,0,0
2022-07-21 02:00,6,0,6,0,0,0
2022-07-21 02:15,3,0,3,0,0,0
2022-07-21 02:30,5,3,2,0,0,0
2022-07-21 02:45,4,0,4,0,0,0
2022-07-21 03:00,4,0,4,0,0,0
2022-07-21 03:15,2,0,2,0,0,0
2022-07-21 03:30,3,0,3,0,0,0
2022-07-21 03:45,1,1,0,0,0,0
2022-07-21 04:00,3,2,1,0,0,0
2022-07-21 04:15,3,0,3,0,0,0
2022-07-21 04:30,0,0,0,0,0,0
2022-07-21 04:45,2,0,2,0,0,0
2022-07-21 05:00,0,0,0,0,0,0
2022-07-21 05:15,0,0,0,0,0,0
2022-07-21 05:30,5,1,4,0,0,0
2022-07-21 05:45,13,4,9,0,0,0
2022-07-21 06:00,6,2,4,0,0,0
2022-07-21 06:15,13,4,9,0,0,0
2022-07-21 06:30,27,12,15,0,0,0
2022-07-21 06:45,45,9,36,0,0,0
2022-07-21 07:00,49,14,35,0,0,0
2022-07-21 07:15,57,13,44,0,0,0
2022-07-21 07:30,68,34,34,0,0,0
2022-07-21 07:45,108,34,74,0,0,0
2022-07-21 08:00,83,27,56,0,0,0
2022-07-21 08:15,60,26,34,0,0,0
2022-07-21 08:30,67,31,36,0,0,0
2022-07-21 08:45,82,29,53,0,0,0
2022-07-21 09:00,66,21,45,0,0,0
2022-07-21 09:15,65,28,37,0,0,0
2022-07-21 09:30,64,24,40,0,0,0
2022-07-21 09:45,66,39,27,0,0,0
2022-07-21 10:00,48,27,21,0,0,0
2022-07-21 10:15,50,27,23,0,0,0
2022-07-21 10:30,56,31,25,0,0,0
2022-07-21 10:45,64,23,41,0,0,0
2022-07-21 11:00,49,20,29,0,0,0
2022-07-21 11:15,56,20,36,0,0,0
2022-07-21 11:30,58,33,25,0,0,0
2022-07-21 11:45,69,39,30,0,0,0
2022-07-21 12:00,69,24,45,0,0,0
2022-07-21 12:15,117,49,68,0,0,0
2022-07-21 12:30,90,42,48,0,0,0
2022-07-21 12:45,80,35,45,0,0,0
2022-07-21 13:00,78,28,50,0,0,0
2022-07-21 13:15,110,42,68,0,0,0
2022-07-21 13:30,91,46,45,0,0,0
2022-07-21 13:45,70,33,37,0,0,0
2022-07-21 14:00,99,51,48,0,0,0
2022-07-21 14:15,63,40,23,0,0,0
2022-07-21 14:30,108,46,62,0,0,0
2022-07-21 14:45,83,38,45,0,0,0
2022-07-21 15:00,76,24,52,0,0,0
2022-07-21 15:15,92,65,27,0,0,0
2022-07-21 15:30,88,51,37,0,0,0
2022-07-21 15:45,79,54,25,0,0,0
2022-07-21 16:00,82,47,35,0,0,0
2022-07-21 16:15,82,58,24,0,0,0
2022-07-21 16:30,95,51,44,0,0,0
2022-07-21 16:45,79,40,39,0,0,0
2022-07-21 17:00,89,45,44,0,0,0
2022-07-21 17:15,95,53,42,0,0,0
2022-07-21 17:30,91,42,49,0,0,0
2022-07-21 17:45,88,44,44,0,0,0
2022-07-21 18:00,79,39,40,0,0,0
2022-07-21 18:15,73,23,50,0,0,0
2022-07-21 18:30,59,24,35,0,0,0
2022-07-21 18:45,63,28,35,0,0,0
2022-07-21 19:00,53,28,25,0,0,0
2022-07-21 19:15,49,15,34,0,0,0
2022-07-21 19:30,50,19,31,0,0,0
2022-07-21 19:45,18,11,7,0,0,0
2022-07-21 20:00,42,15,27,0,0,0
2022-07-21 20:15,34,6,28,0,0,0
2022-07-21 20:30,41,16,25,0,0,0
2022-07-21 20:45,37,13,24,0,0,0
2022-07-21 21:00,22,11,11,0,0,0
2022-07-21 21:15,25,14,11,0,0,0
2022-07-21 21:30,21,11,10,0,0,0
2022-07-21 21:45,17,9,8,0,0,0
2022-07-21 22:00,26,11,15,0,0,0
2022-07-21 22:15,17,2,15,0,0,0
2022-07-21 22:30,23,7,16,0,0,0
2022-07-21 22:45,21,4,17,0,0,0
2022-07-21 23:00,19,6,13,0,0,0
2022-07-21 23:15,19,5,14,0,0,0
2022-07-21 23:30,18,8,10,0,0,0
2022-07-21 23:45,11,6,5,0,0,0
2022-07-22 00:00,3,0,3,0,0,0
2022-07-22 00:15,5,2,3,0,0,0
2022-07-22 00:30,11,4,7,0,0,0
2022-07-22 00:45,10,1,9,0,0,0
2022-07-22 01:00,3,1,2,0,0,0
2022-07-22 01:15,5,1,4,0,0,0
2022-07-22 01:30,3,0,3,0,0,0
2022-07-22 01:45,6,0,6,0,0,0
2022-07-22 02:00,6,1,5,0,0,0
2022-07-22 02:15,2,1,1,0,0,0
2022-07-22 02:30,2,2,0,0,0,0
2022-07-22 02:45,1,0,1,0,0,0
2022-07-22 03:00,0,0,0,0,0,0
2022-07-22 03:15,5,0,5,0,0,0
2022-07-22 03:30,2,1,1,0,0,0
2022-07-22 03:45,2,0,2,0,0,0
2022-07-22 04:00,1,1,0,0,0,0
2022-07-22 04:15,0,0,0,0,0,0
2022-07-22 04:30,0,0,0,0,0,0
2022-07-22 04:45,1,1,0,0,0,0
2022-07-22 05:00,2,1,1,0,0,0
2022-07-22 05:15,1,0,1,0,0,0
2022-07-22 05:30,19,5,14,0,0,0
2022-07-22 05:45,16,7,9,0,0,0
2022-07-22 06:00,10,2,8,0,0,0
2022-07-22 06:15,14,6,8,0,0,0
2022-07-22 06:30,23,9,14,0,0,0
2022-07-22 06:45,49,10,39,0,0,0
2022-07-22 07:00,61,17,44,0,0,0
2022-07-22 07:15,67,16,51,0,0,0
2022-07-22 07:30,99,32,67,0,0,0
2022-07-22 07:45,102,35,67,0,0,0
2022-07-22 08:00,86,33,53,0,0,0
2022-07-22 08:15,62,29,33,0,0,0
2022-07-22 08:30,65,28,37,0,0,0
2022-07-22 08:45,68,34,34,0,0,0
2022-07-22 09:00,66,33,33,0,0,0
2022-07-22 09:15,64,22,42,0,0,0
2022-07-22 09:30,64,29,35,0,0,0
2022-07-22 09:45,60,32,28,0,0,0
2022-07-22 10:00,50,27,23,0,0,0
2022-07-22 10:15,51,28,23,0,0,0
2022-07-22 10:30,52,31,21,0,0,0
2022-07-22 10:45,54,26,28,0,0,0
2022-07-22 11:00,89,41,48,0,0,0
2022-07-22 11:15,65,32,33,0,0,0
2022-07-22 11:30,67,30,37,0,0,0
2022-07-22 11:45,104,58,46,0,0,0
2022-07-22 12:00,83,35,48,0,0,0
2022-07-22 12:15,84,41,43,0,0,0
2022-07-22 12:30,94,45,49,0,0,0
2022-07-22 12:45,85,42,43,0,0,0
2022-07-22 13:00,91,43,48,0,0,0
2022-07-22 13:15,79,38,41,0,0,0
2022-07-22 13:30,84,41,43,0,0,0
2022-07-22 13:45,90,52,38,0,0,0
2022-07-22 14:00,94,49,45,0,0,0
2022-07-22 14:15,82,40,42,0,0,0
2022-07-22 14:30,96,44,52,0,0,0
2022-07-22 14:45,91,50,41,0,0,0
2022-07-22 15:00,108,48,60,0,0,0
2022-07-22 15:15,96,45,51,0,0,0
2022-07-22 15:30,94,44,50,0,0,0
2022-07-22 15:45,88,43,45,0,0,0
2022-07-22 16:00,89,57,32,0,0,0
2022-07-22 16:15,83,37,46,0,0,0
2022-07-22 16:30,79,36,43,0,0,0
2022-07-22 16:45,104,44,60,0,0,0
2022-07-22 17:00,76,39,37,0,0,0
2022-07-22 17:15,62,26,36,0,0,0
2022-07-22 17:30,71,36,35,0,0,0
2022-07-22 17:45,84,33,51,0,0,0
2022-07-22 18:00,89,36,53,0,0,0
2022-07-22 18:15,80,40,40,0,0,0
2022-07-22 18:30,82,24,58,0,0,0
2022-07-22 18:45,68,24,44,0,0,0
2022-07-22 19:00,59,25,34,0,0,0
2022-07-22 19:15,52,23,29,0,0,0
2022-07-22 19:30,45,17,28,0,0,0
2022-07-22 19:45,69,39,30,0,0,0
2022-07-22 20:00,49,23,26,0,0,0
2022-07-22 20:15,57,24,33,0,0,0
2022-07-22 20:30,41,18,23,0,0,0
2022-07-22 20:45,41,22,19,0,0,0
2022-07-22 21:00,48,21,27,0,0,0
2022-07-22 21:15,46,14,32,0,0,0
2022-07-22 21:30,30,14,16,0,0,0
2022-07-22 21:45,36,15,21,0,0,0
2022-07-22 22:00,36,11,25,0,0,0
2022-07-22 22:15,22,6,16,0,0,0
2022-07-22 22:30,20,7,13,0,0,0
2022-07-22 22:45,26,8,18,0,0,0
2022-07-22 23:00,18,5,13,0,0,0
2022-07-22 23:15,22,6,16,0,0,0
2022-07-22 23:30,14,4,10,0,0,0
2022-07-22 23:45,16,7,9,0,0,0
2022-07-23 00:00,7,1,6,0,0,0
2022-07-23 00:15,47,5,42,0,0,0
2022-07-23 00:30,80,5,75,0,0,0
2022-07-23 00:45,10,2,8,0,0,0
2022-07-23 01:00,10,2,8,0,0,0
2022-07-23 01:15,16,2,14,0,0,0
2022-07-23 01:30,7,3,4,0,0,0
2022-07-23 01:45,10,4,6,0,0,0
2022-07-23 02:00,8,2,6,0,0,0
2022-07-23 02:15,9,2,7,0,0,0
2022-07-23 02:30,3,0,3,0,0,0
2022-07-23 02:45,3,0,3,0,0,0
2022-07-23 03:00,5,0,5,0,0,0
2022-07-23 03:15,4,1,3,0,0,0
2022-07-23 03:30,8,5,3,0,0,0
2022-07-23 03:45,12,5,7,0,0,0
2022-07-23 04:00,8,0,8,0,0,0
2022-07-23 04:15,12,2,10,0,0,0
2022-07-23 04:30,3,0,3,0,0,0
2022-07-23 04:45,1,1,0,0,0,0
2022-07-23 05:00,1,0,1,0,0,0
2022-07-23 05:15,9,3,6,0,0,0
2022-07-23 05:30,8,1,7,0,0,0
2022-07-23 05:45,13,4,9,0,0,0
2022-07-23 06:00,2,1,1,0,0,0
2022-07-23 06:15,5,2,3,0,0,0
2022-07-23 06:30,8,6,2,0,0,0
2022-07-23 06:45,18,10,8,0,0,0
2022-07-23 07:00,7,4,3,0,0,0
2022-07-23 07:15,15,9,6,0,0,0
2022-07-23 07:30,20,12,8,0,0,0
2022-07-23 07:45,29,17,12,0,0,0
2022-07-23 08:00,26,19,7,0,0,0
2022-07-23 08:15,24,15,9,0,0,0
2022-07-23 08:30,29,21,8,0,0,0
2022-07-23 08:45,27,18,9,0,0,0
2022-07-23 09:00,37,20,17,0,0,0
2022-07-23 09:15,50,35,15,0,0,0
2022-07-23 09:30,60,34,26,0,0,0
2022-07-23 09:45,49,38,11,0,0,0
2022-07-23 10:00,49,30,19,0,0,0
2022-07-23 10:15,84,46,38,0,0,0
2022-07-23 10:30,73,41,32,0,0,0
2022-07-23 10:45,79,50,29,0,0,0
2022-07-23 11:00,69,43,26,0,0,0
2022-07-23 11:15,79,44,35,0,0,0
2022-07-23 11:30,89,57,32,0,0,0
2022-07-23 11:45,90,52,38,0,0,0
2022-07-23 12:00,59,31,28,0,0,0
2022-07-23 12:15,93,55,38,0,0,0
2022-07-23 12:30,101,50,51,0,0,0
2022-07-23 12:45,92,50,42,0,0,0
2022-07-23 13:00,67,21,46,0,0,0
2022-07-23 13:15,108,49,59,0,0,0
2022-07-23 13:30,104,56,48,0,0,0
2022-07-23 13:45,104,32,72,0,0,0
2022-07-23 14:00,98,46,52,0,0,0
2022-07-23 14:15,69,31,38,0,0,0
2022-07-23 14:30,74,29,45,0,0,0
2022-07-23 14:45,72,14,58,0,0,0
2022-07-23 15:00,88,38,50,0,0,0
2022-07-23 15:15,84,24,60,0,0,0
2022-07-23 15:30,82,35,47,0,0,0
2022-07-23 15:45,62,32,30,0,0,0
2022-07-23 16:00,60,24,36,0,0,0
2022-07-23 16:15,71,25,46,0,0,0
2022-07-23 16:30,71,25,46,0,0,0
2022-07-23 16:45,59,29,30,0,0,0
2022-07-23 17:00,73,35,38,0,0,0
2022-07-23 17:15,65,27,38,0,0,0
2022-07-23 17:30,60,21,39,0,0,0
2022-07-23 17:45,67,27,40,0,0,0
2022-07-23 18:00,47,22,25,0,0,0
2022-07-23 18:15,53,15,38,0,0,0
2022-07-23 18:30,69,25,44,0,0,0
2022-07-23 18:45,54,30,24,0,0,0
2022-07-23 19:00,50,21,29,0,0,0
2022-07-23 19:15,57,26,31,0,0,0
2022-07-23 19:30,38,20,18,0,0,0
2022-07-23 19:45,64,26,38,0,0,0
2022-07-23 20:00,65,32,33,0,0,0
2022-07-23 20:15,45,23,22,0,0,0
2022-07-23 20:30,41,21,20,0,0,0
2022-07-23 20:45,44,17,27,0,0,0
2022-07-23 21:00,32,21,11,0,0,0
2022-07-23 21:15,25,13,12,0,0,0
2022-07-23 21:30,34,11,23,0,0,0
2022-07-23 21:45,21,10,11,0,0,0
2022-07-23 22:00,19,4,15,0,0,0
2022-07-23 22:15,36,7,29,0,0,0
2022-07-23 22:30,30,6,24,0,0,0
2022-07-23 22:45,12,4,8,0,0,0
2022-07-23 23:00,19,8,11,0,0,0
2022-07-23 23:15,32,2,30,0,0,0
2022-07-23 23:30,12,3,9,0,0,0
2022-07-23 23:45,18,8,10,0,0,0
2022-07-24 00:00,12,3,9,0,0,0
2022-07-24 00:15,19,9,10,0,0,0
2022-07-24 00:30,77,3,74,0,0,0
2022-07-24 00:45,13,5,8,0,0,0
2022-07-24 01:00,19,5,14,0,0,0
2022-07-24 01:15,8,1,7,0,0,0
2022-07-24 01:30,5,0,5,0,0,0
2022-07-24 01:45,4,0,4,0,0,0
2022-07-24 02:00,10,2,8,0,0,0
2022-07-24 02:15,8,0,8,0,0,0
2022-07-24 02:30,7,0,7,0,0,0
2022-07-24 02:45,7,3,4,0,0,0
2022-07-24 03:00,12,1,11,0,0,0
2022-07-24 03:15,6,2,4,0,0,0
2022-07-24 03:30,10,6,4,0,0,0
2022-07-24 03:45,13,0,13,0,0,0
2022-07-24 04:00,3,1,2,0,0,0
2022-07-24 04:15,4,0,4,0,0,0
2022-07-24 04:30,4,0,4,0,0,0
2022-07-24 04:45,4,1,3,0,0,0
2022-07-24 05:00,6,0,6,0,0,0
2022-07-24 05:15,1,0,1,0,0,0
2022-07-24 05:30,13,2,11,0,0,0
2022-07-24 05:45,6,1,5,0,0,0
2022-07-24 06:00,5,0,5,0,0,0
2022-07-24 06:15,4,4,0,0,0,0
2022-07-24 06:30,6,4,2,0,0,0
2022-07-24 06:45,4,3,1,0,0,0
2022-07-24 07:00,2,0,2,0,0,0
2022-07-24 07:15,5,1,4,0,0,0
2022-07-24 07:30,7,1,6,0,0,0
2022-07-24 07:45,6,3,3,0,0,0
2022-07-24 08:00,11,7,4,0,0,0
2022-07-24 08:15,7,6,1,0,0,0
2022-07-24 08:30,10,3,7,0,0,0
2022-07-24 08:45,20,13,7,0,0,0
2022-07-24 09:00,13,6,7,0,0,0
2022-07-24 09:15,28,16,12,0,0,0
2022-07-24 09:30,37,20,17,0,0,0
2022-07-24 09:45,20,12,8,0,0,0
2022-07-24 10:00,28,12,16,0,0,0
2022-07-24 10:15,29,19,10,0,0,0
2022-07-24 10:30,28,10,18,0,0,0
2022-07-24 10:45,54,13,41,0,0,0
2022-07-24 11:00,26,14,12,0,0,0
2022-07-24 11:15,30,15,15,0,0,0
2022-07-24 11:30,27,13,14,0,0,0
2022-07-24 11:45,39,14,25,0,0,0
2022-07-24 12:00,59,28,31,0,0,0
2022-07-24 12:15,47,18,29,0,0,0
2022-07-24 12:30,41,13,28,0,0,0
2022-07-24 12:45,41,17,24,0,0,0
2022-07-24 13:00,47,21,26,0,0,0
2022-07-24 13:15,44,15,29,0,0,0
2022-07-24 13:30,47,12,35,0,0,0
2022-07-24 13:45,47,24,23,0,0,0
2022-07-24 14:00,58,25,33,0,0,0
2022-07-24 14:15,55,32,23,0,0,0
2022-07-24 14:30,53,32,21,0,0,0
2022-07-24 14:45,61,28,33,0,0,0
2022-07-24 15:00,35,22,13,0,0,0
2022-07-24 15:15,53,32,21,0,0,0
2022-07-24 15:30,46,25,21,0,0,0
2022-07-24 15:45,50,21,29,0,0,0
2022-07-24 16:00,42,22,20,0,0,0
2022-07-24 16:15,72,26,46,0,0,0
2022-07-24 16:30,55,20,35,0,0,0
2022-07-24 16:45,37,6,31,0,0,0
2022-07-24 17:00,43,17,26,0,0,0
2022-07-24 17:15,46,8,38,0,0,0
2022-07-24 17:30,43,14,29,0,0,0
2022-07-24 17:45,47,25,22,0,0,0
2022-07-24 18:00,49,26,23,0,0,0
2022-07-24 18:15,51,22,29,0,0,0
2022-07-24 18:30,55,19,36,0,0,0
2022-07-24 18:45,42,11,31,0,0,0
2022-07-24 19:00,41,20,21,0,0,0
2022-07-24 19:15,44,21,23,0,0,0
2022-07-24 19:30,37,20,17,0,0,0
2022-07-24 19:45,33,14,19,0,0,0
2022-07-24 20:00,39,18,21,0,0,0
2022-07-24 20:15,46,14,32,0,0,0
2022-07-24 20:30,47,16,31,0,0,0
2022-07-24 20:45,37,12,25,0,0,0
2022-07-24 21:00,39,14,25,0,0,0
2022-07-24 21:15,38,14,24,0,0,0
2022-07-24 21:30,23,5,18,0,0,0
2022-07-24 21:45,19,3,16,0,0,0
2022-07-24 22:00,29,11,18,0,0,0
2022-07-24 22:15,22,5,17,0,0,0
2022-07-24 22:30,12,1,11,0,0,0
2022-07-24 22:45,21,3,18,0,0,0
2022-07-24 23:00,21,4,17,0,0,0
2022-07-24 23:15,15,2,13,0,0,0
2022-07-24 23:30,10,1,9,0,0,0
2022-07-24 23:45,6,1,5,0,0,0
2022-07-25 00:00,8,2,6,0,0,0
2022-07-25 00:15,26,1,25,0,0,0
2022-07-25 00:30,4,0,4,0,0,0
2022-07-25 00:45,4,0,4,0,0,0
2022-07-25 01:00,0,0,0,0,0,0
2022-07-25 01:15,4,3,1,0,0,0
2022-07-25 01:30,0,0,0,0,0,0
2022-07-25 01:45,1,0,1,0,0,0
2022-07-25 02:00,9,1,8,0,0,0
2022-07-25 02:15,0,0,0,0,0,0
2022-07-25 02:30,1,0,1,0,0,0
2022-07-25 02:45,8,0,8,0,0,0
2022-07-25 03:00,3,0,3,0,0,0
2022-07-25 03:15,0,0,0,0,0,0
2022-07-25 03:30,2,0,2,0,0,0
2022-07-25 03:45,2,0,2,0,0,0
2022-07-25 04:00,1,1,0,0,0,0
2022-07-25 04:15,0,0,0,0,0,0
2022-07-25 04:30,2,0,2,0,0,0
2022-07-25 04:45,4,0,4,0,0,0
2022-07-25 05:00,1,1,0,0,0,0
2022-07-25 05:15,5,3,2,0,0,0
2022-07-25 05:30,7,2,5,0,0,0
2022-07-25 05:45,15,6,9,0,0,0
2022-07-25 06:00,13,5,8,0,0,0
2022-07-25 06:15,20,6,14,0,0,0
2022-07-25 06:30,43,15,28,0,0,0
2022-07-25 06:45,64,16,48,0,0,0
2022-07-25 07:00,69,17,52,0,0,0
2022-07-25 07:15,70,18,52,0,0,0
2022-07-25 07:30,106,39,67,0,0,0
2022-07-25 07:45,103,32,71,0,0,0
2022-07-25 08:00,85,29,56,0,0,0
2022-07-25 08:15,93,37,56,0,0,0
2022-07-25 08:30,85,42,43,0,0,0
2022-07-25 08:45,110,50,60,0,0,0
2022-07-25 09:00,83,36,47,0,0,0
2022-07-25 09:15,68,24,44,0,0,0
2022-07-25 09:30,68,35,33,0,0,0
2022-07-25 09:45,87,41,46,0,0,0
2022-07-25 10:00,55,27,28,0,0,0
2022-07-25 10:15,63,34,29,0,0,0
2022-07-25 10:30,60,29,31,0,0,0
2022-07-25 10:45,72,39,33,0,0,0
2022-07-25 11:00,63,30,33,0,0,0
2022-07-25 11:15,45,28,17,0,0,0
2022-07-25 11:30,60,27,33,0,0,0
2022-07-25 11:45,53,33,20,0,0,0
2022-07-25 12:00,80,42,38,0,0,0
2022-07-25 12:15,77,34,43,0,0,0
2022-07-25 12:30,77,32,45,0,0,0
2022-07-25 12:45,82,43,39,0,0,0
2022-07-25 13:00,75,31,44,0,0,0
2022-07-25 13:15,63,21,42,0,0,0
2022-07-25 13:30,74,39,35,0,0,0
2022-07-25 13:45,69,32,37,0,0,0
2022-07-25 14:00,58,31,27,0,0,0
2022-07-25 14:15,73,41,32,0,0,0
2022-07-25 14:30,74,32,42,0,0,0
2022-07-25 14:45,82,41,41,0,0,0
2022-07-25 15:00,81,37,44,0,0,0
2022-07-25 15:15,84,46,38,0,0,0
2022-07-25 15:30,81,49,32,0,0,0
2022-07-25 15:45,104,63,41,0,0,0
2022-07-25 16:00,102,62,40,0,0,0
2022-07-25 16:15,96,45,51,0,0,0
2022-07-25 16:30,111,67,44,0,0,0
2022-07-25 16:45,107,56,51,0,0,0
2022-07-25 17:00,94,43,51,0,0,0
2022-07-25 17:15,83,38,45,0,0,0
2022-07-25 17:30,91,43,48,0,0,0
2022-07-25 17:45,75,36,39,0,0,0
2022-07-25 18:00,90,39,51,0,0,0
2022-07-25 18:15,75,34,41,0,0,0
2022-07-25 18:30,67,31,36,0,0,0
2022-07-25 18:45,65,27,38,0,0,0
2022-07-25 19:00,51,20,31,0,0,0
2022-07-25 19:15,59,21,38,0,0,0
2022-07-25 19:30,54,27,27,0,0,0
2022-07-25 19:45,52,27,25,0,0,0
2022-07-25 20:00,46,11,35,0,0,0
2022-07-25 20:15,51,16,35,0,0,0
2022-07-25 20:30,28,13,15,0,0,0
2022-07-25 20:45,38,22,16,0,0,0
2022-07-25 21:00,20,5,15,0,0,0
2022-07-25 21:15,31,13,18,0,0,0
2022-07-25 21:30,35,8,27,0,0,0
2022-07-25 21:45,32,7,25,0,0,0
2022-07-25 22:00,32,13,19,0,0,0
2022-07-25 22:15,23,7,16,0,0,0
2022-07-25 22:30,22,7,15,0,0,0
2022-07-25 22:45,20,3,17,0,0,0
2022-07-25 23:00,15,1,14,0,0,0
2022-07-25 23:15,11,0,11,0,0,0
2022-07-25 23:30,21,0,21,0,0,0
2022-07-25 23:45,24,2,22,0,0,0
2022-07-26 00:00,8,0,8,0,0,0
2022-07-26 00:15,10,2,8,0,0,0
2022-07-26 00:30,3,0,3,0,0,0
2022-07-26 00:45,0,0,0,0,0,0
2022-07-26 01:00,4,0,4,0,0,0
2022-07-26 01:15,3,2,1,0,0,0
2022-07-26 01:30,4,1,3,0,0,0
2022-07-26 01:45,3,0,3,0,0,0
2022-07-26 02:00,0,0,0,0,0,0
2022-07-26 02:15,2,1,1,0,0,0
2022-07-26 02:30,1,0,1,0,0,0
2022-07-26 02:45,2,0,2,0,0,0
2022-07-26 03:00,0,0,0,0,0,0
2022-07-26 03:15,0,0,0,0,0,0
2022-07-26 03:30,0,0,0,0,0,0
2022-07-26 03:45,2,1,1,0,0,0
2022-07-26 04:00,0,0,0,0,0,0
2022-07-26 04:15,0,0,0,0,0,0
2022-07-26 04:30,0,0,0,0,0,0
2022-07-26 04:45,3,2,1,0,0,0
2022-07-26 05:00,0,0,0,0,0,0
2022-07-26 05:15,1,1,0,0,0,0
2022-07-26 05:30,14,5,9,0,0,0
2022-07-26 05:45,16,5,11,0,0,0
2022-07-26 06:00,9,4,5,0,0,0
2022-07-26 06:15,23,5,18,0,0,0
2022-07-26 06:30,37,16,21,0,0,0
2022-07-26 06:45,52,11,41,0,0,0
2022-07-26 07:00,69,22,47,0,0,0
2022-07-26 07:15,85,26,59,0,0,0
2022-07-26 07:30,93,36,57,0,0,0
2022-07-26 07:45,136,40,96,0,0,0
2022-07-26 08:00,97,42,55,0,0,0
2022-07-26 08:15,95,36,59,0,0,0
2022-07-26 08:30,79,31,48,0,0,0
2022-07-26 08:45,104,58,46,0,0,0
2022-07-26 09:00,70,35,35,0,0,0
2022-07-26 09:15,81,31,50,0,0,0
2022-07-26 09:30,51,25,26,0,0,0
2022-07-26 09:45,76,43,33,0,0,0
2022-07-26 10:00,63,38,25,0,0,0
2022-07-26 10:15,58,38,20,0,0,0
2022-07-26 10:30,33,13,20,0,0,0
2022-07-26 10:45,35,17,18,0,0,0
2022-07-26 11:00,18,10,8,0,0,0
2022-07-26 11:15,21,7,14,0,0,0
2022-07-26 11:30,62,26,36,0,0,0
2022-07-26 11:45,56,30,26,0,0,0
2022-07-26 12:00,48,29,19,0,0,0
2022-07-26 12:15,33,11,22,0,0,0
2022-07-26 12:30,48,20,28,0,0,0
2022-07-26 12:45,62,22,40,0,0,0
2022-07-26 13:00,44,21,23,0,0,0
2022-07-26 13:15,47,24,23,0,0,0
2022-07-26 13:30,65,22,43,0,0,0
2022-07-26 13:45,54,31,23,0,0,0
2022-07-26 14:00,67,29,38,0,0,0
2022-07-26 14:15,77,51,26,0,0,0
2022-07-26 14:30,26,20,6,0,0,0
2022-07-26 14:45,63,30,33,0,0,0
2022-07-26 15:00,79,43,36,0,0,0
2022-07-26 15:15,77,46,31,0,0,0
2022-07-26 15:30,83,42,41,0,0,0
2022-07-26 15:45,95,53,42,0,0,0
2022-07-26 16:00,107,57,50,0,0,0
2022-07-26 16:15,129,72,57,0,0,0
2022-07-26 16:30,88,46,42,0,0,0
2022-07-26 16:45,93,45,48,0,0,0
2022-07-26 17:00,80,37,43,0,0,0
2022-07-26 17:15,92,50,42,0,0,0
2022-07-26 17:30,93,43,50,0,0,0
2022-07-26 17:45,67,29,38,0,0,0
2022-07-26 18:00,96,38,58,0,0,0
2022-07-26 18:15,87,33,54,0,0,0
2022-07-26 18:30,77,31,46,0,0,0
2022-07-26 18:45,72,34,38,0,0,0
2022-07-26 19:00,66,26,40,0,0,0
2022-07-26 19:15,47,14,33,0,0,0
2022-07-26 19:30,46,19,27,0,0,0
2022-07-26 19:45,51,29,22,0,0,0
2022-07-26 20:00,39,14,25,0,0,0
2022-07-26 20:15,51,18,33,0,0,0
2022-07-26 20:30,29,11,18,0,0,0
2022-07-26 20:45,34,12,22,0,0,0
2022-07-26 21:00,20,12,8,0,0,0
2022-07-26 21:15,23,9,14,0,0,0
2022-07-26 21:30,26,13,13,0,0,0
2022-07-26 21:45,24,4,20,0,0,0
2022-07-26 22:00,31,12,19,0,0,0
2022-07-26 22:15,18,4,14,0,0,0
2022-07-26 22:30,16,3,13,0,0,0
2022-07-26 22:45,26,3,23,0,0,0
2022-07-26 23:00,25,3,22,0,0,0
2022-07-26 23:15,12,3,9,0,0,0
2022-07-26 23:30,14,5,9,0,0,0
2022-07-26 23:45,10,0,10,0,0,0
2022-07-27 00:00,18,2,16,0,0,0
2022-07-27 00:15,13,4,9,0,0,0
2022-07-27 00:30,3,1,2,0,0,0
2022-07-27 00:45,0,0,0,0,0,0
2022-07-27 01:00,6,3,3,0,0,0
2022-07-27 01:15,2,0,2,0,0,0
2022-07-27 01:30,0,0,0,0,0,0
2022-07-27 01:45,1,0,1,0,0,0
2022-07-27 02:00,2,1,1,0,0,0
2022-07-27 02:15,2,2,0,0,0,0
2022-07-27 02:30,0,0,0,0,0,0
2022-07-27 02:45,0,0,0,0,0,0
2022-07-27 03:00,1,1,0,0,0,0
2022-07-27 03:15,2,2,0,0,0,0
2022-07-27 03:30,2,0,2,0,0,0
2022-07-27 03:45,1,0,1,0,0,0
2022-07-27 04:00,0,0,0,0,0,0
2022-07-27 04:15,1,0,1,0,0,0
2022-07-27 04:30,2,1,1,0,0,0
2022-07-27 04:45,0,0,0,0,0,0
2022-07-27 05:00,2,2,0,0,0,0
2022-07-27 05:15,1,0,1,0,0,0
2022-07-27 05:30,10,3,7,0,0,0
2022-07-27 05:45,20,5,15,0,0,0
2022-07-27 06:00,12,4,8,0,0,0
2022-07-27 06:15,19,7,12,0,0,0
2022-07-27 06:30,31,9,22,0,0,0
2022-07-27 06:45,69,24,45,0,0,0
2022-07-27 07:00,74,30,44,0,0,0
2022-07-27 07:15,70,18,52,0,0,0
2022-07-27 07:30,81,37,44,0,0,0
2022-07-27 07:45,111,33,78,0,0,0
2022-07-27 08:00,103,39,64,0,0,0
2022-07-27 08:15,91,40,51,0,0,0
2022-07-27 08:30,72,44,28,0,0,0
2022-07-27 08:45,97,44,53,0,0,0
2022-07-27 09:00,80,36,44,0,0,0
2022-07-27 09:15,79,48,31,0,0,0
2022-07-27 09:30,92,47,45,0,0,0
2022-07-27 09:45,94,55,39,0,0,0
2022-07-27 10:00,83,47,36,0,0,0
2022-07-27 10:15,83,33,50,0,0,0
2022-07-27 10:30,93,44,49,0,0,0
2022-07-27 10:45,92,52,40,0,0,0
2022-07-27 11:00,76,36,40,0,0,0
2022-07-27 11:15,62,27,35,0,0,0
2022-07-27 11:30,83,37,46,0,0,0
2022-07-27 11:45,109,62,47,0,0,0
2022-07-27 12:00,79,37,42,0,0,0
2022-07-27 12:15,123,58,65,0,0,0
2022-07-27 12:30,101,40,61,0,0,0
2022-07-27 12:45,119,44,75,0,0,0
2022-07-27 13:00,89,41,48,0,0,0
2022-07-27 13:15,113,55,58,0,0,0
2022-07-27 13:30,96,36,60,0,0,0
2022-07-27 13:45,109,44,65,0,0,0
2022-07-27 14:00,96,40,56,0,0,0
2022-07-27 14:15,79,31,48,0,0,0
2022-07-27 14:30,99,41,58,0,0,0
2022-07-27 14:45,81,37,44,0,0,0
2022-07-27 15:00,89,37,52,0,0,0
2022-07-27 15:15,112,65,47,0,0,0
2022-07-27 15:30,117,57,60,0,0,0
2022-07-27 15:45,120,62,58,0,0,0
2022-07-27 16:00,115,64,51,0,0,0
2022-07-27 16:15,119,69,50,0,0,0
2022-07-27 16:30,116,55,61,0,0,0
2022-07-27 16:45,107,50,57,0,0,0
2022-07-27 17:00,96,43,53,0,0,0
2022-07-27 17:15,119,52,67,0,0,0
2022-07-27 17:30,106,48,58,0,0,0
2022-07-27 17:45,125,55,70,0,0,0
2022-07-27 18:00,105,48,57,0,0,0
2022-07-27 18:15,89,31,58,0,0,0
2022-07-27 18:30,85,19,66,0,0,0
2022-07-27 18:45,91,49,42,0,0,0
2022-07-27 19:00,68,19,49,0,0,0
2022-07-27 19:15,56,28,28,0,0,0
2022-07-27 19:30,71,38,33,0,0,0
2022-07-27 19:45,59,27,32,0,0,0
2022-07-27 20:00,55,21,34,0,0,0
2022-07-27 20:15,63,21,42,0,0,0
2022-07-27 20:30,39,13,26,0,0,0
2022-07-27 20:45,41,18,23,0,0,0
2022-07-27 21:00,27,12,15,0,0,0
2022-07-27 21:15,23,10,13,0,0,0
2022-07-27 21:30,32,13,19,0,0,0
2022-07-27 21:45,35,12,23,0,0,0
2022-07-27 22:00,32,12,20,0,0,0
2022-07-27 22:15,15,2,13,0,0,0
2022-07-27 22:30,22,5,17,0,0,0
2022-07-27 22:45,19,6,13,0,0,0
2022-07-27 23:00,22,11,11,0,0,0
2022-07-27 23:15,31,14,17,0,0,0
2022-07-27 23:30,10,1,9,0,0,0
2022-07-27 23:45,7,2,5,0,0,0
2022-07-28 00:00,16,1,15,0,0,0
2022-07-28 00:15,25,3,22,0,0,0
2022-07-28 00:30,5,1,4,0,0,0
2022-07-28 00:45,13,2,11,0,0,0
2022-07-28 01:00,4,3,1,0,0,0
2022-07-28 01:15,5,3,2,0,0,0
2022-07-28 01:30,1,0,1,0,0,0
2022-07-28 01:45,4,1,3,0,0,0
2022-07-28 02:00,5,0,5,0,0,0
2022-07-28 02:15,4,1,3,0,0,0
2022-07-28 02:30,7,4,3,0,0,0
2022-07-28 02:45,4,0,4,0,0,0
2022-07-28 03:00,1,0,1,0,0,0
2022-07-28 03:15,5,0,5,0,0,0
2022-07-28 03:30,3,0,3,0,0,0
2022-07-28 03:45,3,0,3,0,0,0
2022-07-28 04:00,4,0,4,0,0,0
2022-07-28 04:15,8,1,7,0,0,0
2022-07-28 04:30,0,0,0,0,0,0
2022-07-28 04:45,0,0,0,0,0,0
2022-07-28 05:00,1,0,1,0,0,0
2022-07-28 05:15,1,1,0,0,0,0
2022-07-28 05:30,7,1,6,0,0,0
2022-07-28 05:45,15,6,9,0,0,0
2022-07-28 06:00,11,2,9,0,0,0
2022-07-28 06:15,21,8,13,0,0,0
2022-07-28 06:30,36,13,23,0,0,0
2022-07-28 06:45,45,10,35,0,0,0
2022-07-28 07:00,59,22,37,0,0,0
2022-07-28 07:15,81,25,56,0,0,0
2022-07-28 07:30,86,34,52,0,0,0
2022-07-28 07:45,101,23,78,0,0,0
2022-07-28 08:00,112,50,62,0,0,0
2022-07-28 08:15,83,27,56,0,0,0
2022-07-28 08:30,86,45,41,0,0,0
2022-07-28 08:45,115,63,52,0,0,0
2022-07-28 09:00,79,32,47,0,0,0
2022-07-28 09:15,60,34,26,0,0,0
2022-07-28 09:30,84,40,44,0,0,0
2022-07-28 09:45,79,46,33,0,0,0
2022-07-28 10:00,63,32,31,0,0,0
2022-07-28 10:15,55,29,26,0,0,0
2022-07-28 10:30,58,29,29,0,0,0
2022-07-28 10:45,67,42,25,0,0,0
2022-07-28 11:00,60,38,22,0,0,0
2022-07-28 11:15,56,21,35,0,0,0
2022-07-28 11:30,74,36,38,0,0,0
2022-07-28 11:45,96,44,52,0,0,0
2022-07-28 12:00,97,64,33,0,0,0
2022-07-28 12:15,84,38,46,0,0,0
2022-07-28 12:30,101,40,61,0,0,0
2022-07-28 12:45,110,57,53,0,0,0
2022-07-28 13:00,96,41,55,0,0,0
2022-07-28 13:15,81,41,40,0,0,0
2022-07-28 13:30,87,48,39,0,0,0
2022-07-28 13:45,92,40,52,0,0,0
2022-07-28 14:00,82,41,41,0,0,0
2022-07-28 14:15,76,41,35,0,0,0
2022-07-28 14:30,98,48,50,0,0,0
2022-07-28 14:45,95,54,41,0,0,0
2022-07-28 15:00,83,31,52,0,0,0
2022-07-28 15:15,104,64,40,0,0,0
2022-07-28 15:30,118,61,57,0,0,0
2022-07-28 15:45,102,58,44,0,0,0
2022-07-28 16:00,152,93,59,0,0,0
2022-07-28 16:15,113,62,51,0,0,0
2022-07-28 16:30,114,56,58,0,0,0
2022-07-28 16:45,109,61,48,0,0,0
2022-07-28 17:00,90,50,40,0,0,0
2022-07-28 17:15,125,69,56,0,0,0
2022-07-28 17:30,99,50,49,0,0,0
2022-07-28 17:45,88,45,43,0,0,0
2022-07-28 18:00,104,44,60,0,0,0
2022-07-28 18:15,81,25,56,0,0,0
2022-07-28 18:30,86,39,47,0,0,0
2022-07-28 18:45,107,52,55,0,0,0
2022-07-28 19:00,87,38,49,0,0,0
2022-07-28 19:15,65,25,40,0,0,0
2022-07-28 19:30,53,22,31,0,0,0
2022-07-28 19:45,46,22,24,0,0,0
2022-07-28 20:00,53,17,36,0,0,0
2022-07-28 20:15,34,14,20,0,0,0
2022-07-28 20:30,47,21,26,0,0,0
2022-07-28 20:45,36,8,28,0,0,0
2022-07-28 21:00,33,14,19,0,0,0
2022-07-28 21:15,32,13,19,0,0,0
2022-07-28 21:30,24,8,16,0,0,0
2022-07-28 21:45,32,7,25,0,0,0
2022-07-28 22:00,35,10,25,0,0,0
2022-07-28 22:15,25,10,15,0,0,0
2022-07-28 22:30,31,8,23,0,0,0
2022-07-28 22:45,24,4,20,0,0,0
2022-07-28 23:00,15,1,14,0,0,0
2022-07-28 23:15,21,5,16,0,0,0
2022-07-28 23:30,21,8,13,0,0,0
2022-07-28 23:45,9,1,8,0,0,0
2022-07-29 00:00,28,3,25,0,0,0
2022-07-29 00:15,21,1,20,0,0,0
2022-07-29 00:30,11,0,11,0,0,0
2022-07-29 00:45,6,0,6,0,0,0
2022-07-29 01:00,8,1,7,0,0,0
2022-07-29 01:15,3,2,1,0,0,0
2022-07-29 01:30,5,0,5,0,0,0
2022-07-29 01:45,3,1,2,0,0,0
2022-07-29 02:00,1,0,1,0,0,0
2022-07-29 02:15,2,0,2,0,0,0
2022-07-29 02:30,2,1,1,0,0,0
2022-07-29 02:45,0,0,0,0,0,0
2022-07-29 03:00,9,6,3,0,0,0
2022-07-29 03:15,3,0,3,0,0,0
2022-07-29 03:30,1,0,1,0,0,0
2022-07-29 03:45,2,1,1,0,0,0
2022-07-29 04:00,0,0,0,0,0,0
2022-07-29 04:15,1,0,1,0,0,0
2022-07-29 04:30,0,0,0,0,0,0
2022-07-29 04:45,0,0,0,0,0,0
2022-07-29 05:00,1,0,1,0,0,0
2022-07-29 05:15,8,8,0,0,0,0
2022-07-29 05:30,12,3,9,0,0,0
2022-07-29 05:45,19,8,11,0,0,0
2022-07-29 06:00,5,0,5,0,0,0
2022-07-29 06:15,17,8,9,0,0,0
2022-07-29 06:30,32,15,17,0,0,0
2022-07-29 06:45,42,9,33,0,0,0
2022-07-29 07:00,53,21,32,0,0,0
2022-07-29 07:15,54,20,34,0,0,0
2022-07-29 07:30,73,36,37,0,0,0
2022-07-29 07:45,119,47,72,0,0,0
2022-07-29 08:00,93,29,64,0,0,0
2022-07-29 08:15,72,19,53,0,0,0
2022-07-29 08:30,58,24,34,0,0,0
2022-07-29 08:45,82,42,40,0,0,0
2022-07-29 09:00,60,25,35,0,0,0
2022-07-29 09:15,65,30,35,0,0,0
2022-07-29 09:30,58,38,20,0,0,0
2022-07-29 09:45,65,32,33,0,0,0
2022-07-29 10:00,77,42,35,0,0,0
2022-07-29 10:15,61,37,24,0,0,0
2022-07-29 10:30,81,43,38,0,0,0
2022-07-29 10:45,56,26,30,0,0,0
2022-07-29 11:00,59,28,31,0,0,0
2022-07-29 11:15,58,27,31,0,0,0
2022-07-29 11:30,72,38,34,0,0,0
2022-07-29 11:45,60,37,23,0,0,0
2022-07-29 12:00,61,30,31,0,0,0
2022-07-29 12:15,102,48,54,0,0,0
2022-07-29 12:30,82,41,41,0,0,0
2022-07-29 12:45,76,33,43,0,0,0
2022-07-29 13:00,57,34,23,0,0,0
2022-07-29 13:15,77,36,41,0,0,0
2022-07-29 13:30,76,33,43,0,0,0
2022-07-29 13:45,86,38,48,0,0,0
2022-07-29 14:00,65,28,37,0,0,0
2022-07-29 14:15,85,47,38,0,0,0
2022-07-29 14:30,94,60,34,0,0,0
2022-07-29 14:45,72,47,25,0,0,0
2022-07-29 15:00,90,50,40,0,0,0
2022-07-29 15:15,82,46,36,0,0,0
2022-07-29 15:30,85,47,38,0,0,0
2022-07-29 15:45,99,59,40,0,0,0
2022-07-29 16:00,90,51,39,0,0,0
2022-07-29 16:15,72,33,39,0,0,0
2022-07-29 16:30,92,52,40,0,0,0
2022-07-29 16:45,74,43,31,0,0,0
2022-07-29 17:00,70,39,31,0,0,0
2022-07-29 17:15,73,29,44,0,0,0
2022-07-29 17:30,82,38,44,0,0,0
2022-07-29 17:45,84,41,43,0,0,0
2022-07-29 18:00,114,48,66,0,0,0
2022-07-29 18:15,61,26,35,0,0,0
2022-07-29 18:30,74,41,33,0,0,0
2022-07-29 18:45,69,37,32,0,0,0
2022-07-29 19:00,65,28,37,0,0,0
2022-07-29 19:15,62,35,27,0,0,0
2022-07-29 19:30,63,29,34,0,0,0
2022-07-29 19:45,61,35,26,0,0,0
2022-07-29 20:00,55,10,45,0,0,0
2022-07-29 20:15,49,19,30,0,0,0
2022-07-29 20:30,17,5,12,0,0,0
2022-07-29 20:45,25,15,10,0,0,0
2022-07-29 21:00,26,10,16,0,0,0
2022-07-29 21:15,46,23,23,0,0,0
2022-07-29 21:30,39,12,27,0,0,0
2022-07-29 21:45,47,18,29,0,0,0
2022-07-29 22:00,33,11,22,0,0,0
2022-07-29 22:15,31,5,26,0,0,0
2022-07-29 22:30,39,10,29,0,0,0
2022-07-29 22:45,32,11,21,0,0,0
2022-07-29 23:00,14,4,10,0,0,0
2022-07-29 23:15,16,1,15,0,0,0
2022-07-29 23:30,22,3,19,0,0,0
2022-07-29 23:45,16,5,11,0,0,0
2022-07-30 00:00,30,4,26,0,0,0
2022-07-30 00:15,45,18,27,0,0,0
2022-07-30 00:30,21,8,13,0,0,0
2022-07-30 00:45,14,5,9,0,0,0
2022-07-30 01:00,23,9,14,0,0,0
2022-07-30 01:15,11,1,10,0,0,0
2022-07-30 01:30,10,0,10,0,0,0
2022-07-30 01:45,11,0,11,0,0,0
2022-07-30 02:00,5,1,4,0,0,0
2022-07-30 02:15,9,0,9,0,0,0
2022-07-30 02:30,16,4,12,0,0,0
2022-07-30 02:45,7,0,7,0,0,0
2022-07-30 03:00,4,3,1,0,0,0
2022-07-30 03:15,10,0,10,0,0,0
2022-07-30 03:30,5,1,4,0,0,0
2022-07-30 03:45,3,0,3,0,0,0
2022-07-30 04:00,2,0,2,0,0,0
2022-07-30 04:15,4,0,4,0,0,0
2022-07-30 04:30,9,7,2,0,0,0
2022-07-30 04:45,7,3,4,0,0,0
2022-07-30 05:00,4,1,3,0,0,0
2022-07-30 05:15,5,1,4,0,0,0
2022-07-30 05:30,7,4,3,0,0,0
2022-07-30 05:45,2,0,2,0,0,0
2022-07-30 06:00,2,2,0,0,0,0
2022-07-30 06:15,2,1,1,0,0,0
2022-07-30 06:30,4,3,1,0,0,0
2022-07-30 06:45,15,8,7,0,0,0
2022-07-30 07:00,5,2,3,0,0,0
2022-07-30 07:15,8,6,2,0,0,0
2022-07-30 07:30,10,9,1,0,0,0
2022-07-30 07:45,22,16,6,0,0,0
2022-07-30 08:00,28,14,14,0,0,0
2022-07-30 08:15,12,5,7,0,0,0
2022-07-30 08:30,25,17,8,0,0,0
2022-07-30 08:45,54,38,16,0,0,0
2022-07-30 09:00,52,38,14,0,0,0
2022-07-30 09:15,47,32,15,0,0,0
2022-07-30 09:30,62,40,22,0,0,0
2022-07-30 09:45,54,36,18,0,0,0
2022-07-30 10:00,73,39,34,0,0,0
2022-07-30 10:15,56,43,13,0,0,0
2022-07-30 10:30,76,55,21,0,0,0
2022-07-30 10:45,76,47,29,0,0,0
2022-07-30 11:00,98,66,32,0,0,0
2022-07-30 11:15,119,74,45,0,0,0
2022-07-30 11:30,90,35,55,0,0,0
2022-07-30 11:45,101,48,53,0,0,0
2022-07-30 12:00,103,64,39,0,0,0
2022-07-30 12:15,93,46,47,0,0,0
2022-07-30 12:30,86,43,43,0,0,0
2022-07-30 12:45,75,51,24,0,0,0
2022-07-30 13:00,103,46,57,0,0,0
2022-07-30 13:15,89,46,43,0,0,0
2022-07-30 13:30,100,42,58,0,0,0
2022-07-30 13:45,86,43,43,0,0,0
2022-07-30 14:00,81,34,47,0,0,0
2022-07-30 14:15,96,34,62,0,0,0
2022-07-30 14:30,66,22,44,0,0,0
2022-07-30 14:45,80,33,47,0,0,0
2022-07-30 15:00,83,23,60,0,0,0
2022-07-30 15:15,71,28,43,0,0,0
2022-07-30 15:30,72,30,42,0,0,0
2022-07-30 15:45,66,27,39,0,0,0
2022-07-30 16:00,67,25,42,0,0,0
2022-07-30 16:15,60,33,27,0,0,0
2022-07-30 16:30,52,23,29,0,0,0
2022-07-30 16:45,72,41,31,0,0,0
2022-07-30 17:00,53,21,32,0,0,0
2022-07-30 17:15,54,25,29,0,0,0
2022-07-30 17:30,69,25,44,0,0,0
2022-07-30 17:45,69,33,36,0,0,0
2022-07-30 18:00,63,28,35,0,0,0
2022-07-30 18:15,76,19,57,0,0,0
2022-07-30 18:30,66,23,43,0,0,0
2022-07-30 18:45,65,31,34,0,0,0
2022-07-30 19:00,81,42,39,0,0,0
2022-07-30 19:15,71,37,34,0,0,0
2022-07-30 19:30,61,32,29,0,0,0
2022-07-30 19:45,55,35,20,0,0,0
2022-07-30 20:00,69,30,39,0,0,0
2022-07-30 20:15,46,21,25,0,0,0
2022-07-30 20:30,54,26,28,0,0,0
2022-07-30 20:45,33,18,15,0,0,0
2022-07-30 21:00,39,18,21,0,0,0
2022-07-30 21:15,45,16,29,0,0,0
2022-07-30 21:30,11,4,7,0,0,0
2022-07-30 21:45,23,7,16,0,0,0
2022-07-30 22:00,35,9,26,0,0,0
2022-07-30 22:15,30,5,25,0,0,0
2022-07-30 22:30,39,15,24,0,0,0
2022-07-30 22:45,33,6,27,0,0,0
2022-07-30 23:00,27,11,16,0,0,0
2022-07-30 23:15,28,5,23,0,0,0
2022-07-30 23:30,19,7,12,0,0,0
2022-07-30 23:45,22,8,14,0,0,0
