Datetime,100034980 (Hammer Straße),101034980 (Hammer Straße stadteinwärts),102034980 (Hammer Straße stadtauswärts),100034980-status,101034980-status,102034980-status
2019-02-01 00:00,6,2,4,0,0,0
2019-02-01 00:15,10,4,6,0,0,0
2019-02-01 00:30,11,5,6,0,0,0
2019-02-01 00:45,8,1,7,0,0,0
2019-02-01 01:00,6,2,4,0,0,0
2019-02-01 01:15,5,1,4,0,0,0
2019-02-01 01:30,7,3,4,0,0,0
2019-02-01 01:45,4,0,4,0,0,0
2019-02-01 02:00,2,2,0,0,0,0
2019-02-01 02:15,5,3,2,0,0,0
2019-02-01 02:30,3,1,2,0,0,0
2019-02-01 02:45,0,0,0,0,0,0
2019-02-01 03:00,2,2,0,0,0,0
2019-02-01 03:15,3,2,1,0,0,0
2019-02-01 03:30,1,0,1,0,0,0
2019-02-01 03:45,1,0,1,0,0,0
2019-02-01 04:00,2,0,2,0,0,0
2019-02-01 04:15,0,0,0,0,0,0
2019-02-01 04:30,1,1,0,0,0,0
2019-02-01 04:45,1,1,0,0,0,0
2019-02-01 05:00,6,5,1,0,0,0
2019-02-01 05:15,7,5,2,0,0,0
2019-02-01 05:30,16,12,4,0,0,0
2019-02-01 05:45,21,16,5,0,0,0
2019-02-01 06:00,14,9,5,0,0,0
2019-02-01 06:15,31,27,4,0,0,0
2019-02-01 06:30,25,16,9,0,0,0
2019-02-01 06:45,54,35,19,0,0,0
2019-02-01 07:00,59,39,20,0,0,0
2019-02-01 07:15,91,60,31,0,0,0
2019-02-01 07:30,141,93,48,0,0,0
2019-02-01 07:45,163,119,44,0,0,0
2019-02-01 08:00,91,59,32,0,0,0
2019-02-01 08:15,118,79,39,0,0,0
2019-02-01 08:30,93,61,32,0,0,0
2019-02-01 08:45,98,68,30,0,0,0
2019-02-01 09:00,68,45,23,0,0,0
2019-02-01 09:15,72,48,24,0,0,0
2019-02-01 09:30,79,60,19,0,0,0
2019-02-01 09:45,94,74,20,0,0,0
2019-02-01 10:00,64,39,25,0,0,0
2019-02-01 10:15,81,50,31,0,0,0
2019-02-01 10:30,62,44,18,0,0,0
2019-02-01 10:45,80,46,34,0,0,0
2019-02-01 11:00,64,39,25,0,0,0
2019-02-01 11:15,76,41,35,0,0,0
2019-02-01 11:30,61,28,33,0,0,0
2019-02-01 11:45,109,58,51,0,0,0
2019-02-01 12:00,75,38,37,0,0,0
2019-02-01 12:15,94,45,49,0,0,0
2019-02-01 12:30,111,41,70,0,0,0
2019-02-01 12:45,115,50,65,0,0,0
2019-02-01 13:00,135,44,91,0,0,0
2019-02-01 13:15,126,54,72,0,0,0
2019-02-01 13:30,124,56,68,0,0,0
2019-02-01 13:45,144,62,82,0,0,0
2019-02-01 14:00,110,40,70,0,0,0
2019-02-01 14:15,139,59,80,0,0,0
2019-02-01 14:30,123,56,67,0,0,0
2019-02-01 14:45,126,53,73,0,0,0
2019-02-01 15:00,117,46,71,0,0,0
2019-02-01 15:15,123,50,73,0,0,0
2019-02-01 15:30,155,68,87,0,0,0
2019-02-01 15:45,128,54,74,0,0,0
2019-02-01 16:00,147,57,90,0,0,0
2019-02-01 16:15,135,46,89,0,0,0
2019-02-01 16:30,133,54,79,0,0,0
2019-02-01 16:45,138,64,74,0,0,0
2019-02-01 17:00,158,51,107,0,0,0
2019-02-01 17:15,151,51,100,0,0,0
2019-02-01 17:30,157,53,104,0,0,0
2019-02-01 17:45,131,43,88,0,0,0
2019-02-01 18:00,169,38,131,0,0,0
2019-02-01 18:15,167,43,124,0,0,0
2019-02-01 18:30,148,50,98,0,0,0
2019-02-01 18:45,149,69,80,0,0,0
2019-02-01 19:00,97,30,67,0,0,0
2019-02-01 19:15,84,34,50,0,0,0
2019-02-01 19:30,86,38,48,0,0,0
2019-02-01 19:45,93,51,42,0,0,0
2019-02-01 20:00,68,25,43,0,0,0
2019-02-01 20:15,74,25,49,0,0,0
2019-02-01 20:30,71,31,40,0,0,0
2019-02-01 20:45,52,34,18,0,0,0
2019-02-01 21:00,56,36,20,0,0,0
2019-02-01 21:15,138,102,36,0,0,0
2019-02-01 21:30,110,73,37,0,0,0
2019-02-01 21:45,69,38,31,0,0,0
2019-02-01 22:00,53,29,24,0,0,0
2019-02-01 22:15,58,31,27,0,0,0
2019-02-01 22:30,41,24,17,0,0,0
2019-02-01 22:45,46,14,32,0,0,0
2019-02-01 23:00,48,11,37,0,0,0
2019-02-01 23:15,32,16,16,0,0,0
2019-02-01 23:30,40,18,22,0,0,0
2019-02-01 23:45,34,17,17,0,0,0
2019-02-02 00:00,38,11,27,0,0,0
2019-02-02 00:15,36,11,25,0,0,0
2019-02-02 00:30,28,17,11,0,0,0
2019-02-02 00:45,27,15,12,0,0,0
2019-02-02 01:00,18,3,15,0,0,0
2019-02-02 01:15,32,13,19,0,0,0
2019-02-02 01:30,12,6,6,0,0,0
2019-02-02 01:45,15,3,12,0,0,0
2019-02-02 02:00,10,3,7,0,0,0
2019-02-02 02:15,10,3,7,0,0,0
2019-02-02 02:30,5,0,5,0,0,0
2019-02-02 02:45,19,5,14,0,0,0
2019-02-02 03:00,12,0,12,0,0,0
2019-02-02 03:15,7,2,5,0,0,0
2019-02-02 03:30,7,1,6,0,0,0
2019-02-02 03:45,8,1,7,0,0,0
2019-02-02 04:00,6,1,5,0,0,0
2019-02-02 04:15,4,2,2,0,0,0
2019-02-02 04:30,2,0,2,0,0,0
2019-02-02 04:45,1,0,1,0,0,0
2019-02-02 05:00,0,0,0,0,0,0
2019-02-02 05:15,6,0,6,0,0,0
2019-02-02 05:30,7,5,2,0,0,0
2019-02-02 05:45,10,6,4,0,0,0
2019-02-02 06:00,3,2,1,0,0,0
2019-02-02 06:15,7,2,5,0,0,0
2019-02-02 06:30,8,3,5,0,0,0
2019-02-02 06:45,7,5,2,0,0,0
2019-02-02 07:00,4,3,1,0,0,0
2019-02-02 07:15,16,10,6,0,0,0
2019-02-02 07:30,12,8,4,0,0,0
2019-02-02 07:45,34,27,7,0,0,0
2019-02-02 08:00,22,16,6,0,0,0
2019-02-02 08:15,22,12,10,0,0,0
2019-02-02 08:30,38,27,11,0,0,0
2019-02-02 08:45,49,32,17,0,0,0
2019-02-02 09:00,58,38,20,0,0,0
2019-02-02 09:15,52,29,23,0,0,0
2019-02-02 09:30,66,47,19,0,0,0
2019-02-02 09:45,65,50,15,0,0,0
2019-02-02 10:00,56,37,19,0,0,0
2019-02-02 10:15,68,44,24,0,0,0
2019-02-02 10:30,80,47,33,0,0,0
2019-02-02 10:45,99,70,29,0,0,0
2019-02-02 11:00,93,62,31,0,0,0
2019-02-02 11:15,98,60,38,0,0,0
2019-02-02 11:30,104,69,35,0,0,0
2019-02-02 11:45,121,59,62,0,0,0
2019-02-02 12:00,102,57,45,0,0,0
2019-02-02 12:15,121,61,60,0,0,0
2019-02-02 12:30,112,68,44,0,0,0
2019-02-02 12:45,110,60,50,0,0,0
2019-02-02 13:00,140,72,68,0,0,0
2019-02-02 13:15,95,45,50,0,0,0
2019-02-02 13:30,117,47,70,0,0,0
2019-02-02 13:45,111,58,53,0,0,0
2019-02-02 14:00,108,39,69,0,0,0
2019-02-02 14:15,74,35,39,0,0,0
2019-02-02 14:30,93,27,66,0,0,0
2019-02-02 14:45,93,40,53,0,0,0
2019-02-02 15:00,92,36,56,0,0,0
2019-02-02 15:15,75,25,50,0,0,0
2019-02-02 15:30,79,28,51,0,0,0
2019-02-02 15:45,80,29,51,0,0,0
2019-02-02 16:00,55,22,33,0,0,0
2019-02-02 16:15,49,12,37,0,0,0
2019-02-02 16:30,55,15,40,0,0,0
2019-02-02 16:45,74,34,40,0,0,0
2019-02-02 17:00,50,22,28,0,0,0
2019-02-02 17:15,44,17,27,0,0,0
2019-02-02 17:30,51,17,34,0,0,0
2019-02-02 17:45,48,22,26,0,0,0
2019-02-02 18:00,65,13,52,0,0,0
2019-02-02 18:15,57,15,42,0,0,0
2019-02-02 18:30,55,25,30,0,0,0
2019-02-02 18:45,38,16,22,0,0,0
2019-02-02 19:00,58,29,29,0,0,0
2019-02-02 19:15,49,18,31,0,0,0
2019-02-02 19:30,41,21,20,0,0,0
2019-02-02 19:45,47,24,23,0,0,0
2019-02-02 20:00,47,21,26,0,0,0
2019-02-02 20:15,41,22,19,0,0,0
2019-02-02 20:30,28,14,14,0,0,0
2019-02-02 20:45,40,14,26,0,0,0
2019-02-02 21:00,22,11,11,0,0,0
2019-02-02 21:15,19,7,12,0,0,0
2019-02-02 21:30,29,11,18,0,0,0
2019-02-02 21:45,10,2,8,0,0,0
2019-02-02 22:00,35,14,21,0,0,0
2019-02-02 22:15,18,8,10,0,0,0
2019-02-02 22:30,25,7,18,0,0,0
2019-02-02 22:45,34,16,18,0,0,0
2019-02-02 23:00,19,6,13,0,0,0
2019-02-02 23:15,20,8,12,0,0,0
2019-02-02 23:30,29,13,16,0,0,0
2019-02-02 23:45,35,6,29,0,0,0
2019-02-03 00:00,18,7,11,0,0,0
2019-02-03 00:15,30,11,19,0,0,0
2019-02-03 00:30,14,6,8,0,0,0
2019-02-03 00:45,17,11,6,0,0,0
2019-02-03 01:00,29,5,24,0,0,0
2019-02-03 01:15,18,6,12,0,0,0
2019-02-03 01:30,13,4,9,0,0,0
2019-02-03 01:45,16,4,12,0,0,0
2019-02-03 02:00,8,3,5,0,0,0
2019-02-03 02:15,11,3,8,0,0,0
2019-02-03 02:30,10,1,9,0,0,0
2019-02-03 02:45,5,1,4,0,0,0
2019-02-03 03:00,13,2,11,0,0,0
2019-02-03 03:15,4,0,4,0,0,0
2019-02-03 03:30,7,2,5,0,0,0
2019-02-03 03:45,4,1,3,0,0,0
2019-02-03 04:00,3,0,3,0,0,0
2019-02-03 04:15,7,2,5,0,0,0
2019-02-03 04:30,2,1,1,0,0,0
2019-02-03 04:45,1,1,0,0,0,0
2019-02-03 05:00,0,0,0,0,0,0
2019-02-03 05:15,3,0,3,0,0,0
2019-02-03 05:30,3,1,2,0,0,0
2019-02-03 05:45,2,1,1,0,0,0
2019-02-03 06:00,2,0,2,0,0,0
2019-02-03 06:15,2,0,2,0,0,0
2019-02-03 06:30,3,2,1,0,0,0
2019-02-03 06:45,3,1,2,0,0,0
2019-02-03 07:00,2,1,1,0,0,0
2019-02-03 07:15,3,2,1,0,0,0
2019-02-03 07:30,2,1,1,0,0,0
2019-02-03 07:45,21,17,4,0,0,0
2019-02-03 08:00,7,4,3,0,0,0
2019-02-03 08:15,7,4,3,0,0,0
2019-02-03 08:30,6,4,2,0,0,0
2019-02-03 08:45,13,6,7,0,0,0
2019-02-03 09:00,14,6,8,0,0,0
2019-02-03 09:15,19,12,7,0,0,0
2019-02-03 09:30,17,8,9,0,0,0
2019-02-03 09:45,43,37,6,0,0,0
2019-02-03 10:00,30,21,9,0,0,0
2019-02-03 10:15,25,17,8,0,0,0
2019-02-03 10:30,20,8,12,0,0,0
2019-02-03 10:45,29,21,8,0,0,0
2019-02-03 11:00,25,16,9,0,0,0
2019-02-03 11:15,31,13,18,0,0,0
2019-02-03 11:30,37,28,9,0,0,0
2019-02-03 11:45,46,16,30,0,0,0
2019-02-03 12:00,30,17,13,0,0,0
2019-02-03 12:15,45,21,24,0,0,0
2019-02-03 12:30,49,22,27,0,0,0
2019-02-03 12:45,60,23,37,0,0,0
2019-02-03 13:00,49,29,20,0,0,0
2019-02-03 13:15,47,25,22,0,0,0
2019-02-03 13:30,41,18,23,0,0,0
2019-02-03 13:45,53,25,28,0,0,0
2019-02-03 14:00,64,31,33,0,0,0
2019-02-03 14:15,61,27,34,0,0,0
2019-02-03 14:30,53,17,36,0,0,0
2019-02-03 14:45,69,37,32,0,0,0
2019-02-03 15:00,54,34,20,0,0,0
2019-02-03 15:15,41,17,24,0,0,0
2019-02-03 15:30,54,25,29,0,0,0
2019-02-03 15:45,63,30,33,0,0,0
2019-02-03 16:00,46,24,22,0,0,0
2019-02-03 16:15,59,28,31,0,0,0
2019-02-03 16:30,77,35,42,0,0,0
2019-02-03 16:45,49,25,24,0,0,0
2019-02-03 17:00,60,32,28,0,0,0
2019-02-03 17:15,66,30,36,0,0,0
2019-02-03 17:30,69,28,41,0,0,0
2019-02-03 17:45,69,32,37,0,0,0
2019-02-03 18:00,50,19,31,0,0,0
2019-02-03 18:15,59,28,31,0,0,0
2019-02-03 18:30,57,25,32,0,0,0
2019-02-03 18:45,37,24,13,0,0,0
2019-02-03 19:00,42,11,31,0,0,0
2019-02-03 19:15,52,20,32,0,0,0
2019-02-03 19:30,49,15,34,0,0,0
2019-02-03 19:45,45,20,25,0,0,0
2019-02-03 20:00,33,15,18,0,0,0
2019-02-03 20:15,45,12,33,0,0,0
2019-02-03 20:30,27,8,19,0,0,0
2019-02-03 20:45,27,8,19,0,0,0
2019-02-03 21:00,21,7,14,0,0,0
2019-02-03 21:15,22,6,16,0,0,0
2019-02-03 21:30,15,8,7,0,0,0
2019-02-03 21:45,24,9,15,0,0,0
2019-02-03 22:00,26,9,17,0,0,0
2019-02-03 22:15,22,9,13,0,0,0
2019-02-03 22:30,16,5,11,0,0,0
2019-02-03 22:45,6,5,1,0,0,0
2019-02-03 23:00,22,13,9,0,0,0
2019-02-03 23:15,17,13,4,0,0,0
2019-02-03 23:30,5,3,2,0,0,0
2019-02-03 23:45,7,4,3,0,0,0
2019-02-04 00:00,8,6,2,0,0,0
2019-02-04 00:15,2,0,2,0,0,0
2019-02-04 00:30,5,4,1,0,0,0
2019-02-04 00:45,3,0,3,0,0,0
2019-02-04 01:00,4,0,4,0,0,0
2019-02-04 01:15,0,0,0,0,0,0
2019-02-04 01:30,1,0,1,0,0,0
2019-02-04 01:45,0,0,0,0,0,0
2019-02-04 02:00,1,0,1,0,0,0
2019-02-04 02:15,0,0,0,0,0,0
2019-02-04 02:30,2,0,2,0,0,0
2019-02-04 02:45,0,0,0,0,0,0
2019-02-04 03:00,1,1,0,0,0,0
2019-02-04 03:15,3,1,2,0,0,0
2019-02-04 03:30,0,0,0,0,0,0
2019-02-04 03:45,0,0,0,0,0,0
2019-02-04 04:00,2,1,1,0,0,0
2019-02-04 04:15,23,4,19,0,0,0
2019-02-04 04:30,11,10,1,0,0,0
2019-02-04 04:45,9,5,4,0,0,0
2019-02-04 05:00,4,3,1,0,0,0
2019-02-04 05:15,13,12,1,0,0,0
2019-02-04 05:30,12,8,4,0,0,0
2019-02-04 05:45,18,14,4,0,0,0
2019-02-04 06:00,14,12,2,0,0,0
2019-02-04 06:15,29,24,5,0,0,0
2019-02-04 06:30,38,27,11,0,0,0
2019-02-04 06:45,55,40,15,0,0,0
2019-02-04 07:00,70,44,26,0,0,0
2019-02-04 07:15,95,58,37,0,0,0
2019-02-04 07:30,138,99,39,0,0,0
2019-02-04 07:45,169,121,48,0,0,0
2019-02-04 08:00,111,71,40,0,0,0
2019-02-04 08:15,130,79,51,0,0,0
2019-02-04 08:30,103,80,23,0,0,0
2019-02-04 08:45,113,87,26,0,0,0
2019-02-04 09:00,72,52,20,0,0,0
2019-02-04 09:15,85,59,26,0,0,0
2019-02-04 09:30,101,77,24,0,0,0
2019-02-04 09:45,68,53,15,0,0,0
2019-02-04 10:00,63,30,33,0,0,0
2019-02-04 10:15,87,44,43,0,0,0
2019-02-04 10:30,72,40,32,0,0,0
2019-02-04 10:45,100,54,46,0,0,0
2019-02-04 11:00,87,40,47,0,0,0
2019-02-04 11:15,90,44,46,0,0,0
2019-02-04 11:30,93,43,50,0,0,0
2019-02-04 11:45,94,59,35,0,0,0
2019-02-04 12:00,82,39,43,0,0,0
2019-02-04 12:15,113,54,59,0,0,0
2019-02-04 12:30,116,46,70,0,0,0
2019-02-04 12:45,92,42,50,0,0,0
2019-02-04 13:00,107,42,65,0,0,0
2019-02-04 13:15,114,51,63,0,0,0
2019-02-04 13:30,88,37,51,0,0,0
2019-02-04 13:45,134,65,69,0,0,0
2019-02-04 14:00,121,52,69,0,0,0
2019-02-04 14:15,113,52,61,0,0,0
2019-02-04 14:30,109,45,64,0,0,0
2019-02-04 14:45,129,55,74,0,0,0
2019-02-04 15:00,121,39,82,0,0,0
2019-02-04 15:15,124,56,68,0,0,0
2019-02-04 15:30,146,55,91,0,0,0
2019-02-04 15:45,118,49,69,0,0,0
2019-02-04 16:00,155,64,91,0,0,0
2019-02-04 16:15,187,77,110,0,0,0
2019-02-04 16:30,154,49,105,0,0,0
2019-02-04 16:45,198,66,132,0,0,0
2019-02-04 17:00,166,66,100,0,0,0
2019-02-04 17:15,192,60,132,0,0,0
2019-02-04 17:30,154,48,106,0,0,0
2019-02-04 17:45,193,62,131,0,0,0
2019-02-04 18:00,154,46,108,0,0,0
2019-02-04 18:15,131,47,84,0,0,0
2019-02-04 18:30,119,38,81,0,0,0
2019-02-04 18:45,133,51,82,0,0,0
2019-02-04 19:00,89,32,57,0,0,0
2019-02-04 19:15,98,34,64,0,0,0
2019-02-04 19:30,80,29,51,0,0,0
2019-02-04 19:45,89,40,49,0,0,0
2019-02-04 20:00,61,35,26,0,0,0
2019-02-04 20:15,49,17,32,0,0,0
2019-02-04 20:30,43,8,35,0,0,0
2019-02-04 20:45,36,16,20,0,0,0
2019-02-04 21:00,47,19,28,0,0,0
2019-02-04 21:15,46,12,34,0,0,0
2019-02-04 21:30,27,6,21,0,0,0
2019-02-04 21:45,47,14,33,0,0,0
2019-02-04 22:00,33,10,23,0,0,0
2019-02-04 22:15,35,14,21,0,0,0
2019-02-04 22:30,36,13,23,0,0,0
2019-02-04 22:45,35,8,27,0,0,0
2019-02-04 23:00,18,1,17,0,0,0
2019-02-04 23:15,13,3,10,0,0,0
2019-02-04 23:30,5,1,4,0,0,0
2019-02-04 23:45,13,4,9,0,0,0
2019-02-05 00:00,11,3,8,0,0,0
2019-02-05 00:15,7,3,4,0,0,0
2019-02-05 00:30,11,2,9,0,0,0
2019-02-05 00:45,5,0,5,0,0,0
2019-02-05 01:00,1,0,1,0,0,0
2019-02-05 01:15,5,1,4,0,0,0
2019-02-05 01:30,4,1,3,0,0,0
2019-02-05 01:45,6,1,5,0,0,0
2019-02-05 02:00,5,0,5,0,0,0
2019-02-05 02:15,1,0,1,0,0,0
2019-02-05 02:30,1,0,1,0,0,0
2019-02-05 02:45,1,0,1,0,0,0
2019-02-05 03:00,4,1,3,0,0,0
2019-02-05 03:15,0,0,0,0,0,0
2019-02-05 03:30,2,0,2,0,0,0
2019-02-05 03:45,0,0,0,0,0,0
2019-02-05 04:00,0,0,0,0,0,0
2019-02-05 04:15,1,0,1,0,0,0
2019-02-05 04:30,0,0,0,0,0,0
2019-02-05 04:45,6,4,2,0,0,0
2019-02-05 05:00,1,1,0,0,0,0
2019-02-05 05:15,14,13,1,0,0,0
2019-02-05 05:30,15,9,6,0,0,0
2019-02-05 05:45,22,17,5,0,0,0
2019-02-05 06:00,22,14,8,0,0,0
2019-02-05 06:15,26,21,5,0,0,0
2019-02-05 06:30,40,31,9,0,0,0
2019-02-05 06:45,56,37,19,0,0,0
2019-02-05 07:00,77,41,36,0,0,0
2019-02-05 07:15,108,68,40,0,0,0
2019-02-05 07:30,158,107,51,0,0,0
2019-02-05 07:45,169,120,49,0,0,0
2019-02-05 08:00,140,97,43,0,0,0
2019-02-05 08:15,156,107,49,0,0,0
2019-02-05 08:30,120,83,37,0,0,0
2019-02-05 08:45,118,82,36,0,0,0
2019-02-05 09:00,104,77,27,0,0,0
2019-02-05 09:15,94,62,32,0,0,0
2019-02-05 09:30,103,75,28,0,0,0
2019-02-05 09:45,117,84,33,0,0,0
2019-02-05 10:00,85,54,31,0,0,0
2019-02-05 10:15,92,69,23,0,0,0
2019-02-05 10:30,79,38,41,0,0,0
2019-02-05 10:45,100,59,41,0,0,0
2019-02-05 11:00,91,42,49,0,0,0
2019-02-05 11:15,96,40,56,0,0,0
2019-02-05 11:30,93,44,49,0,0,0
2019-02-05 11:45,90,40,50,0,0,0
2019-02-05 12:00,99,43,56,0,0,0
2019-02-05 12:15,109,48,61,0,0,0
2019-02-05 12:30,102,36,66,0,0,0
2019-02-05 12:45,124,52,72,0,0,0
2019-02-05 13:00,139,64,75,0,0,0
2019-02-05 13:15,115,44,71,0,0,0
2019-02-05 13:30,108,63,45,0,0,0
2019-02-05 13:45,125,70,55,0,0,0
2019-02-05 14:00,125,43,82,0,0,0
2019-02-05 14:15,111,49,62,0,0,0
2019-02-05 14:30,127,61,66,0,0,0
2019-02-05 14:45,132,58,74,0,0,0
2019-02-05 15:00,110,40,70,0,0,0
2019-02-05 15:15,124,49,75,0,0,0
2019-02-05 15:30,131,51,80,0,0,0
2019-02-05 15:45,148,71,77,0,0,0
2019-02-05 16:00,171,58,113,0,0,0
2019-02-05 16:15,161,65,96,0,0,0
2019-02-05 16:30,171,59,112,0,0,0
2019-02-05 16:45,168,58,110,0,0,0
2019-02-05 17:00,179,70,109,0,0,0
2019-02-05 17:15,174,55,119,0,0,0
2019-02-05 17:30,153,49,104,0,0,0
2019-02-05 17:45,196,86,110,0,0,0
2019-02-05 18:00,186,60,126,0,0,0
2019-02-05 18:15,155,60,95,0,0,0
2019-02-05 18:30,126,47,79,0,0,0
2019-02-05 18:45,125,40,85,0,0,0
2019-02-05 19:00,118,44,74,0,0,0
2019-02-05 19:15,122,55,67,0,0,0
2019-02-05 19:30,88,36,52,0,0,0
2019-02-05 19:45,105,41,64,0,0,0
2019-02-05 20:00,86,29,57,0,0,0
2019-02-05 20:15,63,19,44,0,0,0
2019-02-05 20:30,48,5,43,0,0,0
2019-02-05 20:45,42,15,27,0,0,0
2019-02-05 21:00,62,23,39,0,0,0
2019-02-05 21:15,48,10,38,0,0,0
2019-02-05 21:30,49,15,34,0,0,0
2019-02-05 21:45,48,18,30,0,0,0
2019-02-05 22:00,59,21,38,0,0,0
2019-02-05 22:15,65,16,49,0,0,0
2019-02-05 22:30,39,6,33,0,0,0
2019-02-05 22:45,53,9,44,0,0,0
2019-02-05 23:00,28,14,14,0,0,0
2019-02-05 23:15,24,2,22,0,0,0
2019-02-05 23:30,31,14,17,0,0,0
2019-02-05 23:45,20,5,15,0,0,0
2019-02-06 00:00,14,7,7,0,0,0
2019-02-06 00:15,4,3,1,0,0,0
2019-02-06 00:30,9,1,8,0,0,0
2019-02-06 00:45,10,4,6,0,0,0
2019-02-06 01:00,4,0,4,0,0,0
2019-02-06 01:15,6,2,4,0,0,0
2019-02-06 01:30,4,2,2,0,0,0
2019-02-06 01:45,5,1,4,0,0,0
2019-02-06 02:00,2,0,2,0,0,0
2019-02-06 02:15,3,0,3,0,0,0
2019-02-06 02:30,0,0,0,0,0,0
2019-02-06 02:45,2,0,2,0,0,0
2019-02-06 03:00,4,1,3,0,0,0
2019-02-06 03:15,1,1,0,0,0,0
2019-02-06 03:30,1,0,1,0,0,0
2019-02-06 03:45,3,0,3,0,0,0
2019-02-06 04:00,2,0,2,0,0,0
2019-02-06 04:15,1,1,0,0,0,0
2019-02-06 04:30,1,1,0,0,0,0
2019-02-06 04:45,4,3,1,0,0,0
2019-02-06 05:00,7,7,0,0,0,0
2019-02-06 05:15,17,11,6,0,0,0
2019-02-06 05:30,17,13,4,0,0,0
2019-02-06 05:45,21,17,4,0,0,0
2019-02-06 06:00,22,14,8,0,0,0
2019-02-06 06:15,29,25,4,0,0,0
2019-02-06 06:30,35,26,9,0,0,0
2019-02-06 06:45,73,43,30,0,0,0
2019-02-06 07:00,78,53,25,0,0,0
2019-02-06 07:15,92,59,33,0,0,0
2019-02-06 07:30,135,103,32,0,0,0
2019-02-06 07:45,150,116,34,0,0,0
2019-02-06 08:00,129,86,43,0,0,0
2019-02-06 08:15,158,107,51,0,0,0
2019-02-06 08:30,122,84,38,0,0,0
2019-02-06 08:45,127,96,31,0,0,0
2019-02-06 09:00,95,66,29,0,0,0
2019-02-06 09:15,105,71,34,0,0,0
2019-02-06 09:30,91,65,26,0,0,0
2019-02-06 09:45,115,85,30,0,0,0
2019-02-06 10:00,98,52,46,0,0,0
2019-02-06 10:15,87,56,31,0,0,0
2019-02-06 10:30,88,54,34,0,0,0
2019-02-06 10:45,108,66,42,0,0,0
2019-02-06 11:00,90,48,42,0,0,0
2019-02-06 11:15,80,42,38,0,0,0
2019-02-06 11:30,119,59,60,0,0,0
2019-02-06 11:45,111,60,51,0,0,0
2019-02-06 12:00,128,60,68,0,0,0
2019-02-06 12:15,151,70,81,0,0,0
2019-02-06 12:30,159,63,96,0,0,0
2019-02-06 12:45,123,40,83,0,0,0
2019-02-06 13:00,141,53,88,0,0,0
2019-02-06 13:15,134,53,81,0,0,0
2019-02-06 13:30,145,56,89,0,0,0
2019-02-06 13:45,146,54,92,0,0,0
2019-02-06 14:00,152,60,92,0,0,0
2019-02-06 14:15,124,48,76,0,0,0
2019-02-06 14:30,136,55,81,0,0,0
2019-02-06 14:45,141,58,83,0,0,0
2019-02-06 15:00,120,48,72,0,0,0
2019-02-06 15:15,122,48,74,0,0,0
2019-02-06 15:30,164,75,89,0,0,0
2019-02-06 15:45,141,60,81,0,0,0
2019-02-06 16:00,155,57,98,0,0,0
2019-02-06 16:15,162,70,92,0,0,0
2019-02-06 16:30,170,62,108,0,0,0
2019-02-06 16:45,176,76,100,0,0,0
2019-02-06 17:00,184,67,117,0,0,0
2019-02-06 17:15,210,76,134,0,0,0
2019-02-06 17:30,161,68,93,0,0,0
2019-02-06 17:45,181,88,93,0,0,0
2019-02-06 18:00,179,61,118,0,0,0
2019-02-06 18:15,161,70,91,0,0,0
2019-02-06 18:30,151,54,97,0,0,0
2019-02-06 18:45,138,49,89,0,0,0
2019-02-06 19:00,137,42,95,0,0,0
2019-02-06 19:15,110,41,69,0,0,0
2019-02-06 19:30,105,36,69,0,0,0
2019-02-06 19:45,90,36,54,0,0,0
2019-02-06 20:00,97,40,57,0,0,0
2019-02-06 20:15,66,17,49,0,0,0
2019-02-06 20:30,69,26,43,0,0,0
2019-02-06 20:45,57,20,37,0,0,0
2019-02-06 21:00,66,12,54,0,0,0
2019-02-06 21:15,47,14,33,0,0,0
2019-02-06 21:30,45,9,36,0,0,0
2019-02-06 21:45,49,12,37,0,0,0
2019-02-06 22:00,38,7,31,0,0,0
2019-02-06 22:15,49,15,34,0,0,0
2019-02-06 22:30,49,21,28,0,0,0
2019-02-06 22:45,33,6,27,0,0,0
2019-02-06 23:00,41,16,25,0,0,0
2019-02-06 23:15,29,8,21,0,0,0
2019-02-06 23:30,26,9,17,0,0,0
2019-02-06 23:45,20,6,14,0,0,0
2019-02-07 00:00,20,7,13,0,0,0
2019-02-07 00:15,14,5,9,0,0,0
2019-02-07 00:30,16,12,4,0,0,0
2019-02-07 00:45,10,0,10,0,0,0
2019-02-07 01:00,7,1,6,0,0,0
2019-02-07 01:15,11,5,6,0,0,0
2019-02-07 01:30,3,3,0,0,0,0
2019-02-07 01:45,6,0,6,0,0,0
2019-02-07 02:00,7,0,7,0,0,0
2019-02-07 02:15,6,0,6,0,0,0
2019-02-07 02:30,1,0,1,0,0,0
2019-02-07 02:45,0,0,0,0,0,0
2019-02-07 03:00,4,1,3,0,0,0
2019-02-07 03:15,7,0,7,0,0,0
2019-02-07 03:30,3,1,2,0,0,0
2019-02-07 03:45,3,0,3,0,0,0
2019-02-07 04:00,3,0,3,0,0,0
2019-02-07 04:15,0,0,0,0,0,0
2019-02-07 04:30,0,0,0,0,0,0
2019-02-07 04:45,3,1,2,0,0,0
2019-02-07 05:00,7,6,1,0,0,0
2019-02-07 05:15,10,8,2,0,0,0
2019-02-07 05:30,13,8,5,0,0,0
2019-02-07 05:45,19,11,8,0,0,0
2019-02-07 06:00,12,8,4,0,0,0
2019-02-07 06:15,27,22,5,0,0,0
2019-02-07 06:30,38,30,8,0,0,0
2019-02-07 06:45,61,46,15,0,0,0
2019-02-07 07:00,58,42,16,0,0,0
2019-02-07 07:15,109,60,49,0,0,0
2019-02-07 07:30,154,101,53,0,0,0
2019-02-07 07:45,189,132,57,0,0,0
2019-02-07 08:00,126,93,33,0,0,0
2019-02-07 08:15,141,93,48,0,0,0
2019-02-07 08:30,120,84,36,0,0,0
2019-02-07 08:45,125,92,33,0,0,0
2019-02-07 09:00,80,52,28,0,0,0
2019-02-07 09:15,91,57,34,0,0,0
2019-02-07 09:30,99,61,38,0,0,0
2019-02-07 09:45,117,81,36,0,0,0
2019-02-07 10:00,84,46,38,0,0,0
2019-02-07 10:15,62,35,27,0,0,0
2019-02-07 10:30,75,39,36,0,0,0
2019-02-07 10:45,95,61,34,0,0,0
2019-02-07 11:00,93,50,43,0,0,0
2019-02-07 11:15,87,49,38,0,0,0
2019-02-07 11:30,96,53,43,0,0,0
2019-02-07 11:45,96,49,47,0,0,0
2019-02-07 12:00,83,41,42,0,0,0
2019-02-07 12:15,112,41,71,0,0,0
2019-02-07 12:30,121,46,75,0,0,0
2019-02-07 12:45,119,59,60,0,0,0
2019-02-07 13:00,133,62,71,0,0,0
2019-02-07 13:15,103,38,65,0,0,0
2019-02-07 13:30,100,56,44,0,0,0
2019-02-07 13:45,141,61,80,0,0,0
2019-02-07 14:00,142,50,92,0,0,0
2019-02-07 14:15,116,38,78,0,0,0
2019-02-07 14:30,115,58,57,0,0,0
2019-02-07 14:45,167,95,72,0,0,0
2019-02-07 15:00,130,56,74,0,0,0
2019-02-07 15:15,132,62,70,0,0,0
2019-02-07 15:30,132,59,73,0,0,0
2019-02-07 15:45,142,57,85,0,0,0
2019-02-07 16:00,138,59,79,0,0,0
2019-02-07 16:15,159,74,85,0,0,0
2019-02-07 16:30,142,66,76,0,0,0
2019-02-07 16:45,161,70,91,0,0,0
2019-02-07 17:00,171,63,108,0,0,0
2019-02-07 17:15,161,58,103,0,0,0
2019-02-07 17:30,174,58,116,0,0,0
2019-02-07 17:45,171,76,95,0,0,0
2019-02-07 18:00,164,42,122,0,0,0
2019-02-07 18:15,166,48,118,0,0,0
2019-02-07 18:30,154,55,99,0,0,0
2019-02-07 18:45,128,52,76,0,0,0
2019-02-07 19:00,140,62,78,0,0,0
2019-02-07 19:15,119,39,80,0,0,0
2019-02-07 19:30,93,32,61,0,0,0
2019-02-07 19:45,105,39,66,0,0,0
2019-02-07 20:00,81,34,47,0,0,0
2019-02-07 20:15,79,18,61,0,0,0
2019-02-07 20:30,56,22,34,0,0,0
2019-02-07 20:45,40,17,23,0,0,0
2019-02-07 21:00,59,23,36,0,0,0
2019-02-07 21:15,42,12,30,0,0,0
2019-02-07 21:30,53,18,35,0,0,0
2019-02-07 21:45,59,19,40,0,0,0
2019-02-07 22:00,52,18,34,0,0,0
2019-02-07 22:15,64,18,46,0,0,0
2019-02-07 22:30,56,17,39,0,0,0
2019-02-07 22:45,28,11,17,0,0,0
2019-02-07 23:00,36,14,22,0,0,0
2019-02-07 23:15,45,10,35,0,0,0
2019-02-07 23:30,34,19,15,0,0,0
2019-02-07 23:45,19,8,11,0,0,0
2019-02-08 00:00,22,5,17,0,0,0
2019-02-08 00:15,15,2,13,0,0,0
2019-02-08 00:30,16,2,14,0,0,0
2019-02-08 00:45,11,9,2,0,0,0
2019-02-08 01:00,9,4,5,0,0,0
2019-02-08 01:15,7,0,7,0,0,0
2019-02-08 01:30,6,1,5,0,0,0
2019-02-08 01:45,6,1,5,0,0,0
2019-02-08 02:00,3,0,3,0,0,0
2019-02-08 02:15,4,1,3,0,0,0
2019-02-08 02:30,9,0,9,0,0,0
2019-02-08 02:45,1,0,1,0,0,0
2019-02-08 03:00,3,1,2,0,0,0
2019-02-08 03:15,3,0,3,0,0,0
2019-02-08 03:30,1,0,1,0,0,0
2019-02-08 03:45,0,0,0,0,0,0
2019-02-08 04:00,5,1,4,0,0,0
2019-02-08 04:15,5,0,5,0,0,0
2019-02-08 04:30,2,1,1,0,0,0
2019-02-08 04:45,3,1,2,0,0,0
2019-02-08 05:00,5,5,0,0,0,0
2019-02-08 05:15,11,9,2,0,0,0
2019-02-08 05:30,11,7,4,0,0,0
2019-02-08 05:45,18,17,1,0,0,0
2019-02-08 06:00,14,9,5,0,0,0
2019-02-08 06:15,26,21,5,0,0,0
2019-02-08 06:30,34,21,13,0,0,0
2019-02-08 06:45,82,54,28,0,0,0
2019-02-08 07:00,60,38,22,0,0,0
2019-02-08 07:15,88,59,29,0,0,0
2019-02-08 07:30,142,96,46,0,0,0
2019-02-08 07:45,170,127,43,0,0,0
2019-02-08 08:00,90,63,27,0,0,0
2019-02-08 08:15,135,95,40,0,0,0
2019-02-08 08:30,103,67,36,0,0,0
2019-02-08 08:45,106,68,38,0,0,0
2019-02-08 09:00,89,53,36,0,0,0
2019-02-08 09:15,73,49,24,0,0,0
2019-02-08 09:30,97,67,30,0,0,0
2019-02-08 09:45,91,64,27,0,0,0
2019-02-08 10:00,91,53,38,0,0,0
2019-02-08 10:15,93,53,40,0,0,0
2019-02-08 10:30,105,49,56,0,0,0
2019-02-08 10:45,97,54,43,0,0,0
2019-02-08 11:00,85,52,33,0,0,0
2019-02-08 11:15,118,66,52,0,0,0
2019-02-08 11:30,120,67,53,0,0,0
2019-02-08 11:45,125,65,60,0,0,0
2019-02-08 12:00,101,45,56,0,0,0
2019-02-08 12:15,114,51,63,0,0,0
2019-02-08 12:30,133,58,75,0,0,0
2019-02-08 12:45,160,60,100,0,0,0
2019-02-08 13:00,134,46,88,0,0,0
2019-02-08 13:15,158,54,104,0,0,0
2019-02-08 13:30,125,48,77,0,0,0
2019-02-08 13:45,143,66,77,0,0,0
2019-02-08 14:00,157,61,96,0,0,0
2019-02-08 14:15,167,57,110,0,0,0
2019-02-08 14:30,137,41,96,0,0,0
2019-02-08 14:45,143,46,97,0,0,0
2019-02-08 15:00,149,66,83,0,0,0
2019-02-08 15:15,120,59,61,0,0,0
2019-02-08 15:30,164,86,78,0,0,0
2019-02-08 15:45,137,60,77,0,0,0
2019-02-08 16:00,158,63,95,0,0,0
2019-02-08 16:15,134,61,73,0,0,0
2019-02-08 16:30,171,62,109,0,0,0
2019-02-08 16:45,148,65,83,0,0,0
2019-02-08 17:00,143,61,82,0,0,0
2019-02-08 17:15,127,50,77,0,0,0
2019-02-08 17:30,139,52,87,0,0,0
2019-02-08 17:45,136,60,76,0,0,0
2019-02-08 18:00,117,35,82,0,0,0
2019-02-08 18:15,156,77,79,0,0,0
2019-02-08 18:30,121,57,64,0,0,0
2019-02-08 18:45,135,63,72,0,0,0
2019-02-08 19:00,146,66,80,0,0,0
2019-02-08 19:15,84,43,41,0,0,0
2019-02-08 19:30,86,38,48,0,0,0
2019-02-08 19:45,110,47,63,0,0,0
2019-02-08 20:00,111,43,68,0,0,0
2019-02-08 20:15,69,31,38,0,0,0
2019-02-08 20:30,51,31,20,0,0,0
2019-02-08 20:45,62,27,35,0,0,0
2019-02-08 21:00,67,25,42,0,0,0
2019-02-08 21:15,54,19,35,0,0,0
2019-02-08 21:30,51,14,37,0,0,0
2019-02-08 21:45,43,15,28,0,0,0
2019-02-08 22:00,54,18,36,0,0,0
2019-02-08 22:15,42,16,26,0,0,0
2019-02-08 22:30,42,14,28,0,0,0
2019-02-08 22:45,50,14,36,0,0,0
2019-02-08 23:00,55,12,43,0,0,0
2019-02-08 23:15,46,13,33,0,0,0
2019-02-08 23:30,39,14,25,0,0,0
2019-02-08 23:45,43,11,32,0,0,0
2019-02-09 00:00,45,17,28,0,0,0
2019-02-09 00:15,54,23,31,0,0,0
2019-02-09 00:30,21,6,15,0,0,0
2019-02-09 00:45,19,5,14,0,0,0
2019-02-09 01:00,24,13,11,0,0,0
2019-02-09 01:15,23,3,20,0,0,0
2019-02-09 01:30,31,12,19,0,0,0
2019-02-09 01:45,11,2,9,0,0,0
2019-02-09 02:00,14,2,12,0,0,0
2019-02-09 02:15,13,2,11,0,0,0
2019-02-09 02:30,12,4,8,0,0,0
2019-02-09 02:45,8,0,8,0,0,0
2019-02-09 03:00,13,0,13,0,0,0
2019-02-09 03:15,9,2,7,0,0,0
2019-02-09 03:30,10,2,8,0,0,0
2019-02-09 03:45,11,5,6,0,0,0
2019-02-09 04:00,7,0,7,0,0,0
2019-02-09 04:15,7,1,6,0,0,0
2019-02-09 04:30,2,2,0,0,0,0
2019-02-09 04:45,1,1,0,0,0,0
2019-02-09 05:00,4,3,1,0,0,0
2019-02-09 05:15,1,0,1,0,0,0
2019-02-09 05:30,11,6,5,0,0,0
2019-02-09 05:45,9,7,2,0,0,0
2019-02-09 06:00,6,3,3,0,0,0
2019-02-09 06:15,6,4,2,0,0,0
2019-02-09 06:30,5,3,2,0,0,0
2019-02-09 06:45,11,7,4,0,0,0
2019-02-09 07:00,8,5,3,0,0,0
2019-02-09 07:15,9,7,2,0,0,0
2019-02-09 07:30,16,9,7,0,0,0
2019-02-09 07:45,41,24,17,0,0,0
2019-02-09 08:00,25,20,5,0,0,0
2019-02-09 08:15,19,11,8,0,0,0
2019-02-09 08:30,43,29,14,0,0,0
2019-02-09 08:45,61,42,19,0,0,0
2019-02-09 09:00,56,40,16,0,0,0
2019-02-09 09:15,58,46,12,0,0,0
2019-02-09 09:30,82,50,32,0,0,0
2019-02-09 09:45,83,68,15,0,0,0
2019-02-09 10:00,67,45,22,0,0,0
2019-02-09 10:15,83,52,31,0,0,0
2019-02-09 10:30,82,52,30,0,0,0
2019-02-09 10:45,109,61,48,0,0,0
2019-02-09 11:00,114,64,50,0,0,0
2019-02-09 11:15,108,69,39,0,0,0
2019-02-09 11:30,118,59,59,0,0,0
2019-02-09 11:45,128,92,36,0,0,0
2019-02-09 12:00,121,55,66,0,0,0
2019-02-09 12:15,116,70,46,0,0,0
2019-02-09 12:30,114,51,63,0,0,0
2019-02-09 12:45,130,67,63,0,0,0
2019-02-09 13:00,99,43,56,0,0,0
2019-02-09 13:15,117,54,63,0,0,0
2019-02-09 13:30,90,47,43,0,0,0
2019-02-09 13:45,121,62,59,0,0,0
2019-02-09 14:00,117,40,77,0,0,0
2019-02-09 14:15,127,42,85,0,0,0
2019-02-09 14:30,102,33,69,0,0,0
2019-02-09 14:45,109,40,69,0,0,0
2019-02-09 15:00,101,34,67,0,0,0
2019-02-09 15:15,108,51,57,0,0,0
2019-02-09 15:30,103,45,58,0,0,0
2019-02-09 15:45,90,37,53,0,0,0
2019-02-09 16:00,90,34,56,0,0,0
2019-02-09 16:15,107,45,62,0,0,0
2019-02-09 16:30,96,34,62,0,0,0
2019-02-09 16:45,94,40,54,0,0,0
2019-02-09 17:00,123,48,75,0,0,0
2019-02-09 17:15,91,39,52,0,0,0
2019-02-09 17:30,93,35,58,0,0,0
2019-02-09 17:45,124,48,76,0,0,0
2019-02-09 18:00,130,36,94,0,0,0
2019-02-09 18:15,99,16,83,0,0,0
2019-02-09 18:30,101,21,80,0,0,0
2019-02-09 18:45,106,46,60,0,0,0
2019-02-09 19:00,75,22,53,0,0,0
2019-02-09 19:15,77,34,43,0,0,0
2019-02-09 19:30,52,17,35,0,0,0
2019-02-09 19:45,76,35,41,0,0,0
2019-02-09 20:00,54,25,29,0,0,0
2019-02-09 20:15,63,30,33,0,0,0
2019-02-09 20:30,52,21,31,0,0,0
2019-02-09 20:45,45,21,24,0,0,0
2019-02-09 21:00,27,10,17,0,0,0
2019-02-09 21:15,79,50,29,0,0,0
2019-02-09 21:30,97,82,15,0,0,0
2019-02-09 21:45,43,32,11,0,0,0
2019-02-09 22:00,43,11,32,0,0,0
2019-02-09 22:15,50,32,18,0,0,0
2019-02-09 22:30,40,24,16,0,0,0
2019-02-09 22:45,38,19,19,0,0,0
2019-02-09 23:00,36,12,24,0,0,0
2019-02-09 23:15,37,17,20,0,0,0
2019-02-09 23:30,44,26,18,0,0,0
2019-02-09 23:45,36,10,26,0,0,0
2019-02-10 00:00,37,12,25,0,0,0
2019-02-10 00:15,20,4,16,0,0,0
2019-02-10 00:30,27,7,20,0,0,0
2019-02-10 00:45,33,16,17,0,0,0
2019-02-10 01:00,27,10,17,0,0,0
2019-02-10 01:15,23,9,14,0,0,0
2019-02-10 01:30,14,7,7,0,0,0
2019-02-10 01:45,19,6,13,0,0,0
2019-02-10 02:00,8,0,8,0,0,0
2019-02-10 02:15,14,6,8,0,0,0
2019-02-10 02:30,16,0,16,0,0,0
2019-02-10 02:45,15,3,12,0,0,0
2019-02-10 03:00,20,0,20,0,0,0
2019-02-10 03:15,14,2,12,0,0,0
2019-02-10 03:30,16,4,12,0,0,0
2019-02-10 03:45,8,2,6,0,0,0
2019-02-10 04:00,1,0,1,0,0,0
2019-02-10 04:15,15,5,10,0,0,0
2019-02-10 04:30,5,3,2,0,0,0
2019-02-10 04:45,5,0,5,0,0,0
2019-02-10 05:00,2,0,2,0,0,0
2019-02-10 05:15,4,1,3,0,0,0
2019-02-10 05:30,9,2,7,0,0,0
2019-02-10 05:45,3,1,2,0,0,0
2019-02-10 06:00,6,1,5,0,0,0
2019-02-10 06:15,3,3,0,0,0,0
2019-02-10 06:30,5,3,2,0,0,0
2019-02-10 06:45,5,2,3,0,0,0
2019-02-10 07:00,0,0,0,0,0,0
2019-02-10 07:15,1,0,1,0,0,0
2019-02-10 07:30,6,2,4,0,0,0
2019-02-10 07:45,13,12,1,0,0,0
2019-02-10 08:00,5,2,3,0,0,0
2019-02-10 08:15,4,2,2,0,0,0
2019-02-10 08:30,9,7,2,0,0,0
2019-02-10 08:45,7,2,5,0,0,0
2019-02-10 09:00,10,6,4,0,0,0
2019-02-10 09:15,9,6,3,0,0,0
2019-02-10 09:30,14,5,9,0,0,0
2019-02-10 09:45,27,20,7,0,0,0
2019-02-10 10:00,12,4,8,0,0,0
2019-02-10 10:15,16,8,8,0,0,0
2019-02-10 10:30,13,7,6,0,0,0
2019-02-10 10:45,25,17,8,0,0,0
2019-02-10 11:00,14,8,6,0,0,0
2019-02-10 11:15,21,12,9,0,0,0
2019-02-10 11:30,22,11,11,0,0,0
2019-02-10 11:45,19,13,6,0,0,0
2019-02-10 12:00,28,16,12,0,0,0
2019-02-10 12:15,17,8,9,0,0,0
2019-02-10 12:30,19,4,15,0,0,0
2019-02-10 12:45,32,16,16,0,0,0
2019-02-10 13:00,23,14,9,0,0,0
2019-02-10 13:15,25,12,13,0,0,0
2019-02-10 13:30,21,11,10,0,0,0
2019-02-10 13:45,25,12,13,0,0,0
2019-02-10 14:00,23,9,14,0,0,0
2019-02-10 14:15,35,24,11,0,0,0
2019-02-10 14:30,36,25,11,0,0,0
2019-02-10 14:45,39,20,19,0,0,0
2019-02-10 15:00,27,13,14,0,0,0
2019-02-10 15:15,37,16,21,0,0,0
2019-02-10 15:30,38,22,16,0,0,0
2019-02-10 15:45,42,23,19,0,0,0
2019-02-10 16:00,30,17,13,0,0,0
2019-02-10 16:15,40,21,19,0,0,0
2019-02-10 16:30,47,26,21,0,0,0
2019-02-10 16:45,47,21,26,0,0,0
2019-02-10 17:00,38,6,32,0,0,0
2019-02-10 17:15,39,14,25,0,0,0
2019-02-10 17:30,33,14,19,0,0,0
2019-02-10 17:45,48,21,27,0,0,0
2019-02-10 18:00,46,17,29,0,0,0
2019-02-10 18:15,30,12,18,0,0,0
2019-02-10 18:30,23,12,11,0,0,0
2019-02-10 18:45,30,13,17,0,0,0
2019-02-10 19:00,22,8,14,0,0,0
2019-02-10 19:15,11,8,3,0,0,0
2019-02-10 19:30,21,9,12,0,0,0
2019-02-10 19:45,29,11,18,0,0,0
2019-02-10 20:00,25,13,12,0,0,0
2019-02-10 20:15,23,4,19,0,0,0
2019-02-10 20:30,16,10,6,0,0,0
2019-02-10 20:45,18,6,12,0,0,0
2019-02-10 21:00,12,5,7,0,0,0
2019-02-10 21:15,14,6,8,0,0,0
2019-02-10 21:30,14,6,8,0,0,0
2019-02-10 21:45,10,3,7,0,0,0
2019-02-10 22:00,13,3,10,0,0,0
2019-02-10 22:15,12,4,8,0,0,0
2019-02-10 22:30,11,2,9,0,0,0
2019-02-10 22:45,9,1,8,0,0,0
2019-02-10 23:00,11,3,8,0,0,0
2019-02-10 23:15,10,3,7,0,0,0
2019-02-10 23:30,5,0,5,0,0,0
2019-02-10 23:45,5,1,4,0,0,0
2019-02-11 00:00,7,2,5,0,0,0
2019-02-11 00:15,0,0,0,0,0,0
2019-02-11 00:30,3,2,1,0,0,0
2019-02-11 00:45,2,1,1,0,0,0
2019-02-11 01:00,1,0,1,0,0,0
2019-02-11 01:15,1,0,1,0,0,0
2019-02-11 01:30,0,0,0,0,0,0
2019-02-11 01:45,0,0,0,0,0,0
2019-02-11 02:00,0,0,0,0,0,0
2019-02-11 02:15,1,1,0,0,0,0
2019-02-11 02:30,0,0,0,0,0,0
2019-02-11 02:45,1,0,1,0,0,0
2019-02-11 03:00,2,1,1,0,0,0
2019-02-11 03:15,2,0,2,0,0,0
2019-02-11 03:30,1,0,1,0,0,0
2019-02-11 03:45,2,0,2,0,0,0
2019-02-11 04:00,0,0,0,0,0,0
2019-02-11 04:15,0,0,0,0,0,0
2019-02-11 04:30,0,0,0,0,0,0
2019-02-11 04:45,2,2,0,0,0,0
2019-02-11 05:00,1,1,0,0,0,0
2019-02-11 05:15,6,2,4,0,0,0
2019-02-11 05:30,16,15,1,0,0,0
2019-02-11 05:45,28,19,9,0,0,0
2019-02-11 06:00,19,13,6,0,0,0
2019-02-11 06:15,34,26,8,0,0,0
2019-02-11 06:30,41,30,11,0,0,0
2019-02-11 06:45,63,47,16,0,0,0
2019-02-11 07:00,72,46,26,0,0,0
2019-02-11 07:15,102,67,35,0,0,0
2019-02-11 07:30,147,102,45,0,0,0
2019-02-11 07:45,173,120,53,0,0,0
2019-02-11 08:00,130,92,38,0,0,0
2019-02-11 08:15,118,82,36,0,0,0
2019-02-11 08:30,129,92,37,0,0,0
2019-02-11 08:45,137,94,43,0,0,0
2019-02-11 09:00,79,62,17,0,0,0
2019-02-11 09:15,97,67,30,0,0,0
2019-02-11 09:30,73,58,15,0,0,0
2019-02-11 09:45,88,60,28,0,0,0
2019-02-11 10:00,81,50,31,0,0,0
2019-02-11 10:15,86,48,38,0,0,0
2019-02-11 10:30,89,48,41,0,0,0
2019-02-11 10:45,90,53,37,0,0,0
2019-02-11 11:00,92,51,41,0,0,0
2019-02-11 11:15,84,39,45,0,0,0
2019-02-11 11:30,97,50,47,0,0,0
2019-02-11 11:45,86,35,51,0,0,0
2019-02-11 12:00,92,35,57,0,0,0
2019-02-11 12:15,102,46,56,0,0,0
2019-02-11 12:30,81,19,62,0,0,0
2019-02-11 12:45,113,40,73,0,0,0
2019-02-11 13:00,125,42,83,0,0,0
2019-02-11 13:15,103,38,65,0,0,0
2019-02-11 13:30,106,38,68,0,0,0
2019-02-11 13:45,89,42,47,0,0,0
2019-02-11 14:00,141,39,102,0,0,0
2019-02-11 14:15,124,46,78,0,0,0
2019-02-11 14:30,129,53,76,0,0,0
2019-02-11 14:45,129,58,71,0,0,0
2019-02-11 15:00,130,45,85,0,0,0
2019-02-11 15:15,113,50,63,0,0,0
2019-02-11 15:30,112,48,64,0,0,0
2019-02-11 15:45,148,48,100,0,0,0
2019-02-11 16:00,181,63,118,0,0,0
2019-02-11 16:15,153,37,116,0,0,0
2019-02-11 16:30,176,55,121,0,0,0
2019-02-11 16:45,182,59,123,0,0,0
2019-02-11 17:00,167,49,118,0,0,0
2019-02-11 17:15,155,52,103,0,0,0
2019-02-11 17:30,166,51,115,0,0,0
2019-02-11 17:45,171,73,98,0,0,0
2019-02-11 18:00,137,47,90,0,0,0
2019-02-11 18:15,157,53,104,0,0,0
2019-02-11 18:30,120,35,85,0,0,0
2019-02-11 18:45,123,43,80,0,0,0
2019-02-11 19:00,115,40,75,0,0,0
2019-02-11 19:15,96,32,64,0,0,0
2019-02-11 19:30,87,36,51,0,0,0
2019-02-11 19:45,85,31,54,0,0,0
2019-02-11 20:00,70,19,51,0,0,0
2019-02-11 20:15,59,23,36,0,0,0
2019-02-11 20:30,50,17,33,0,0,0
2019-02-11 20:45,42,14,28,0,0,0
2019-02-11 21:00,59,16,43,0,0,0
2019-02-11 21:15,48,16,32,0,0,0
2019-02-11 21:30,51,15,36,0,0,0
2019-02-11 21:45,46,15,31,0,0,0
2019-02-11 22:00,42,10,32,0,0,0
2019-02-11 22:15,37,13,24,0,0,0
2019-02-11 22:30,26,7,19,0,0,0
2019-02-11 22:45,32,6,26,0,0,0
2019-02-11 23:00,17,5,12,0,0,0
2019-02-11 23:15,9,0,9,0,0,0
2019-02-11 23:30,14,6,8,0,0,0
2019-02-11 23:45,15,5,10,0,0,0
2019-02-12 00:00,8,3,5,0,0,0
2019-02-12 00:15,9,2,7,0,0,0
2019-02-12 00:30,3,0,3,0,0,0
2019-02-12 00:45,2,1,1,0,0,0
2019-02-12 01:00,5,1,4,0,0,0
2019-02-12 01:15,4,3,1,0,0,0
2019-02-12 01:30,1,1,0,0,0,0
2019-02-12 01:45,3,0,3,0,0,0
2019-02-12 02:00,2,0,2,0,0,0
2019-02-12 02:15,1,0,1,0,0,0
2019-02-12 02:30,2,0,2,0,0,0
2019-02-12 02:45,2,0,2,0,0,0
2019-02-12 03:00,2,1,1,0,0,0
2019-02-12 03:15,0,0,0,0,0,0
2019-02-12 03:30,0,0,0,0,0,0
2019-02-12 03:45,2,1,1,0,0,0
2019-02-12 04:00,1,1,0,0,0,0
2019-02-12 04:15,2,2,0,0,0,0
2019-02-12 04:30,2,0,2,0,0,0
2019-02-12 04:45,1,1,0,0,0,0
2019-02-12 05:00,2,1,1,0,0,0
2019-02-12 05:15,8,5,3,0,0,0
2019-02-12 05:30,14,9,5,0,0,0
2019-02-12 05:45,18,15,3,0,0,0
2019-02-12 06:00,18,11,7,0,0,0
2019-02-12 06:15,32,28,4,0,0,0
2019-02-12 06:30,27,20,7,0,0,0
2019-02-12 06:45,68,45,23,0,0,0
2019-02-12 07:00,96,68,28,0,0,0
2019-02-12 07:15,111,69,42,0,0,0
2019-02-12 07:30,157,89,68,0,0,0
2019-02-12 07:45,173,124,49,0,0,0
2019-02-12 08:00,138,89,49,0,0,0
2019-02-12 08:15,158,120,38,0,0,0
2019-02-12 08:30,119,86,33,0,0,0
2019-02-12 08:45,128,99,29,0,0,0
2019-02-12 09:00,101,67,34,0,0,0
2019-02-12 09:15,87,53,34,0,0,0
2019-02-12 09:30,83,59,24,0,0,0
2019-02-12 09:45,112,90,22,0,0,0
2019-02-12 10:00,73,41,32,0,0,0
2019-02-12 10:15,86,50,36,0,0,0
2019-02-12 10:30,80,49,31,0,0,0
2019-02-12 10:45,96,56,40,0,0,0
2019-02-12 11:00,76,47,29,0,0,0
2019-02-12 11:15,86,49,37,0,0,0
2019-02-12 11:30,117,52,65,0,0,0
2019-02-12 11:45,83,47,36,0,0,0
2019-02-12 12:00,104,47,57,0,0,0
2019-02-12 12:15,118,44,74,0,0,0
2019-02-12 12:30,121,52,69,0,0,0
2019-02-12 12:45,108,47,61,0,0,0
2019-02-12 13:00,106,51,55,0,0,0
2019-02-12 13:15,133,52,81,0,0,0
2019-02-12 13:30,108,49,59,0,0,0
2019-02-12 13:45,127,50,77,0,0,0
2019-02-12 14:00,111,42,69,0,0,0
2019-02-12 14:15,130,47,83,0,0,0
2019-02-12 14:30,128,51,77,0,0,0
2019-02-12 14:45,144,79,65,0,0,0
2019-02-12 15:00,133,56,77,0,0,0
2019-02-12 15:15,134,53,81,0,0,0
2019-02-12 15:30,114,49,65,0,0,0
2019-02-12 15:45,147,69,78,0,0,0
2019-02-12 16:00,171,61,110,0,0,0
2019-02-12 16:15,194,87,107,0,0,0
2019-02-12 16:30,168,73,95,0,0,0
2019-02-12 16:45,185,83,102,0,0,0
2019-02-12 17:00,182,72,110,0,0,0
2019-02-12 17:15,169,65,104,0,0,0
2019-02-12 17:30,182,56,126,0,0,0
2019-02-12 17:45,189,65,124,0,0,0
2019-02-12 18:00,157,52,105,0,0,0
2019-02-12 18:15,137,56,81,0,0,0
2019-02-12 18:30,148,51,97,0,0,0
2019-02-12 18:45,146,67,79,0,0,0
2019-02-12 19:00,107,42,65,0,0,0
2019-02-12 19:15,117,43,74,0,0,0
2019-02-12 19:30,105,38,67,0,0,0
2019-02-12 19:45,97,32,65,0,0,0
2019-02-12 20:00,101,40,61,0,0,0
2019-02-12 20:15,87,24,63,0,0,0
2019-02-12 20:30,51,13,38,0,0,0
2019-02-12 20:45,51,27,24,0,0,0
2019-02-12 21:00,53,25,28,0,0,0
2019-02-12 21:15,62,9,53,0,0,0
2019-02-12 21:30,54,18,36,0,0,0
2019-02-12 21:45,43,15,28,0,0,0
2019-02-12 22:00,60,21,39,0,0,0
2019-02-12 22:15,47,10,37,0,0,0
2019-02-12 22:30,45,16,29,0,0,0
2019-02-12 22:45,39,9,30,0,0,0
2019-02-12 23:00,29,8,21,0,0,0
2019-02-12 23:15,22,5,17,0,0,0
2019-02-12 23:30,12,2,10,0,0,0
2019-02-12 23:45,9,1,8,0,0,0
2019-02-13 00:00,11,4,7,0,0,0
2019-02-13 00:15,8,0,8,0,0,0
2019-02-13 00:30,5,1,4,0,0,0
2019-02-13 00:45,7,1,6,0,0,0
2019-02-13 01:00,2,0,2,0,0,0
2019-02-13 01:15,7,0,7,0,0,0
2019-02-13 01:30,3,0,3,0,0,0
2019-02-13 01:45,2,2,0,0,0,0
2019-02-13 02:00,3,1,2,0,0,0
2019-02-13 02:15,4,2,2,0,0,0
2019-02-13 02:30,0,0,0,0,0,0
2019-02-13 02:45,1,1,0,0,0,0
2019-02-13 03:00,1,1,0,0,0,0
2019-02-13 03:15,0,0,0,0,0,0
2019-02-13 03:30,2,1,1,0,0,0
2019-02-13 03:45,1,1,0,0,0,0
2019-02-13 04:00,1,0,1,0,0,0
2019-02-13 04:15,0,0,0,0,0,0
2019-02-13 04:30,0,0,0,0,0,0
2019-02-13 04:45,5,5,0,0,0,0
2019-02-13 05:00,3,2,1,0,0,0
2019-02-13 05:15,13,8,5,0,0,0
2019-02-13 05:30,14,8,6,0,0,0
2019-02-13 05:45,21,17,4,0,0,0
2019-02-13 06:00,22,17,5,0,0,0
2019-02-13 06:15,39,30,9,0,0,0
2019-02-13 06:30,35,25,10,0,0,0
2019-02-13 06:45,57,39,18,0,0,0
2019-02-13 07:00,81,51,30,0,0,0
2019-02-13 07:15,101,60,41,0,0,0
2019-02-13 07:30,167,109,58,0,0,0
2019-02-13 07:45,173,125,48,0,0,0
2019-02-13 08:00,131,85,46,0,0,0
2019-02-13 08:15,152,96,56,0,0,0
2019-02-13 08:30,117,81,36,0,0,0
2019-02-13 08:45,131,93,38,0,0,0
2019-02-13 09:00,89,67,22,0,0,0
2019-02-13 09:15,103,76,27,0,0,0
2019-02-13 09:30,123,90,33,0,0,0
2019-02-13 09:45,134,96,38,0,0,0
2019-02-13 10:00,85,54,31,0,0,0
2019-02-13 10:15,98,49,49,0,0,0
2019-02-13 10:30,92,48,44,0,0,0
2019-02-13 10:45,125,78,47,0,0,0
2019-02-13 11:00,102,49,53,0,0,0
2019-02-13 11:15,109,54,55,0,0,0
2019-02-13 11:30,107,59,48,0,0,0
2019-02-13 11:45,125,66,59,0,0,0
2019-02-13 12:00,104,48,56,0,0,0
2019-02-13 12:15,120,53,67,0,0,0
2019-02-13 12:30,127,38,89,0,0,0
2019-02-13 12:45,154,62,92,0,0,0
2019-02-13 13:00,124,46,78,0,0,0
2019-02-13 13:15,139,43,96,0,0,0
2019-02-13 13:30,112,43,69,0,0,0
2019-02-13 13:45,113,54,59,0,0,0
2019-02-13 14:00,127,41,86,0,0,0
2019-02-13 14:15,138,43,95,0,0,0
2019-02-13 14:30,114,54,60,0,0,0
2019-02-13 14:45,134,59,75,0,0,0
2019-02-13 15:00,140,51,89,0,0,0
2019-02-13 15:15,106,51,55,0,0,0
2019-02-13 15:30,149,71,78,0,0,0
2019-02-13 15:45,148,60,88,0,0,0
2019-02-13 16:00,162,68,94,0,0,0
2019-02-13 16:15,173,57,116,0,0,0
2019-02-13 16:30,194,69,125,0,0,0
2019-02-13 16:45,167,74,93,0,0,0
2019-02-13 17:00,184,70,114,0,0,0
2019-02-13 17:15,162,68,94,0,0,0
2019-02-13 17:30,174,63,111,0,0,0
2019-02-13 17:45,184,69,115,0,0,0
2019-02-13 18:00,145,55,90,0,0,0
2019-02-13 18:15,129,50,79,0,0,0
2019-02-13 18:30,117,43,74,0,0,0
2019-02-13 18:45,143,60,83,0,0,0
2019-02-13 19:00,109,40,69,0,0,0
2019-02-13 19:15,123,51,72,0,0,0
2019-02-13 19:30,96,34,62,0,0,0
2019-02-13 19:45,114,41,73,0,0,0
2019-02-13 20:00,91,24,67,0,0,0
2019-02-13 20:15,81,23,58,0,0,0
2019-02-13 20:30,66,22,44,0,0,0
2019-02-13 20:45,63,30,33,0,0,0
2019-02-13 21:00,48,18,30,0,0,0
2019-02-13 21:15,44,12,32,0,0,0
2019-02-13 21:30,44,14,30,0,0,0
2019-02-13 21:45,55,22,33,0,0,0
2019-02-13 22:00,55,18,37,0,0,0
2019-02-13 22:15,40,14,26,0,0,0
2019-02-13 22:30,58,25,33,0,0,0
2019-02-13 22:45,47,22,25,0,0,0
2019-02-13 23:00,59,23,36,0,0,0
2019-02-13 23:15,31,12,19,0,0,0
2019-02-13 23:30,25,8,17,0,0,0
2019-02-13 23:45,36,17,19,0,0,0
2019-02-14 00:00,14,4,10,0,0,0
2019-02-14 00:15,21,6,15,0,0,0
2019-02-14 00:30,13,5,8,0,0,0
2019-02-14 00:45,9,1,8,0,0,0
2019-02-14 01:00,10,2,8,0,0,0
2019-02-14 01:15,16,11,5,0,0,0
2019-02-14 01:30,5,1,4,0,0,0
2019-02-14 01:45,12,6,6,0,0,0
2019-02-14 02:00,5,0,5,0,0,0
2019-02-14 02:15,4,0,4,0,0,0
2019-02-14 02:30,1,0,1,0,0,0
2019-02-14 02:45,3,1,2,0,0,0
2019-02-14 03:00,3,2,1,0,0,0
2019-02-14 03:15,1,0,1,0,0,0
2019-02-14 03:30,2,0,2,0,0,0
2019-02-14 03:45,4,0,4,0,0,0
2019-02-14 04:00,1,0,1,0,0,0
2019-02-14 04:15,4,0,4,0,0,0
2019-02-14 04:30,4,0,4,0,0,0
2019-02-14 04:45,5,3,2,0,0,0
2019-02-14 05:00,3,2,1,0,0,0
2019-02-14 05:15,9,8,1,0,0,0
2019-02-14 05:30,18,12,6,0,0,0
2019-02-14 05:45,19,12,7,0,0,0
2019-02-14 06:00,28,22,6,0,0,0
2019-02-14 06:15,33,25,8,0,0,0
2019-02-14 06:30,44,35,9,0,0,0
2019-02-14 06:45,48,37,11,0,0,0
2019-02-14 07:00,70,41,29,0,0,0
2019-02-14 07:15,109,73,36,0,0,0
2019-02-14 07:30,162,99,63,0,0,0
2019-02-14 07:45,178,128,50,0,0,0
2019-02-14 08:00,121,81,40,0,0,0
2019-02-14 08:15,159,101,58,0,0,0
2019-02-14 08:30,111,85,26,0,0,0
2019-02-14 08:45,133,96,37,0,0,0
2019-02-14 09:00,93,64,29,0,0,0
2019-02-14 09:15,115,86,29,0,0,0
2019-02-14 09:30,114,79,35,0,0,0
2019-02-14 09:45,120,87,33,0,0,0
2019-02-14 10:00,78,49,29,0,0,0
2019-02-14 10:15,76,46,30,0,0,0
2019-02-14 10:30,69,36,33,0,0,0
2019-02-14 10:45,98,54,44,0,0,0
2019-02-14 11:00,87,48,39,0,0,0
2019-02-14 11:15,121,62,59,0,0,0
2019-02-14 11:30,108,54,54,0,0,0
2019-02-14 11:45,103,55,48,0,0,0
2019-02-14 12:00,102,45,57,0,0,0
2019-02-14 12:15,121,45,76,0,0,0
2019-02-14 12:30,118,51,67,0,0,0
2019-02-14 12:45,134,56,78,0,0,0
2019-02-14 13:00,130,62,68,0,0,0
2019-02-14 13:15,126,55,71,0,0,0
2019-02-14 13:30,109,47,62,0,0,0
2019-02-14 13:45,143,62,81,0,0,0
2019-02-14 14:00,142,53,89,0,0,0
2019-02-14 14:15,142,68,74,0,0,0
2019-02-14 14:30,147,61,86,0,0,0
2019-02-14 14:45,159,81,78,0,0,0
2019-02-14 15:00,151,60,91,0,0,0
2019-02-14 15:15,158,71,87,0,0,0
2019-02-14 15:30,171,80,91,0,0,0
2019-02-14 15:45,186,82,104,0,0,0
2019-02-14 16:00,178,73,105,0,0,0
2019-02-14 16:15,199,91,108,0,0,0
2019-02-14 16:30,220,87,133,0,0,0
2019-02-14 16:45,166,69,97,0,0,0
2019-02-14 17:00,192,72,120,0,0,0
2019-02-14 17:15,194,80,114,0,0,0
2019-02-14 17:30,190,79,111,0,0,0
2019-02-14 17:45,228,99,129,0,0,0
2019-02-14 18:00,182,59,123,0,0,0
2019-02-14 18:15,176,62,114,0,0,0
2019-02-14 18:30,151,56,95,0,0,0
2019-02-14 18:45,184,93,91,0,0,0
2019-02-14 19:00,134,44,90,0,0,0
2019-02-14 19:15,125,50,75,0,0,0
2019-02-14 19:30,98,41,57,0,0,0
2019-02-14 19:45,98,46,52,0,0,0
2019-02-14 20:00,89,30,59,0,0,0
2019-02-14 20:15,94,36,58,0,0,0
2019-02-14 20:30,59,19,40,0,0,0
2019-02-14 20:45,82,29,53,0,0,0
2019-02-14 21:00,47,19,28,0,0,0
2019-02-14 21:15,48,8,40,0,0,0
2019-02-14 21:30,65,23,42,0,0,0
2019-02-14 21:45,65,26,39,0,0,0
2019-02-14 22:00,60,19,41,0,0,0
2019-02-14 22:15,58,15,43,0,0,0
2019-02-14 22:30,67,10,57,0,0,0
2019-02-14 22:45,46,20,26,0,0,0
2019-02-14 23:00,32,4,28,0,0,0
2019-02-14 23:15,37,14,23,0,0,0
2019-02-14 23:30,23,3,20,0,0,0
2019-02-14 23:45,33,11,22,0,0,0
2019-02-15 00:00,20,8,12,0,0,0
2019-02-15 00:15,19,6,13,0,0,0
2019-02-15 00:30,10,2,8,0,0,0
2019-02-15 00:45,9,2,7,0,0,0
2019-02-15 01:00,9,2,7,0,0,0
2019-02-15 01:15,1,0,1,0,0,0
2019-02-15 01:30,6,5,1,0,0,0
2019-02-15 01:45,5,3,2,0,0,0
2019-02-15 02:00,3,1,2,0,0,0
2019-02-15 02:15,3,0,3,0,0,0
2019-02-15 02:30,1,0,1,0,0,0
2019-02-15 02:45,1,0,1,0,0,0
2019-02-15 03:00,6,4,2,0,0,0
2019-02-15 03:15,1,1,0,0,0,0
2019-02-15 03:30,1,0,1,0,0,0
2019-02-15 03:45,1,0,1,0,0,0
2019-02-15 04:00,3,0,3,0,0,0
2019-02-15 04:15,1,1,0,0,0,0
2019-02-15 04:30,3,1,2,0,0,0
2019-02-15 04:45,2,2,0,0,0,0
2019-02-15 05:00,4,4,0,0,0,0
2019-02-15 05:15,11,5,6,0,0,0
2019-02-15 05:30,8,8,0,0,0,0
2019-02-15 05:45,27,22,5,0,0,0
2019-02-15 06:00,21,15,6,0,0,0
2019-02-15 06:15,31,24,7,0,0,0
2019-02-15 06:30,40,25,15,0,0,0
2019-02-15 06:45,68,49,19,0,0,0
2019-02-15 07:00,67,41,26,0,0,0
2019-02-15 07:15,112,77,35,0,0,0
2019-02-15 07:30,151,95,56,0,0,0
2019-02-15 07:45,157,121,36,0,0,0
2019-02-15 08:00,98,74,24,0,0,0
2019-02-15 08:15,146,102,44,0,0,0
2019-02-15 08:30,112,75,37,0,0,0
2019-02-15 08:45,136,86,50,0,0,0
2019-02-15 09:00,83,56,27,0,0,0
2019-02-15 09:15,93,57,36,0,0,0
2019-02-15 09:30,91,63,28,0,0,0
2019-02-15 09:45,116,76,40,0,0,0
2019-02-15 10:00,95,62,33,0,0,0
2019-02-15 10:15,89,57,32,0,0,0
2019-02-15 10:30,81,48,33,0,0,0
2019-02-15 10:45,96,60,36,0,0,0
2019-02-15 11:00,92,48,44,0,0,0
2019-02-15 11:15,115,49,66,0,0,0
2019-02-15 11:30,106,61,45,0,0,0
2019-02-15 11:45,130,67,63,0,0,0
2019-02-15 12:00,133,71,62,0,0,0
2019-02-15 12:15,129,71,58,0,0,0
2019-02-15 12:30,146,48,98,0,0,0
2019-02-15 12:45,166,74,92,0,0,0
2019-02-15 13:00,179,63,116,0,0,0
2019-02-15 13:15,152,57,95,0,0,0
2019-02-15 13:30,150,60,90,0,0,0
2019-02-15 13:45,187,82,105,0,0,0
2019-02-15 14:00,181,64,117,0,0,0
2019-02-15 14:15,174,74,100,0,0,0
2019-02-15 14:30,201,97,104,0,0,0
2019-02-15 14:45,164,73,91,0,0,0
2019-02-15 15:00,185,70,115,0,0,0
2019-02-15 15:15,159,71,88,0,0,0
2019-02-15 15:30,185,84,101,0,0,0
2019-02-15 15:45,194,91,103,0,0,0
2019-02-15 16:00,183,89,94,0,0,0
2019-02-15 16:15,196,88,108,0,0,0
2019-02-15 16:30,165,61,104,0,0,0
2019-02-15 16:45,175,80,95,0,0,0
2019-02-15 17:00,169,55,114,0,0,0
2019-02-15 17:15,194,87,107,0,0,0
2019-02-15 17:30,197,83,114,0,0,0
2019-02-15 17:45,190,85,105,0,0,0
2019-02-15 18:00,135,45,90,0,0,0
2019-02-15 18:15,139,44,95,0,0,0
2019-02-15 18:30,129,46,83,0,0,0
2019-02-15 18:45,130,60,70,0,0,0
2019-02-15 19:00,128,57,71,0,0,0
2019-02-15 19:15,135,61,74,0,0,0
2019-02-15 19:30,80,34,46,0,0,0
2019-02-15 19:45,121,57,64,0,0,0
2019-02-15 20:00,113,48,65,0,0,0
2019-02-15 20:15,60,21,39,0,0,0
2019-02-15 20:30,55,20,35,0,0,0
2019-02-15 20:45,50,22,28,0,0,0
2019-02-15 21:00,53,33,20,0,0,0
2019-02-15 21:15,53,19,34,0,0,0
2019-02-15 21:30,70,23,47,0,0,0
2019-02-15 21:45,36,7,29,0,0,0
2019-02-15 22:00,55,14,41,0,0,0
2019-02-15 22:15,60,13,47,0,0,0
2019-02-15 22:30,74,24,50,0,0,0
2019-02-15 22:45,63,24,39,0,0,0
2019-02-15 23:00,52,23,29,0,0,0
2019-02-15 23:15,50,18,32,0,0,0
2019-02-15 23:30,44,11,33,0,0,0
2019-02-15 23:45,49,23,26,0,0,0
2019-02-16 00:00,40,20,20,0,0,0
2019-02-16 00:15,37,18,19,0,0,0
2019-02-16 00:30,40,15,25,0,0,0
2019-02-16 00:45,25,5,20,0,0,0
2019-02-16 01:00,31,12,19,0,0,0
2019-02-16 01:15,28,7,21,0,0,0
2019-02-16 01:30,26,10,16,0,0,0
2019-02-16 01:45,16,2,14,0,0,0
2019-02-16 02:00,21,4,17,0,0,0
2019-02-16 02:15,12,1,11,0,0,0
2019-02-16 02:30,16,6,10,0,0,0
2019-02-16 02:45,19,8,11,0,0,0
2019-02-16 03:00,19,2,17,0,0,0
2019-02-16 03:15,11,4,7,0,0,0
2019-02-16 03:30,5,0,5,0,0,0
2019-02-16 03:45,4,0,4,0,0,0
2019-02-16 04:00,7,0,7,0,0,0
2019-02-16 04:15,14,7,7,0,0,0
2019-02-16 04:30,4,1,3,0,0,0
2019-02-16 04:45,1,0,1,0,0,0
2019-02-16 05:00,9,7,2,0,0,0
2019-02-16 05:15,6,2,4,0,0,0
2019-02-16 05:30,7,2,5,0,0,0
2019-02-16 05:45,10,9,1,0,0,0
2019-02-16 06:00,4,2,2,0,0,0
2019-02-16 06:15,14,8,6,0,0,0
2019-02-16 06:30,7,4,3,0,0,0
2019-02-16 06:45,3,3,0,0,0,0
2019-02-16 07:00,12,8,4,0,0,0
2019-02-16 07:15,11,7,4,0,0,0
2019-02-16 07:30,29,18,11,0,0,0
2019-02-16 07:45,42,30,12,0,0,0
2019-02-16 08:00,33,19,14,0,0,0
2019-02-16 08:15,43,30,13,0,0,0
2019-02-16 08:30,46,28,18,0,0,0
2019-02-16 08:45,64,38,26,0,0,0
2019-02-16 09:00,47,28,19,0,0,0
2019-02-16 09:15,77,59,18,0,0,0
2019-02-16 09:30,109,71,38,0,0,0
2019-02-16 09:45,132,94,38,0,0,0
2019-02-16 10:00,113,79,34,0,0,0
2019-02-16 10:15,142,100,42,0,0,0
2019-02-16 10:30,139,99,40,0,0,0
2019-02-16 10:45,133,90,43,0,0,0
2019-02-16 11:00,148,93,55,0,0,0
2019-02-16 11:15,155,96,59,0,0,0
2019-02-16 11:30,188,101,87,0,0,0
2019-02-16 11:45,221,127,94,0,0,0
2019-02-16 12:00,178,96,82,0,0,0
2019-02-16 12:15,174,89,85,0,0,0
2019-02-16 12:30,249,72,177,0,0,0
2019-02-16 12:45,290,95,195,0,0,0
2019-02-16 13:00,308,98,210,0,0,0
2019-02-16 13:15,263,99,164,0,0,0
2019-02-16 13:30,156,72,84,0,0,0
2019-02-16 13:45,206,105,101,0,0,0
2019-02-16 14:00,169,74,95,0,0,0
2019-02-16 14:15,192,72,120,0,0,0
2019-02-16 14:30,185,73,112,0,0,0
2019-02-16 14:45,186,70,116,0,0,0
2019-02-16 15:00,157,77,80,0,0,0
2019-02-16 15:15,148,52,96,0,0,0
2019-02-16 15:30,155,68,87,0,0,0
2019-02-16 15:45,168,84,84,0,0,0
2019-02-16 16:00,198,126,72,0,0,0
2019-02-16 16:15,310,218,92,0,0,0
2019-02-16 16:30,179,95,84,0,0,0
2019-02-16 16:45,149,67,82,0,0,0
2019-02-16 17:00,136,63,73,0,0,0
2019-02-16 17:15,119,58,61,0,0,0
2019-02-16 17:30,120,38,82,0,0,0
2019-02-16 17:45,135,55,80,0,0,0
2019-02-16 18:00,143,65,78,0,0,0
2019-02-16 18:15,108,40,68,0,0,0
2019-02-16 18:30,122,65,57,0,0,0
2019-02-16 18:45,108,61,47,0,0,0
2019-02-16 19:00,119,52,67,0,0,0
2019-02-16 19:15,117,60,57,0,0,0
2019-02-16 19:30,82,38,44,0,0,0
2019-02-16 19:45,82,39,43,0,0,0
2019-02-16 20:00,85,40,45,0,0,0
2019-02-16 20:15,48,19,29,0,0,0
2019-02-16 20:30,63,34,29,0,0,0
2019-02-16 20:45,54,25,29,0,0,0
2019-02-16 21:00,39,17,22,0,0,0
2019-02-16 21:15,43,19,24,0,0,0
2019-02-16 21:30,32,8,24,0,0,0
2019-02-16 21:45,46,14,32,0,0,0
2019-02-16 22:00,28,11,17,0,0,0
2019-02-16 22:15,31,5,26,0,0,0
2019-02-16 22:30,37,11,26,0,0,0
2019-02-16 22:45,46,15,31,0,0,0
2019-02-16 23:00,68,33,35,0,0,0
2019-02-16 23:15,26,13,13,0,0,0
2019-02-16 23:30,37,11,26,0,0,0
2019-02-16 23:45,39,19,20,0,0,0
2019-02-17 00:00,37,12,25,0,0,0
2019-02-17 00:15,26,5,21,0,0,0
2019-02-17 00:30,17,4,13,0,0,0
2019-02-17 00:45,27,10,17,0,0,0
2019-02-17 01:00,16,1,15,0,0,0
2019-02-17 01:15,17,4,13,0,0,0
2019-02-17 01:30,18,4,14,0,0,0
2019-02-17 01:45,19,6,13,0,0,0
2019-02-17 02:00,6,1,5,0,0,0
2019-02-17 02:15,23,5,18,0,0,0
2019-02-17 02:30,8,2,6,0,0,0
2019-02-17 02:45,14,1,13,0,0,0
2019-02-17 03:00,4,0,4,0,0,0
2019-02-17 03:15,14,2,12,0,0,0
2019-02-17 03:30,11,1,10,0,0,0
2019-02-17 03:45,6,3,3,0,0,0
2019-02-17 04:00,9,2,7,0,0,0
2019-02-17 04:15,5,1,4,0,0,0
2019-02-17 04:30,9,0,9,0,0,0
2019-02-17 04:45,6,1,5,0,0,0
2019-02-17 05:00,4,1,3,0,0,0
2019-02-17 05:15,5,2,3,0,0,0
2019-02-17 05:30,5,3,2,0,0,0
2019-02-17 05:45,2,1,1,0,0,0
2019-02-17 06:00,4,0,4,0,0,0
2019-02-17 06:15,6,5,1,0,0,0
2019-02-17 06:30,6,1,5,0,0,0
2019-02-17 06:45,5,3,2,0,0,0
2019-02-17 07:00,1,1,0,0,0,0
2019-02-17 07:15,1,0,1,0,0,0
2019-02-17 07:30,5,3,2,0,0,0
2019-02-17 07:45,8,5,3,0,0,0
2019-02-17 08:00,3,2,1,0,0,0
2019-02-17 08:15,8,3,5,0,0,0
2019-02-17 08:30,7,5,2,0,0,0
2019-02-17 08:45,12,7,5,0,0,0
2019-02-17 09:00,12,7,5,0,0,0
2019-02-17 09:15,32,16,16,0,0,0
2019-02-17 09:30,30,14,16,0,0,0
2019-02-17 09:45,62,42,20,0,0,0
2019-02-17 10:00,42,30,12,0,0,0
2019-02-17 10:15,52,24,28,0,0,0
2019-02-17 10:30,32,20,12,0,0,0
2019-02-17 10:45,43,31,12,0,0,0
2019-02-17 11:00,32,19,13,0,0,0
2019-02-17 11:15,35,16,19,0,0,0
2019-02-17 11:30,44,29,15,0,0,0
2019-02-17 11:45,42,25,17,0,0,0
2019-02-17 12:00,82,56,26,0,0,0
2019-02-17 12:15,70,43,27,0,0,0
2019-02-17 12:30,60,31,29,0,0,0
2019-02-17 12:45,73,38,35,0,0,0
2019-02-17 13:00,84,49,35,0,0,0
2019-02-17 13:15,85,45,40,0,0,0
2019-02-17 13:30,98,45,53,0,0,0
2019-02-17 13:45,86,44,42,0,0,0
2019-02-17 14:00,83,41,42,0,0,0
2019-02-17 14:15,118,64,54,0,0,0
2019-02-17 14:30,124,54,70,0,0,0
2019-02-17 14:45,123,72,51,0,0,0
2019-02-17 15:00,128,66,62,0,0,0
2019-02-17 15:15,113,48,65,0,0,0
2019-02-17 15:30,115,65,50,0,0,0
2019-02-17 15:45,100,37,63,0,0,0
2019-02-17 16:00,111,43,68,0,0,0
2019-02-17 16:15,96,35,61,0,0,0
2019-02-17 16:30,141,73,68,0,0,0
2019-02-17 16:45,116,55,61,0,0,0
2019-02-17 17:00,101,41,60,0,0,0
2019-02-17 17:15,96,38,58,0,0,0
2019-02-17 17:30,115,39,76,0,0,0
2019-02-17 17:45,91,43,48,0,0,0
2019-02-17 18:00,73,28,45,0,0,0
2019-02-17 18:15,94,41,53,0,0,0
2019-02-17 18:30,72,27,45,0,0,0
2019-02-17 18:45,81,26,55,0,0,0
2019-02-17 19:00,76,21,55,0,0,0
2019-02-17 19:15,61,30,31,0,0,0
2019-02-17 19:30,57,23,34,0,0,0
2019-02-17 19:45,40,12,28,0,0,0
2019-02-17 20:00,47,14,33,0,0,0
2019-02-17 20:15,28,8,20,0,0,0
2019-02-17 20:30,34,9,25,0,0,0
2019-02-17 20:45,38,6,32,0,0,0
2019-02-17 21:00,18,4,14,0,0,0
2019-02-17 21:15,19,5,14,0,0,0
2019-02-17 21:30,18,3,15,0,0,0
2019-02-17 21:45,25,7,18,0,0,0
2019-02-17 22:00,17,9,8,0,0,0
2019-02-17 22:15,22,7,15,0,0,0
2019-02-17 22:30,14,6,8,0,0,0
2019-02-17 22:45,12,1,11,0,0,0
2019-02-17 23:00,12,2,10,0,0,0
2019-02-17 23:15,7,2,5,0,0,0
2019-02-17 23:30,7,5,2,0,0,0
2019-02-17 23:45,5,1,4,0,0,0
2019-02-18 00:00,2,1,1,0,0,0
2019-02-18 00:15,5,1,4,0,0,0
2019-02-18 00:30,3,1,2,0,0,0
2019-02-18 00:45,3,1,2,0,0,0
2019-02-18 01:00,8,0,8,0,0,0
2019-02-18 01:15,1,1,0,0,0,0
2019-02-18 01:30,0,0,0,0,0,0
2019-02-18 01:45,2,1,1,0,0,0
2019-02-18 02:00,0,0,0,0,0,0
2019-02-18 02:15,0,0,0,0,0,0
2019-02-18 02:30,0,0,0,0,0,0
2019-02-18 02:45,2,2,0,0,0,0
2019-02-18 03:00,2,0,2,0,0,0
2019-02-18 03:15,0,0,0,0,0,0
2019-02-18 03:30,0,0,0,0,0,0
2019-02-18 03:45,1,1,0,0,0,0
2019-02-18 04:00,2,0,2,0,0,0
2019-02-18 04:15,0,0,0,0,0,0
2019-02-18 04:30,0,0,0,0,0,0
2019-02-18 04:45,3,3,0,0,0,0
2019-02-18 05:00,7,6,1,0,0,0
2019-02-18 05:15,11,9,2,0,0,0
2019-02-18 05:30,14,10,4,0,0,0
2019-02-18 05:45,24,18,6,0,0,0
2019-02-18 06:00,20,14,6,0,0,0
2019-02-18 06:15,33,23,10,0,0,0
2019-02-18 06:30,39,30,9,0,0,0
2019-02-18 06:45,55,38,17,0,0,0
2019-02-18 07:00,78,49,29,0,0,0
2019-02-18 07:15,112,70,42,0,0,0
2019-02-18 07:30,150,100,50,0,0,0
2019-02-18 07:45,186,129,57,0,0,0
2019-02-18 08:00,129,79,50,0,0,0
2019-02-18 08:15,147,102,45,0,0,0
2019-02-18 08:30,105,85,20,0,0,0
2019-02-18 08:45,133,106,27,0,0,0
2019-02-18 09:00,100,67,33,0,0,0
2019-02-18 09:15,110,71,39,0,0,0
2019-02-18 09:30,116,81,35,0,0,0
2019-02-18 09:45,117,80,37,0,0,0
2019-02-18 10:00,79,54,25,0,0,0
2019-02-18 10:15,114,66,48,0,0,0
2019-02-18 10:30,97,56,41,0,0,0
2019-02-18 10:45,99,55,44,0,0,0
2019-02-18 11:00,92,41,51,0,0,0
2019-02-18 11:15,108,64,44,0,0,0
2019-02-18 11:30,129,57,72,0,0,0
2019-02-18 11:45,140,83,57,0,0,0
2019-02-18 12:00,130,53,77,0,0,0
2019-02-18 12:15,124,48,76,0,0,0
2019-02-18 12:30,135,53,82,0,0,0
2019-02-18 12:45,136,59,77,0,0,0
2019-02-18 13:00,148,55,93,0,0,0
2019-02-18 13:15,159,63,96,0,0,0
2019-02-18 13:30,120,58,62,0,0,0
2019-02-18 13:45,177,76,101,0,0,0
2019-02-18 14:00,146,62,84,0,0,0
2019-02-18 14:15,141,67,74,0,0,0
2019-02-18 14:30,135,66,69,0,0,0
2019-02-18 14:45,175,94,81,0,0,0
2019-02-18 15:00,172,72,100,0,0,0
2019-02-18 15:15,172,81,91,0,0,0
2019-02-18 15:30,169,67,102,0,0,0
2019-02-18 15:45,188,81,107,0,0,0
2019-02-18 16:00,203,80,123,0,0,0
2019-02-18 16:15,196,84,112,0,0,0
2019-02-18 16:30,234,84,150,0,0,0
2019-02-18 16:45,212,83,129,0,0,0
2019-02-18 17:00,230,76,154,0,0,0
2019-02-18 17:15,186,76,110,0,0,0
2019-02-18 17:30,221,62,159,0,0,0
2019-02-18 17:45,225,81,144,0,0,0
2019-02-18 18:00,192,57,135,0,0,0
2019-02-18 18:15,133,44,89,0,0,0
2019-02-18 18:30,146,63,83,0,0,0
2019-02-18 18:45,118,50,68,0,0,0
2019-02-18 19:00,153,57,96,0,0,0
2019-02-18 19:15,149,62,87,0,0,0
2019-02-18 19:30,87,32,55,0,0,0
2019-02-18 19:45,134,58,76,0,0,0
2019-02-18 20:00,93,41,52,0,0,0
2019-02-18 20:15,73,14,59,0,0,0
2019-02-18 20:30,56,25,31,0,0,0
2019-02-18 20:45,59,27,32,0,0,0
2019-02-18 21:00,62,16,46,0,0,0
2019-02-18 21:15,60,15,45,0,0,0
2019-02-18 21:30,54,19,35,0,0,0
2019-02-18 21:45,55,12,43,0,0,0
2019-02-18 22:00,59,16,43,0,0,0
2019-02-18 22:15,43,12,31,0,0,0
2019-02-18 22:30,55,20,35,0,0,0
2019-02-18 22:45,23,5,18,0,0,0
2019-02-18 23:00,43,17,26,0,0,0
2019-02-18 23:15,18,3,15,0,0,0
2019-02-18 23:30,11,0,11,0,0,0
2019-02-18 23:45,16,5,11,0,0,0
2019-02-19 00:00,19,2,17,0,0,0
2019-02-19 00:15,6,4,2,0,0,0
2019-02-19 00:30,9,4,5,0,0,0
2019-02-19 00:45,5,0,5,0,0,0
2019-02-19 01:00,5,3,2,0,0,0
2019-02-19 01:15,3,2,1,0,0,0
2019-02-19 01:30,5,1,4,0,0,0
2019-02-19 01:45,1,0,1,0,0,0
2019-02-19 02:00,3,0,3,0,0,0
2019-02-19 02:15,0,0,0,0,0,0
2019-02-19 02:30,1,1,0,0,0,0
2019-02-19 02:45,2,1,1,0,0,0
2019-02-19 03:00,0,0,0,0,0,0
2019-02-19 03:15,1,0,1,0,0,0
2019-02-19 03:30,1,0,1,0,0,0
2019-02-19 03:45,0,0,0,0,0,0
2019-02-19 04:00,0,0,0,0,0,0
2019-02-19 04:15,0,0,0,0,0,0
2019-02-19 04:30,2,1,1,0,0,0
2019-02-19 04:45,6,2,4,0,0,0
2019-02-19 05:00,5,3,2,0,0,0
2019-02-19 05:15,16,11,5,0,0,0
2019-02-19 05:30,21,16,5,0,0,0
2019-02-19 05:45,27,14,13,0,0,0
2019-02-19 06:00,27,16,11,0,0,0
2019-02-19 06:15,27,23,4,0,0,0
2019-02-19 06:30,46,40,6,0,0,0
2019-02-19 06:45,51,33,18,0,0,0
2019-02-19 07:00,86,55,31,0,0,0
2019-02-19 07:15,116,73,43,0,0,0
2019-02-19 07:30,195,122,73,0,0,0
2019-02-19 07:45,170,118,52,0,0,0
2019-02-19 08:00,118,85,33,0,0,0
2019-02-19 08:15,170,121,49,0,0,0
2019-02-19 08:30,130,94,36,0,0,0
2019-02-19 08:45,134,104,30,0,0,0
2019-02-19 09:00,89,61,28,0,0,0
2019-02-19 09:15,115,77,38,0,0,0
2019-02-19 09:30,108,84,24,0,0,0
2019-02-19 09:45,119,91,28,0,0,0
2019-02-19 10:00,81,45,36,0,0,0
2019-02-19 10:15,99,57,42,0,0,0
2019-02-19 10:30,103,61,42,0,0,0
2019-02-19 10:45,93,54,39,0,0,0
2019-02-19 11:00,91,43,48,0,0,0
2019-02-19 11:15,91,46,45,0,0,0
2019-02-19 11:30,93,51,42,0,0,0
2019-02-19 11:45,106,49,57,0,0,0
2019-02-19 12:00,101,45,56,0,0,0
2019-02-19 12:15,113,50,63,0,0,0
2019-02-19 12:30,113,46,67,0,0,0
2019-02-19 12:45,128,52,76,0,0,0
2019-02-19 13:00,129,47,82,0,0,0
2019-02-19 13:15,129,52,77,0,0,0
2019-02-19 13:30,121,56,65,0,0,0
2019-02-19 13:45,140,59,81,0,0,0
2019-02-19 14:00,131,51,80,0,0,0
2019-02-19 14:15,128,60,68,0,0,0
2019-02-19 14:30,123,55,68,0,0,0
2019-02-19 14:45,140,71,69,0,0,0
2019-02-19 15:00,141,53,88,0,0,0
2019-02-19 15:15,138,65,73,0,0,0
2019-02-19 15:30,138,66,72,0,0,0
2019-02-19 15:45,167,78,89,0,0,0
2019-02-19 16:00,179,68,111,0,0,0
2019-02-19 16:15,157,60,97,0,0,0
2019-02-19 16:30,188,73,115,0,0,0
2019-02-19 16:45,209,80,129,0,0,0
2019-02-19 17:00,187,62,125,0,0,0
2019-02-19 17:15,180,70,110,0,0,0
2019-02-19 17:30,189,72,117,0,0,0
2019-02-19 17:45,209,74,135,0,0,0
2019-02-19 18:00,209,75,134,0,0,0
2019-02-19 18:15,147,48,99,0,0,0
2019-02-19 18:30,121,48,73,0,0,0
2019-02-19 18:45,127,51,76,0,0,0
2019-02-19 19:00,112,33,79,0,0,0
2019-02-19 19:15,98,40,58,0,0,0
2019-02-19 19:30,108,53,55,0,0,0
2019-02-19 19:45,108,41,67,0,0,0
2019-02-19 20:00,99,36,63,0,0,0
2019-02-19 20:15,86,32,54,0,0,0
2019-02-19 20:30,53,18,35,0,0,0
2019-02-19 20:45,49,18,31,0,0,0
2019-02-19 21:00,79,25,54,0,0,0
2019-02-19 21:15,40,16,24,0,0,0
2019-02-19 21:30,52,22,30,0,0,0
2019-02-19 21:45,56,17,39,0,0,0
2019-02-19 22:00,42,12,30,0,0,0
2019-02-19 22:15,55,22,33,0,0,0
2019-02-19 22:30,32,6,26,0,0,0
2019-02-19 22:45,48,19,29,0,0,0
2019-02-19 23:00,76,21,55,0,0,0
2019-02-19 23:15,26,3,23,0,0,0
2019-02-19 23:30,24,6,18,0,0,0
2019-02-19 23:45,13,1,12,0,0,0
2019-02-20 00:00,13,5,8,0,0,0
2019-02-20 00:15,11,2,9,0,0,0
2019-02-20 00:30,5,0,5,0,0,0
2019-02-20 00:45,8,3,5,0,0,0
2019-02-20 01:00,3,1,2,0,0,0
2019-02-20 01:15,2,2,0,0,0,0
2019-02-20 01:30,1,1,0,0,0,0
2019-02-20 01:45,2,1,1,0,0,0
2019-02-20 02:00,1,0,1,0,0,0
2019-02-20 02:15,0,0,0,0,0,0
2019-02-20 02:30,0,0,0,0,0,0
2019-02-20 02:45,1,1,0,0,0,0
2019-02-20 03:00,2,1,1,0,0,0
2019-02-20 03:15,0,0,0,0,0,0
2019-02-20 03:30,1,0,1,0,0,0
2019-02-20 03:45,0,0,0,0,0,0
2019-02-20 04:00,1,0,1,0,0,0
2019-02-20 04:15,0,0,0,0,0,0
2019-02-20 04:30,1,1,0,0,0,0
2019-02-20 04:45,1,1,0,0,0,0
2019-02-20 05:00,6,6,0,0,0,0
2019-02-20 05:15,14,11,3,0,0,0
2019-02-20 05:30,15,11,4,0,0,0
2019-02-20 05:45,23,20,3,0,0,0
2019-02-20 06:00,23,14,9,0,0,0
2019-02-20 06:15,30,25,5,0,0,0
2019-02-20 06:30,47,33,14,0,0,0
2019-02-20 06:45,57,41,16,0,0,0
2019-02-20 07:00,77,50,27,0,0,0
2019-02-20 07:15,118,71,47,0,0,0
2019-02-20 07:30,189,132,57,0,0,0
2019-02-20 07:45,178,131,47,0,0,0
2019-02-20 08:00,123,76,47,0,0,0
2019-02-20 08:15,165,117,48,0,0,0
2019-02-20 08:30,140,89,51,0,0,0
2019-02-20 08:45,170,118,52,0,0,0
2019-02-20 09:00,113,73,40,0,0,0
2019-02-20 09:15,102,67,35,0,0,0
2019-02-20 09:30,109,71,38,0,0,0
2019-02-20 09:45,134,90,44,0,0,0
2019-02-20 10:00,93,53,40,0,0,0
2019-02-20 10:15,102,65,37,0,0,0
2019-02-20 10:30,107,66,41,0,0,0
2019-02-20 10:45,128,71,57,0,0,0
2019-02-20 11:00,106,60,46,0,0,0
2019-02-20 11:15,116,61,55,0,0,0
2019-02-20 11:30,122,75,47,0,0,0
2019-02-20 11:45,152,77,75,0,0,0
2019-02-20 12:00,129,64,65,0,0,0
2019-02-20 12:15,68,67,1,0,0,0
2019-02-20 12:30,162,67,95,0,0,0
2019-02-20 12:45,154,74,80,0,0,0
2019-02-20 13:00,156,64,92,0,0,0
2019-02-20 13:15,141,44,97,0,0,0
2019-02-20 13:30,147,64,83,0,0,0
2019-02-20 13:45,151,61,90,0,0,0
2019-02-20 14:00,136,53,83,0,0,0
2019-02-20 14:15,135,49,86,0,0,0
2019-02-20 14:30,141,69,72,0,0,0
2019-02-20 14:45,130,50,80,0,0,0
2019-02-20 15:00,141,63,78,0,0,0
2019-02-20 15:15,132,58,74,0,0,0
2019-02-20 15:30,157,64,93,0,0,0
2019-02-20 15:45,145,56,89,0,0,0
2019-02-20 16:00,175,67,108,0,0,0
2019-02-20 16:15,173,71,102,0,0,0
2019-02-20 16:30,170,70,100,0,0,0
2019-02-20 16:45,180,65,115,0,0,0
2019-02-20 17:00,228,78,150,0,0,0
2019-02-20 17:15,186,84,102,0,0,0
2019-02-20 17:30,193,60,133,0,0,0
2019-02-20 17:45,186,78,108,0,0,0
2019-02-20 18:00,171,59,112,0,0,0
2019-02-20 18:15,158,50,108,0,0,0
2019-02-20 18:30,142,55,87,0,0,0
2019-02-20 18:45,153,67,86,0,0,0
2019-02-20 19:00,137,38,99,0,0,0
2019-02-20 19:15,130,48,82,0,0,0
2019-02-20 19:30,107,32,75,0,0,0
2019-02-20 19:45,148,54,94,0,0,0
2019-02-20 20:00,105,37,68,0,0,0
2019-02-20 20:15,96,35,61,0,0,0
2019-02-20 20:30,39,15,24,0,0,0
2019-02-20 20:45,58,15,43,0,0,0
2019-02-20 21:00,78,35,43,0,0,0
2019-02-20 21:15,51,15,36,0,0,0
2019-02-20 21:30,48,20,28,0,0,0
2019-02-20 21:45,35,12,23,0,0,0
2019-02-20 22:00,47,15,32,0,0,0
2019-02-20 22:15,47,17,30,0,0,0
2019-02-20 22:30,64,25,39,0,0,0
2019-02-20 22:45,54,25,29,0,0,0
2019-02-20 23:00,53,16,37,0,0,0
2019-02-20 23:15,30,10,20,0,0,0
2019-02-20 23:30,17,9,8,0,0,0
2019-02-20 23:45,20,8,12,0,0,0
2019-02-21 00:00,12,0,12,0,0,0
2019-02-21 00:15,12,2,10,0,0,0
2019-02-21 00:30,5,1,4,0,0,0
2019-02-21 00:45,13,7,6,0,0,0
2019-02-21 01:00,9,1,8,0,0,0
2019-02-21 01:15,3,2,1,0,0,0
2019-02-21 01:30,9,1,8,0,0,0
2019-02-21 01:45,3,0,3,0,0,0
2019-02-21 02:00,3,1,2,0,0,0
2019-02-21 02:15,7,1,6,0,0,0
2019-02-21 02:30,1,0,1,0,0,0
2019-02-21 02:45,4,2,2,0,0,0
2019-02-21 03:00,1,1,0,0,0,0
2019-02-21 03:15,4,0,4,0,0,0
2019-02-21 03:30,2,0,2,0,0,0
2019-02-21 03:45,0,0,0,0,0,0
2019-02-21 04:00,3,0,3,0,0,0
2019-02-21 04:15,4,0,4,0,0,0
2019-02-21 04:30,7,1,6,0,0,0
2019-02-21 04:45,2,2,0,0,0,0
2019-02-21 05:00,7,7,0,0,0,0
2019-02-21 05:15,13,9,4,0,0,0
2019-02-21 05:30,18,15,3,0,0,0
2019-02-21 05:45,24,20,4,0,0,0
2019-02-21 06:00,29,19,10,0,0,0
2019-02-21 06:15,26,22,4,0,0,0
2019-02-21 06:30,42,34,8,0,0,0
2019-02-21 06:45,55,37,18,0,0,0
2019-02-21 07:00,70,46,24,0,0,0
2019-02-21 07:15,122,80,42,0,0,0
2019-02-21 07:30,176,126,50,0,0,0
2019-02-21 07:45,173,121,52,0,0,0
2019-02-21 08:00,123,90,33,0,0,0
2019-02-21 08:15,168,105,63,0,0,0
2019-02-21 08:30,131,97,34,0,0,0
2019-02-21 08:45,154,103,51,0,0,0
2019-02-21 09:00,84,53,31,0,0,0
2019-02-21 09:15,96,68,28,0,0,0
2019-02-21 09:30,99,77,22,0,0,0
2019-02-21 09:45,115,77,38,0,0,0
2019-02-21 10:00,79,42,37,0,0,0
2019-02-21 10:15,86,51,35,0,0,0
2019-02-21 10:30,96,64,32,0,0,0
2019-02-21 10:45,108,64,44,0,0,0
2019-02-21 11:00,84,54,30,0,0,0
2019-02-21 11:15,93,48,45,0,0,0
2019-02-21 11:30,104,54,50,0,0,0
2019-02-21 11:45,116,56,60,0,0,0
2019-02-21 12:00,129,55,74,0,0,0
2019-02-21 12:15,120,49,71,0,0,0
2019-02-21 12:30,124,48,76,0,0,0
2019-02-21 12:45,121,52,69,0,0,0
2019-02-21 13:00,114,41,73,0,0,0
2019-02-21 13:15,117,42,75,0,0,0
2019-02-21 13:30,120,53,67,0,0,0
2019-02-21 13:45,122,66,56,0,0,0
2019-02-21 14:00,136,59,77,0,0,0
2019-02-21 14:15,145,54,91,0,0,0
2019-02-21 14:30,127,48,79,0,0,0
2019-02-21 14:45,170,78,92,0,0,0
2019-02-21 15:00,126,57,69,0,0,0
2019-02-21 15:15,139,54,85,0,0,0
2019-02-21 15:30,138,60,78,0,0,0
2019-02-21 15:45,178,87,91,0,0,0
2019-02-21 16:00,194,84,110,0,0,0
2019-02-21 16:15,184,70,114,0,0,0
2019-02-21 16:30,184,66,118,0,0,0
2019-02-21 16:45,211,84,127,0,0,0
2019-02-21 17:00,187,72,115,0,0,0
2019-02-21 17:15,197,74,123,0,0,0
2019-02-21 17:30,194,72,122,0,0,0
2019-02-21 17:45,193,64,129,0,0,0
2019-02-21 18:00,185,51,134,0,0,0
2019-02-21 18:15,169,53,116,0,0,0
2019-02-21 18:30,174,68,106,0,0,0
2019-02-21 18:45,125,52,73,0,0,0
2019-02-21 19:00,126,55,71,0,0,0
2019-02-21 19:15,129,47,82,0,0,0
2019-02-21 19:30,101,36,65,0,0,0
2019-02-21 19:45,104,46,58,0,0,0
2019-02-21 20:00,73,26,47,0,0,0
2019-02-21 20:15,70,21,49,0,0,0
2019-02-21 20:30,54,10,44,0,0,0
2019-02-21 20:45,55,17,38,0,0,0
2019-02-21 21:00,56,17,39,0,0,0
2019-02-21 21:15,51,15,36,0,0,0
2019-02-21 21:30,38,10,28,0,0,0
2019-02-21 21:45,63,16,47,0,0,0
2019-02-21 22:00,53,16,37,0,0,0
2019-02-21 22:15,59,29,30,0,0,0
2019-02-21 22:30,35,13,22,0,0,0
2019-02-21 22:45,39,19,20,0,0,0
2019-02-21 23:00,38,16,22,0,0,0
2019-02-21 23:15,29,9,20,0,0,0
2019-02-21 23:30,24,3,21,0,0,0
2019-02-21 23:45,13,1,12,0,0,0
2019-02-22 00:00,11,4,7,0,0,0
2019-02-22 00:15,9,2,7,0,0,0
2019-02-22 00:30,6,3,3,0,0,0
2019-02-22 00:45,8,2,6,0,0,0
2019-02-22 01:00,3,0,3,0,0,0
2019-02-22 01:15,3,1,2,0,0,0
2019-02-22 01:30,4,0,4,0,0,0
2019-02-22 01:45,1,1,0,0,0,0
2019-02-22 02:00,4,1,3,0,0,0
2019-02-22 02:15,2,0,2,0,0,0
2019-02-22 02:30,0,0,0,0,0,0
2019-02-22 02:45,3,2,1,0,0,0
2019-02-22 03:00,2,2,0,0,0,0
2019-02-22 03:15,1,0,1,0,0,0
2019-02-22 03:30,2,2,0,0,0,0
2019-02-22 03:45,4,0,4,0,0,0
2019-02-22 04:00,0,0,0,0,0,0
2019-02-22 04:15,2,0,2,0,0,0
2019-02-22 04:30,0,0,0,0,0,0
2019-02-22 04:45,1,1,0,0,0,0
2019-02-22 05:00,7,7,0,0,0,0
2019-02-22 05:15,10,5,5,0,0,0
2019-02-22 05:30,17,12,5,0,0,0
2019-02-22 05:45,24,20,4,0,0,0
2019-02-22 06:00,15,13,2,0,0,0
2019-02-22 06:15,27,18,9,0,0,0
2019-02-22 06:30,42,28,14,0,0,0
2019-02-22 06:45,69,52,17,0,0,0
2019-02-22 07:00,74,47,27,0,0,0
2019-02-22 07:15,115,72,43,0,0,0
2019-02-22 07:30,157,118,39,0,0,0
2019-02-22 07:45,182,135,47,0,0,0
2019-02-22 08:00,97,68,29,0,0,0
2019-02-22 08:15,146,103,43,0,0,0
2019-02-22 08:30,115,82,33,0,0,0
2019-02-22 08:45,138,91,47,0,0,0
2019-02-22 09:00,98,72,26,0,0,0
2019-02-22 09:15,110,82,28,0,0,0
2019-02-22 09:30,98,68,30,0,0,0
2019-02-22 09:45,132,97,35,0,0,0
2019-02-22 10:00,74,36,38,0,0,0
2019-02-22 10:15,87,47,40,0,0,0
2019-02-22 10:30,97,47,50,0,0,0
2019-02-22 10:45,108,63,45,0,0,0
2019-02-22 11:00,84,47,37,0,0,0
2019-02-22 11:15,116,52,64,0,0,0
2019-02-22 11:30,120,58,62,0,0,0
2019-02-22 11:45,116,59,57,0,0,0
2019-02-22 12:00,133,62,71,0,0,0
2019-02-22 12:15,149,64,85,0,0,0
2019-02-22 12:30,140,61,79,0,0,0
2019-02-22 12:45,128,55,73,0,0,0
2019-02-22 13:00,159,62,97,0,0,0
2019-02-22 13:15,163,50,113,0,0,0
2019-02-22 13:30,141,43,98,0,0,0
2019-02-22 13:45,169,80,89,0,0,0
2019-02-22 14:00,142,49,93,0,0,0
2019-02-22 14:15,158,61,97,0,0,0
2019-02-22 14:30,144,52,92,0,0,0
2019-02-22 14:45,148,52,96,0,0,0
2019-02-22 15:00,167,64,103,0,0,0
2019-02-22 15:15,156,73,83,0,0,0
2019-02-22 15:30,135,57,78,0,0,0
2019-02-22 15:45,177,66,111,0,0,0
2019-02-22 16:00,177,83,94,0,0,0
2019-02-22 16:15,211,111,100,0,0,0
2019-02-22 16:30,163,81,82,0,0,0
2019-02-22 16:45,178,92,86,0,0,0
2019-02-22 17:00,214,135,79,0,0,0
2019-02-22 17:15,223,141,82,0,0,0
2019-02-22 17:30,194,99,95,0,0,0
2019-02-22 17:45,210,95,115,0,0,0
2019-02-22 18:00,164,77,87,0,0,0
2019-02-22 18:15,168,62,106,0,0,0
2019-02-22 18:30,161,53,108,0,0,0
2019-02-22 18:45,176,57,119,0,0,0
2019-02-22 19:00,171,54,117,0,0,0
2019-02-22 19:15,152,53,99,0,0,0
2019-02-22 19:30,147,43,104,0,0,0
2019-02-22 19:45,138,55,83,0,0,0
2019-02-22 20:00,120,47,73,0,0,0
2019-02-22 20:15,86,39,47,0,0,0
2019-02-22 20:30,87,37,50,0,0,0
2019-02-22 20:45,70,31,39,0,0,0
2019-02-22 21:00,75,29,46,0,0,0
2019-02-22 21:15,63,24,39,0,0,0
2019-02-22 21:30,52,21,31,0,0,0
2019-02-22 21:45,57,23,34,0,0,0
2019-02-22 22:00,62,25,37,0,0,0
2019-02-22 22:15,45,19,26,0,0,0
2019-02-22 22:30,52,9,43,0,0,0
2019-02-22 22:45,55,17,38,0,0,0
2019-02-22 23:00,41,8,33,0,0,0
2019-02-22 23:15,50,18,32,0,0,0
2019-02-22 23:30,32,13,19,0,0,0
2019-02-22 23:45,34,12,22,0,0,0
2019-02-23 00:00,42,12,30,0,0,0
2019-02-23 00:15,50,25,25,0,0,0
2019-02-23 00:30,34,19,15,0,0,0
2019-02-23 00:45,38,8,30,0,0,0
2019-02-23 01:00,34,11,23,0,0,0
2019-02-23 01:15,23,11,12,0,0,0
2019-02-23 01:30,23,7,16,0,0,0
2019-02-23 01:45,25,16,9,0,0,0
2019-02-23 02:00,15,0,15,0,0,0
2019-02-23 02:15,16,6,10,0,0,0
2019-02-23 02:30,11,7,4,0,0,0
2019-02-23 02:45,8,0,8,0,0,0
2019-02-23 03:00,7,3,4,0,0,0
2019-02-23 03:15,8,3,5,0,0,0
2019-02-23 03:30,7,3,4,0,0,0
2019-02-23 03:45,13,1,12,0,0,0
2019-02-23 04:00,7,4,3,0,0,0
2019-02-23 04:15,2,0,2,0,0,0
2019-02-23 04:30,4,1,3,0,0,0
2019-02-23 04:45,9,2,7,0,0,0
2019-02-23 05:00,4,1,3,0,0,0
2019-02-23 05:15,12,6,6,0,0,0
2019-02-23 05:30,10,8,2,0,0,0
2019-02-23 05:45,5,4,1,0,0,0
2019-02-23 06:00,4,2,2,0,0,0
2019-02-23 06:15,9,5,4,0,0,0
2019-02-23 06:30,7,4,3,0,0,0
2019-02-23 06:45,14,10,4,0,0,0
2019-02-23 07:00,7,5,2,0,0,0
2019-02-23 07:15,12,8,4,0,0,0
2019-02-23 07:30,25,14,11,0,0,0
2019-02-23 07:45,31,21,10,0,0,0
2019-02-23 08:00,22,16,6,0,0,0
2019-02-23 08:15,27,19,8,0,0,0
2019-02-23 08:30,41,27,14,0,0,0
2019-02-23 08:45,68,50,18,0,0,0
2019-02-23 09:00,46,26,20,0,0,0
2019-02-23 09:15,91,67,24,0,0,0
2019-02-23 09:30,89,71,18,0,0,0
2019-02-23 09:45,108,70,38,0,0,0
2019-02-23 10:00,107,74,33,0,0,0
2019-02-23 10:15,131,83,48,0,0,0
2019-02-23 10:30,142,86,56,0,0,0
2019-02-23 10:45,138,97,41,0,0,0
2019-02-23 11:00,140,93,47,0,0,0
2019-02-23 11:15,139,98,41,0,0,0
2019-02-23 11:30,143,77,66,0,0,0
2019-02-23 11:45,173,98,75,0,0,0
2019-02-23 12:00,185,103,82,0,0,0
2019-02-23 12:15,189,86,103,0,0,0
2019-02-23 12:30,175,101,74,0,0,0
2019-02-23 12:45,161,83,78,0,0,0
2019-02-23 13:00,172,89,83,0,0,0
2019-02-23 13:15,165,74,91,0,0,0
2019-02-23 13:30,192,97,95,0,0,0
2019-02-23 13:45,177,102,75,0,0,0
2019-02-23 14:00,173,75,98,0,0,0
2019-02-23 14:15,162,59,103,0,0,0
2019-02-23 14:30,146,54,92,0,0,0
2019-02-23 14:45,196,88,108,0,0,0
2019-02-23 15:00,138,62,76,0,0,0
2019-02-23 15:15,176,71,105,0,0,0
2019-02-23 15:30,128,49,79,0,0,0
2019-02-23 15:45,143,67,76,0,0,0
2019-02-23 16:00,151,65,86,0,0,0
2019-02-23 16:15,127,60,67,0,0,0
2019-02-23 16:30,104,42,62,0,0,0
2019-02-23 16:45,132,52,80,0,0,0
2019-02-23 17:00,131,46,85,0,0,0
2019-02-23 17:15,125,53,72,0,0,0
2019-02-23 17:30,130,39,91,0,0,0
2019-02-23 17:45,124,40,84,0,0,0
2019-02-23 18:00,133,27,106,0,0,0
2019-02-23 18:15,151,37,114,0,0,0
2019-02-23 18:30,136,41,95,0,0,0
2019-02-23 18:45,119,43,76,0,0,0
2019-02-23 19:00,112,41,71,0,0,0
2019-02-23 19:15,105,38,67,0,0,0
2019-02-23 19:30,100,31,69,0,0,0
2019-02-23 19:45,90,38,52,0,0,0
2019-02-23 20:00,82,33,49,0,0,0
2019-02-23 20:15,56,27,29,0,0,0
2019-02-23 20:30,53,21,32,0,0,0
2019-02-23 20:45,60,38,22,0,0,0
2019-02-23 21:00,49,17,32,0,0,0
2019-02-23 21:15,96,67,29,0,0,0
2019-02-23 21:30,99,79,20,0,0,0
2019-02-23 21:45,48,29,19,0,0,0
2019-02-23 22:00,41,17,24,0,0,0
2019-02-23 22:15,34,17,17,0,0,0
2019-02-23 22:30,46,28,18,0,0,0
2019-02-23 22:45,49,27,22,0,0,0
2019-02-23 23:00,56,25,31,0,0,0
2019-02-23 23:15,63,34,29,0,0,0
2019-02-23 23:30,63,38,25,0,0,0
2019-02-23 23:45,45,25,20,0,0,0
2019-02-24 00:00,50,20,30,0,0,0
2019-02-24 00:15,48,4,44,0,0,0
2019-02-24 00:30,39,17,22,0,0,0
2019-02-24 00:45,30,9,21,0,0,0
2019-02-24 01:00,27,9,18,0,0,0
2019-02-24 01:15,17,7,10,0,0,0
2019-02-24 01:30,28,6,22,0,0,0
2019-02-24 01:45,18,7,11,0,0,0
2019-02-24 02:00,29,4,25,0,0,0
2019-02-24 02:15,19,11,8,0,0,0
2019-02-24 02:30,21,6,15,0,0,0
2019-02-24 02:45,26,9,17,0,0,0
2019-02-24 03:00,11,2,9,0,0,0
2019-02-24 03:15,8,2,6,0,0,0
2019-02-24 03:30,6,1,5,0,0,0
2019-02-24 03:45,7,0,7,0,0,0
2019-02-24 04:00,11,0,11,0,0,0
2019-02-24 04:15,5,2,3,0,0,0
2019-02-24 04:30,6,3,3,0,0,0
2019-02-24 04:45,4,2,2,0,0,0
2019-02-24 05:00,3,1,2,0,0,0
2019-02-24 05:15,5,3,2,0,0,0
2019-02-24 05:30,6,4,2,0,0,0
2019-02-24 05:45,6,2,4,0,0,0
2019-02-24 06:00,2,0,2,0,0,0
2019-02-24 06:15,2,1,1,0,0,0
2019-02-24 06:30,2,0,2,0,0,0
2019-02-24 06:45,4,0,4,0,0,0
2019-02-24 07:00,4,1,3,0,0,0
2019-02-24 07:15,0,0,0,0,0,0
2019-02-24 07:30,6,3,3,0,0,0
2019-02-24 07:45,9,5,4,0,0,0
2019-02-24 08:00,8,3,5,0,0,0
2019-02-24 08:15,3,1,2,0,0,0
2019-02-24 08:30,8,2,6,0,0,0
2019-02-24 08:45,13,6,7,0,0,0
2019-02-24 09:00,15,11,4,0,0,0
2019-02-24 09:15,33,20,13,0,0,0
2019-02-24 09:30,34,16,18,0,0,0
2019-02-24 09:45,67,43,24,0,0,0
2019-02-24 10:00,35,16,19,0,0,0
2019-02-24 10:15,29,21,8,0,0,0
2019-02-24 10:30,26,15,11,0,0,0
2019-02-24 10:45,37,22,15,0,0,0
2019-02-24 11:00,64,24,40,0,0,0
2019-02-24 11:15,38,13,25,0,0,0
2019-02-24 11:30,47,28,19,0,0,0
2019-02-24 11:45,56,34,22,0,0,0
2019-02-24 12:00,57,34,23,0,0,0
2019-02-24 12:15,56,24,32,0,0,0
2019-02-24 12:30,42,23,19,0,0,0
2019-02-24 12:45,64,39,25,0,0,0
2019-02-24 13:00,67,32,35,0,0,0
2019-02-24 13:15,60,39,21,0,0,0
2019-02-24 13:30,73,46,27,0,0,0
2019-02-24 13:45,86,51,35,0,0,0
2019-02-24 14:00,81,35,46,0,0,0
2019-02-24 14:15,101,59,42,0,0,0
2019-02-24 14:30,115,62,53,0,0,0
2019-02-24 14:45,102,47,55,0,0,0
2019-02-24 15:00,134,60,74,0,0,0
2019-02-24 15:15,129,63,66,0,0,0
2019-02-24 15:30,103,32,71,0,0,0
2019-02-24 15:45,82,40,42,0,0,0
2019-02-24 16:00,107,45,62,0,0,0
2019-02-24 16:15,99,40,59,0,0,0
2019-02-24 16:30,118,56,62,0,0,0
2019-02-24 16:45,96,42,54,0,0,0
2019-02-24 17:00,111,44,67,0,0,0
2019-02-24 17:15,88,27,61,0,0,0
2019-02-24 17:30,84,32,52,0,0,0
2019-02-24 17:45,90,43,47,0,0,0
2019-02-24 18:00,93,34,59,0,0,0
2019-02-24 18:15,80,33,47,0,0,0
2019-02-24 18:30,59,19,40,0,0,0
2019-02-24 18:45,62,34,28,0,0,0
2019-02-24 19:00,66,20,46,0,0,0
2019-02-24 19:15,50,17,33,0,0,0
2019-02-24 19:30,37,11,26,0,0,0
2019-02-24 19:45,47,25,22,0,0,0
2019-02-24 20:00,62,20,42,0,0,0
2019-02-24 20:15,34,9,25,0,0,0
2019-02-24 20:30,37,13,24,0,0,0
2019-02-24 20:45,25,6,19,0,0,0
2019-02-24 21:00,31,7,24,0,0,0
2019-02-24 21:15,21,9,12,0,0,0
2019-02-24 21:30,28,11,17,0,0,0
2019-02-24 21:45,22,8,14,0,0,0
2019-02-24 22:00,17,5,12,0,0,0
2019-02-24 22:15,15,4,11,0,0,0
2019-02-24 22:30,17,3,14,0,0,0
2019-02-24 22:45,13,5,8,0,0,0
2019-02-24 23:00,11,1,10,0,0,0
2019-02-24 23:15,8,3,5,0,0,0
2019-02-24 23:30,12,3,9,0,0,0
2019-02-24 23:45,6,4,2,0,0,0
2019-02-25 00:00,6,0,6,0,0,0
2019-02-25 00:15,1,1,0,0,0,0
2019-02-25 00:30,6,1,5,0,0,0
2019-02-25 00:45,5,2,3,0,0,0
2019-02-25 01:00,1,0,1,0,0,0
2019-02-25 01:15,2,0,2,0,0,0
2019-02-25 01:30,2,0,2,0,0,0
2019-02-25 01:45,2,0,2,0,0,0
2019-02-25 02:00,0,0,0,0,0,0
2019-02-25 02:15,0,0,0,0,0,0
2019-02-25 02:30,0,0,0,0,0,0
2019-02-25 02:45,2,2,0,0,0,0
2019-02-25 03:00,0,0,0,0,0,0
2019-02-25 03:15,1,0,1,0,0,0
2019-02-25 03:30,0,0,0,0,0,0
2019-02-25 03:45,0,0,0,0,0,0
2019-02-25 04:00,1,0,1,0,0,0
2019-02-25 04:15,1,0,1,0,0,0
2019-02-25 04:30,0,0,0,0,0,0
2019-02-25 04:45,3,3,0,0,0,0
2019-02-25 05:00,4,4,0,0,0,0
2019-02-25 05:15,7,3,4,0,0,0
2019-02-25 05:30,20,16,4,0,0,0
2019-02-25 05:45,24,17,7,0,0,0
2019-02-25 06:00,20,12,8,0,0,0
2019-02-25 06:15,29,25,4,0,0,0
2019-02-25 06:30,47,31,16,0,0,0
2019-02-25 06:45,65,43,22,0,0,0
2019-02-25 07:00,60,41,19,0,0,0
2019-02-25 07:15,127,73,54,0,0,0
2019-02-25 07:30,147,104,43,0,0,0
2019-02-25 07:45,178,120,58,0,0,0
2019-02-25 08:00,128,84,44,0,0,0
2019-02-25 08:15,150,107,43,0,0,0
2019-02-25 08:30,116,74,42,0,0,0
2019-02-25 08:45,136,95,41,0,0,0
2019-02-25 09:00,87,62,25,0,0,0
2019-02-25 09:15,117,72,45,0,0,0
2019-02-25 09:30,107,79,28,0,0,0
2019-02-25 09:45,122,81,41,0,0,0
2019-02-25 10:00,105,62,43,0,0,0
2019-02-25 10:15,77,45,32,0,0,0
2019-02-25 10:30,96,57,39,0,0,0
2019-02-25 10:45,116,63,53,0,0,0
2019-02-25 11:00,102,48,54,0,0,0
2019-02-25 11:15,121,62,59,0,0,0
2019-02-25 11:30,143,74,69,0,0,0
2019-02-25 11:45,125,67,58,0,0,0
2019-02-25 12:00,142,59,83,0,0,0
2019-02-25 12:15,118,51,67,0,0,0
2019-02-25 12:30,138,56,82,0,0,0
2019-02-25 12:45,150,70,80,0,0,0
2019-02-25 13:00,142,55,87,0,0,0
2019-02-25 13:15,157,65,92,0,0,0
2019-02-25 13:30,145,67,78,0,0,0
2019-02-25 13:45,179,80,99,0,0,0
2019-02-25 14:00,149,48,101,0,0,0
2019-02-25 14:15,155,63,92,0,0,0
2019-02-25 14:30,159,75,84,0,0,0
2019-02-25 14:45,154,98,56,0,0,0
2019-02-25 15:00,181,75,106,0,0,0
2019-02-25 15:15,172,74,98,0,0,0
2019-02-25 15:30,148,60,88,0,0,0
2019-02-25 15:45,203,85,118,0,0,0
2019-02-25 16:00,192,86,106,0,0,0
2019-02-25 16:15,193,62,131,0,0,0
2019-02-25 16:30,248,97,151,0,0,0
2019-02-25 16:45,227,86,141,0,0,0
2019-02-25 17:00,221,75,146,0,0,0
2019-02-25 17:15,186,65,121,0,0,0
2019-02-25 17:30,184,64,120,0,0,0
2019-02-25 17:45,234,91,143,0,0,0
2019-02-25 18:00,229,75,154,0,0,0
2019-02-25 18:15,194,78,116,0,0,0
2019-02-25 18:30,137,53,84,0,0,0
2019-02-25 18:45,143,55,88,0,0,0
2019-02-25 19:00,124,29,95,0,0,0
2019-02-25 19:15,132,42,90,0,0,0
2019-02-25 19:30,100,34,66,0,0,0
2019-02-25 19:45,110,44,66,0,0,0
2019-02-25 20:00,81,22,59,0,0,0
2019-02-25 20:15,60,16,44,0,0,0
2019-02-25 20:30,70,22,48,0,0,0
2019-02-25 20:45,60,21,39,0,0,0
2019-02-25 21:00,55,18,37,0,0,0
2019-02-25 21:15,50,11,39,0,0,0
2019-02-25 21:30,44,16,28,0,0,0
2019-02-25 21:45,54,24,30,0,0,0
2019-02-25 22:00,63,21,42,0,0,0
2019-02-25 22:15,61,24,37,0,0,0
2019-02-25 22:30,46,17,29,0,0,0
2019-02-25 22:45,41,6,35,0,0,0
2019-02-25 23:00,30,4,26,0,0,0
2019-02-25 23:15,20,5,15,0,0,0
2019-02-25 23:30,11,5,6,0,0,0
2019-02-25 23:45,16,7,9,0,0,0
2019-02-26 00:00,10,4,6,0,0,0
2019-02-26 00:15,6,4,2,0,0,0
2019-02-26 00:30,9,3,6,0,0,0
2019-02-26 00:45,3,0,3,0,0,0
2019-02-26 01:00,11,4,7,0,0,0
2019-02-26 01:15,2,0,2,0,0,0
2019-02-26 01:30,1,0,1,0,0,0
2019-02-26 01:45,2,0,2,0,0,0
2019-02-26 02:00,2,1,1,0,0,0
2019-02-26 02:15,1,0,1,0,0,0
2019-02-26 02:30,1,0,1,0,0,0
2019-02-26 02:45,2,2,0,0,0,0
2019-02-26 03:00,1,1,0,0,0,0
2019-02-26 03:15,2,0,2,0,0,0
2019-02-26 03:30,2,0,2,0,0,0
2019-02-26 03:45,1,0,1,0,0,0
2019-02-26 04:00,1,1,0,0,0,0
2019-02-26 04:15,0,0,0,0,0,0
2019-02-26 04:30,0,0,0,0,0,0
2019-02-26 04:45,2,2,0,0,0,0
2019-02-26 05:00,4,4,0,0,0,0
2019-02-26 05:15,11,6,5,0,0,0
2019-02-26 05:30,11,7,4,0,0,0
2019-02-26 05:45,28,19,9,0,0,0
2019-02-26 06:00,27,19,8,0,0,0
2019-02-26 06:15,32,27,5,0,0,0
2019-02-26 06:30,54,42,12,0,0,0
2019-02-26 06:45,65,48,17,0,0,0
2019-02-26 07:00,71,47,24,0,0,0
2019-02-26 07:15,143,87,56,0,0,0
2019-02-26 07:30,186,116,70,0,0,0
2019-02-26 07:45,191,141,50,0,0,0
2019-02-26 08:00,144,102,42,0,0,0
2019-02-26 08:15,164,114,50,0,0,0
2019-02-26 08:30,136,103,33,0,0,0
2019-02-26 08:45,136,92,44,0,0,0
2019-02-26 09:00,107,63,44,0,0,0
2019-02-26 09:15,104,64,40,0,0,0
2019-02-26 09:30,114,82,32,0,0,0
2019-02-26 09:45,125,84,41,0,0,0
2019-02-26 10:00,97,65,32,0,0,0
2019-02-26 10:15,91,55,36,0,0,0
2019-02-26 10:30,107,63,44,0,0,0
2019-02-26 10:45,101,67,34,0,0,0
2019-02-26 11:00,95,56,39,0,0,0
2019-02-26 11:15,107,55,52,0,0,0
2019-02-26 11:30,102,56,46,0,0,0
2019-02-26 11:45,112,54,58,0,0,0
2019-02-26 12:00,131,58,73,0,0,0
2019-02-26 12:15,140,62,78,0,0,0
2019-02-26 12:30,165,77,88,0,0,0
2019-02-26 12:45,153,79,74,0,0,0
2019-02-26 13:00,138,56,82,0,0,0
2019-02-26 13:15,160,68,92,0,0,0
2019-02-26 13:30,160,73,87,0,0,0
2019-02-26 13:45,181,74,107,0,0,0
2019-02-26 14:00,146,62,84,0,0,0
2019-02-26 14:15,167,73,94,0,0,0
2019-02-26 14:30,149,67,82,0,0,0
2019-02-26 14:45,169,70,99,0,0,0
2019-02-26 15:00,173,63,110,0,0,0
2019-02-26 15:15,169,65,104,0,0,0
2019-02-26 15:30,165,76,89,0,0,0
2019-02-26 15:45,191,87,104,0,0,0
2019-02-26 16:00,222,89,133,0,0,0
2019-02-26 16:15,206,85,121,0,0,0
2019-02-26 16:30,203,74,129,0,0,0
2019-02-26 16:45,212,85,127,0,0,0
2019-02-26 17:00,199,73,126,0,0,0
2019-02-26 17:15,209,72,137,0,0,0
2019-02-26 17:30,231,87,144,0,0,0
2019-02-26 17:45,247,86,161,0,0,0
2019-02-26 18:00,199,67,132,0,0,0
2019-02-26 18:15,164,55,109,0,0,0
2019-02-26 18:30,153,65,88,0,0,0
2019-02-26 18:45,172,80,92,0,0,0
2019-02-26 19:00,137,54,83,0,0,0
2019-02-26 19:15,134,50,84,0,0,0
2019-02-26 19:30,93,33,60,0,0,0
2019-02-26 19:45,105,47,58,0,0,0
2019-02-26 20:00,89,32,57,0,0,0
2019-02-26 20:15,62,24,38,0,0,0
2019-02-26 20:30,60,19,41,0,0,0
2019-02-26 20:45,60,21,39,0,0,0
2019-02-26 21:00,48,13,35,0,0,0
2019-02-26 21:15,61,14,47,0,0,0
2019-02-26 21:30,44,12,32,0,0,0
2019-02-26 21:45,67,21,46,0,0,0
2019-02-26 22:00,61,11,50,0,0,0
2019-02-26 22:15,63,16,47,0,0,0
2019-02-26 22:30,57,10,47,0,0,0
2019-02-26 22:45,36,11,25,0,0,0
2019-02-26 23:00,28,6,22,0,0,0
2019-02-26 23:15,20,6,14,0,0,0
2019-02-26 23:30,17,2,15,0,0,0
2019-02-26 23:45,19,8,11,0,0,0
2019-02-27 00:00,10,1,9,0,0,0
2019-02-27 00:15,8,1,7,0,0,0
2019-02-27 00:30,7,2,5,0,0,0
2019-02-27 00:45,6,2,4,0,0,0
2019-02-27 01:00,1,1,0,0,0,0
2019-02-27 01:15,4,1,3,0,0,0
2019-02-27 01:30,0,0,0,0,0,0
2019-02-27 01:45,5,0,5,0,0,0
2019-02-27 02:00,0,0,0,0,0,0
2019-02-27 02:15,3,1,2,0,0,0
2019-02-27 02:30,1,0,1,0,0,0
2019-02-27 02:45,4,2,2,0,0,0
2019-02-27 03:00,0,0,0,0,0,0
2019-02-27 03:15,1,1,0,0,0,0
2019-02-27 03:30,1,0,1,0,0,0
2019-02-27 03:45,1,1,0,0,0,0
2019-02-27 04:00,1,0,1,0,0,0
2019-02-27 04:15,1,0,1,0,0,0
2019-02-27 04:30,0,0,0,0,0,0
2019-02-27 04:45,4,4,0,0,0,0
2019-02-27 05:00,3,3,0,0,0,0
2019-02-27 05:15,13,8,5,0,0,0
2019-02-27 05:30,18,11,7,0,0,0
2019-02-27 05:45,31,21,10,0,0,0
2019-02-27 06:00,26,21,5,0,0,0
2019-02-27 06:15,34,33,1,0,0,0
2019-02-27 06:30,47,32,15,0,0,0
2019-02-27 06:45,78,52,26,0,0,0
2019-02-27 07:00,82,49,33,0,0,0
2019-02-27 07:15,127,83,44,0,0,0
2019-02-27 07:30,168,116,52,0,0,0
2019-02-27 07:45,176,128,48,0,0,0
2019-02-27 08:00,148,106,42,0,0,0
2019-02-27 08:15,176,114,62,0,0,0
2019-02-27 08:30,122,81,41,0,0,0
2019-02-27 08:45,176,126,50,0,0,0
2019-02-27 09:00,107,68,39,0,0,0
2019-02-27 09:15,112,77,35,0,0,0
2019-02-27 09:30,123,96,27,0,0,0
2019-02-27 09:45,140,94,46,0,0,0
2019-02-27 10:00,113,78,35,0,0,0
2019-02-27 10:15,119,74,45,0,0,0
2019-02-27 10:30,119,65,54,0,0,0
2019-02-27 10:45,110,64,46,0,0,0
2019-02-27 11:00,132,67,65,0,0,0
2019-02-27 11:15,123,70,53,0,0,0
2019-02-27 11:30,124,60,64,0,0,0
2019-02-27 11:45,154,80,74,0,0,0
2019-02-27 12:00,128,55,73,0,0,0
2019-02-27 12:15,154,70,84,0,0,0
2019-02-27 12:30,173,69,104,0,0,0
2019-02-27 12:45,159,80,79,0,0,0
2019-02-27 13:00,174,77,97,0,0,0
2019-02-27 13:15,184,70,114,0,0,0
2019-02-27 13:30,166,70,96,0,0,0
2019-02-27 13:45,168,72,96,0,0,0
2019-02-27 14:00,139,50,89,0,0,0
2019-02-27 14:15,168,58,110,0,0,0
2019-02-27 14:30,172,68,104,0,0,0
2019-02-27 14:45,187,71,116,0,0,0
2019-02-27 15:00,177,74,103,0,0,0
2019-02-27 15:15,166,77,89,0,0,0
2019-02-27 15:30,187,85,102,0,0,0
2019-02-27 15:45,216,88,128,0,0,0
2019-02-27 16:00,211,86,125,0,0,0
2019-02-27 16:15,221,79,142,0,0,0
2019-02-27 16:30,205,83,122,0,0,0
2019-02-27 16:45,198,87,111,0,0,0
2019-02-27 17:00,228,94,134,0,0,0
2019-02-27 17:15,233,115,118,0,0,0
2019-02-27 17:30,205,89,116,0,0,0
2019-02-27 17:45,257,111,146,0,0,0
2019-02-27 18:00,206,69,137,0,0,0
2019-02-27 18:15,186,73,113,0,0,0
2019-02-27 18:30,172,56,116,0,0,0
2019-02-27 18:45,148,65,83,0,0,0
2019-02-27 19:00,162,62,100,0,0,0
2019-02-27 19:15,150,69,81,0,0,0
2019-02-27 19:30,122,36,86,0,0,0
2019-02-27 19:45,136,52,84,0,0,0
2019-02-27 20:00,108,32,76,0,0,0
2019-02-27 20:15,94,33,61,0,0,0
2019-02-27 20:30,51,21,30,0,0,0
2019-02-27 20:45,58,13,45,0,0,0
2019-02-27 21:00,66,26,40,0,0,0
2019-02-27 21:15,61,20,41,0,0,0
2019-02-27 21:30,45,17,28,0,0,0
2019-02-27 21:45,79,23,56,0,0,0
2019-02-27 22:00,60,11,49,0,0,0
2019-02-27 22:15,48,19,29,0,0,0
2019-02-27 22:30,55,25,30,0,0,0
2019-02-27 22:45,54,21,33,0,0,0
2019-02-27 23:00,27,10,17,0,0,0
2019-02-27 23:15,22,7,15,0,0,0
2019-02-27 23:30,23,7,16,0,0,0
2019-02-27 23:45,24,8,16,0,0,0
2019-02-28 00:00,7,2,5,0,0,0
2019-02-28 00:15,8,3,5,0,0,0
2019-02-28 00:30,6,0,6,0,0,0
2019-02-28 00:45,7,2,5,0,0,0
2019-02-28 01:00,12,3,9,0,0,0
2019-02-28 01:15,2,0,2,0,0,0
2019-02-28 01:30,3,0,3,0,0,0
2019-02-28 01:45,2,0,2,0,0,0
2019-02-28 02:00,0,0,0,0,0,0
2019-02-28 02:15,2,1,1,0,0,0
2019-02-28 02:30,1,0,1,0,0,0
2019-02-28 02:45,3,3,0,0,0,0
2019-02-28 03:00,0,0,0,0,0,0
2019-02-28 03:15,0,0,0,0,0,0
2019-02-28 03:30,2,0,2,0,0,0
2019-02-28 03:45,0,0,0,0,0,0
2019-02-28 04:00,4,1,3,0,0,0
2019-02-28 04:15,2,0,2,0,0,0
2019-02-28 04:30,2,0,2,0,0,0
2019-02-28 04:45,6,4,2,0,0,0
2019-02-28 05:00,3,3,0,0,0,0
2019-02-28 05:15,9,5,4,0,0,0
2019-02-28 05:30,14,10,4,0,0,0
2019-02-28 05:45,23,17,6,0,0,0
2019-02-28 06:00,23,13,10,0,0,0
2019-02-28 06:15,28,23,5,0,0,0
2019-02-28 06:30,39,29,10,0,0,0
2019-02-28 06:45,69,43,26,0,0,0
2019-02-28 07:00,63,41,22,0,0,0
2019-02-28 07:15,118,80,38,0,0,0
2019-02-28 07:30,182,126,56,0,0,0
2019-02-28 07:45,197,137,60,0,0,0
2019-02-28 08:00,137,90,47,0,0,0
2019-02-28 08:15,144,101,43,0,0,0
2019-02-28 08:30,144,90,54,0,0,0
2019-02-28 08:45,136,94,42,0,0,0
2019-02-28 09:00,117,78,39,0,0,0
2019-02-28 09:15,108,81,27,0,0,0
2019-02-28 09:30,95,71,24,0,0,0
2019-02-28 09:45,111,76,35,0,0,0
2019-02-28 10:00,107,59,48,0,0,0
2019-02-28 10:15,110,62,48,0,0,0
2019-02-28 10:30,105,67,38,0,0,0
2019-02-28 10:45,124,71,53,0,0,0
2019-02-28 11:00,113,54,59,0,0,0
2019-02-28 11:15,121,66,55,0,0,0
2019-02-28 11:30,126,63,63,0,0,0
2019-02-28 11:45,119,59,60,0,0,0
2019-02-28 12:00,137,51,86,0,0,0
2019-02-28 12:15,151,55,96,0,0,0
2019-02-28 12:30,156,55,101,0,0,0
2019-02-28 12:45,158,75,83,0,0,0
2019-02-28 13:00,145,54,91,0,0,0
2019-02-28 13:15,132,54,78,0,0,0
2019-02-28 13:30,135,60,75,0,0,0
2019-02-28 13:45,147,83,64,0,0,0
2019-02-28 14:00,145,58,87,0,0,0
2019-02-28 14:15,139,49,90,0,0,0
2019-02-28 14:30,125,61,64,0,0,0
2019-02-28 14:45,183,94,89,0,0,0
2019-02-28 15:00,160,87,73,0,0,0
2019-02-28 15:15,160,76,84,0,0,0
2019-02-28 15:30,162,68,94,0,0,0
2019-02-28 15:45,209,104,105,0,0,0
2019-02-28 16:00,190,94,96,0,0,0
2019-02-28 16:15,179,74,105,0,0,0
2019-02-28 16:30,182,80,102,0,0,0
2019-02-28 16:45,161,80,81,0,0,0
2019-02-28 17:00,188,78,110,0,0,0
2019-02-28 17:15,188,77,111,0,0,0
2019-02-28 17:30,180,63,117,0,0,0
2019-02-28 17:45,194,70,124,0,0,0
2019-02-28 18:00,175,61,114,0,0,0
2019-02-28 18:15,161,54,107,0,0,0
2019-02-28 18:30,142,46,96,0,0,0
2019-02-28 18:45,141,57,84,0,0,0
2019-02-28 19:00,127,39,88,0,0,0
2019-02-28 19:15,99,40,59,0,0,0
2019-02-28 19:30,84,28,56,0,0,0
2019-02-28 19:45,104,45,59,0,0,0
2019-02-28 20:00,97,29,68,0,0,0
2019-02-28 20:15,69,18,51,0,0,0
2019-02-28 20:30,52,22,30,0,0,0
2019-02-28 20:45,55,30,25,0,0,0
2019-02-28 21:00,40,19,21,0,0,0
2019-02-28 21:15,64,18,46,0,0,0
2019-02-28 21:30,70,26,44,0,0,0
2019-02-28 21:45,48,12,36,0,0,0
2019-02-28 22:00,65,25,40,0,0,0
2019-02-28 22:15,60,16,44,0,0,0
2019-02-28 22:30,32,11,21,0,0,0
2019-02-28 22:45,29,5,24,0,0,0
2019-02-28 23:00,53,6,47,0,0,0
2019-02-28 23:15,46,9,37,0,0,0
2019-02-28 23:30,20,3,17,0,0,0
2019-02-28 23:45,22,8,14,0,0,0
