Datetime,100034980 (Hammer Straße),101034980 (Hammer Straße stadteinwärts),102034980 (Hammer Straße stadtauswärts),100034980-status,101034980-status,102034980-status
2019-04-01 00:00,4,3,1,0,0,0
2019-04-01 00:15,6,3,3,0,0,0
2019-04-01 00:30,8,2,6,0,0,0
2019-04-01 00:45,2,0,2,0,0,0
2019-04-01 01:00,6,0,6,0,0,0
2019-04-01 01:15,2,0,2,0,0,0
2019-04-01 01:30,0,0,0,0,0,0
2019-04-01 01:45,2,0,2,0,0,0
2019-04-01 02:00,0,0,0,0,0,0
2019-04-01 02:15,1,0,1,0,0,0
2019-04-01 02:30,0,0,0,0,0,0
2019-04-01 02:45,1,0,1,0,0,0
2019-04-01 03:00,1,1,0,0,0,0
2019-04-01 03:15,0,0,0,0,0,0
2019-04-01 03:30,1,0,1,0,0,0
2019-04-01 03:45,1,1,0,0,0,0
2019-04-01 04:00,0,0,0,0,0,0
2019-04-01 04:15,0,0,0,0,0,0
2019-04-01 04:30,1,0,1,0,0,0
2019-04-01 04:45,3,3,0,0,0,0
2019-04-01 05:00,5,4,1,0,0,0
2019-04-01 05:15,9,6,3,0,0,0
2019-04-01 05:30,11,8,3,0,0,0
2019-04-01 05:45,25,20,5,0,0,0
2019-04-01 06:00,19,12,7,0,0,0
2019-04-01 06:15,39,29,10,0,0,0
2019-04-01 06:30,32,24,8,0,0,0
2019-04-01 06:45,52,34,18,0,0,0
2019-04-01 07:00,73,48,25,0,0,0
2019-04-01 07:15,135,85,50,0,0,0
2019-04-01 07:30,149,102,47,0,0,0
2019-04-01 07:45,190,141,49,0,0,0
2019-04-01 08:00,163,113,50,0,0,0
2019-04-01 08:15,133,95,38,0,0,0
2019-04-01 08:30,129,90,39,0,0,0
2019-04-01 08:45,148,103,45,0,0,0
2019-04-01 09:00,117,81,36,0,0,0
2019-04-01 09:15,108,69,39,0,0,0
2019-04-01 09:30,114,80,34,0,0,0
2019-04-01 09:45,143,109,34,0,0,0
2019-04-01 10:00,110,72,38,0,0,0
2019-04-01 10:15,109,54,55,0,0,0
2019-04-01 10:30,88,47,41,0,0,0
2019-04-01 10:45,128,85,43,0,0,0
2019-04-01 11:00,130,63,67,0,0,0
2019-04-01 11:15,107,56,51,0,0,0
2019-04-01 11:30,112,51,61,0,0,0
2019-04-01 11:45,145,74,71,0,0,0
2019-04-01 12:00,139,65,74,0,0,0
2019-04-01 12:15,140,49,91,0,0,0
2019-04-01 12:30,150,61,89,0,0,0
2019-04-01 12:45,136,61,75,0,0,0
2019-04-01 13:00,160,62,98,0,0,0
2019-04-01 13:15,146,56,90,0,0,0
2019-04-01 13:30,159,76,83,0,0,0
2019-04-01 13:45,166,77,89,0,0,0
2019-04-01 14:00,172,65,107,0,0,0
2019-04-01 14:15,165,56,109,0,0,0
2019-04-01 14:30,171,77,94,0,0,0
2019-04-01 14:45,177,82,95,0,0,0
2019-04-01 15:00,161,63,98,0,0,0
2019-04-01 15:15,176,75,101,0,0,0
2019-04-01 15:30,200,79,121,0,0,0
2019-04-01 15:45,226,116,110,0,0,0
2019-04-01 16:00,214,91,123,0,0,0
2019-04-01 16:15,223,81,142,0,0,0
2019-04-01 16:30,216,83,133,0,0,0
2019-04-01 16:45,242,93,149,0,0,0
2019-04-01 17:00,255,100,155,0,0,0
2019-04-01 17:15,223,73,150,0,0,0
2019-04-01 17:30,214,89,125,0,0,0
2019-04-01 17:45,246,104,142,0,0,0
2019-04-01 18:00,212,66,146,0,0,0
2019-04-01 18:15,220,80,140,0,0,0
2019-04-01 18:30,184,72,112,0,0,0
2019-04-01 18:45,199,73,126,0,0,0
2019-04-01 19:00,194,74,120,0,0,0
2019-04-01 19:15,152,54,98,0,0,0
2019-04-01 19:30,153,58,95,0,0,0
2019-04-01 19:45,155,53,102,0,0,0
2019-04-01 20:00,116,42,74,0,0,0
2019-04-01 20:15,98,37,61,0,0,0
2019-04-01 20:30,71,27,44,0,0,0
2019-04-01 20:45,53,22,31,0,0,0
2019-04-01 21:00,77,26,51,0,0,0
2019-04-01 21:15,53,18,35,0,0,0
2019-04-01 21:30,67,26,41,0,0,0
2019-04-01 21:45,65,23,42,0,0,0
2019-04-01 22:00,75,21,54,0,0,0
2019-04-01 22:15,64,19,45,0,0,0
2019-04-01 22:30,52,19,33,0,0,0
2019-04-01 22:45,41,7,34,0,0,0
2019-04-01 23:00,39,8,31,0,0,0
2019-04-01 23:15,22,4,18,0,0,0
2019-04-01 23:30,31,13,18,0,0,0
2019-04-01 23:45,8,2,6,0,0,0
2019-04-02 00:00,14,5,9,0,0,0
2019-04-02 00:15,15,6,9,0,0,0
2019-04-02 00:30,19,13,6,0,0,0
2019-04-02 00:45,6,3,3,0,0,0
2019-04-02 01:00,12,1,11,0,0,0
2019-04-02 01:15,5,1,4,0,0,0
2019-04-02 01:30,10,4,6,0,0,0
2019-04-02 01:45,3,0,3,0,0,0
2019-04-02 02:00,2,0,2,0,0,0
2019-04-02 02:15,6,2,4,0,0,0
2019-04-02 02:30,2,0,2,0,0,0
2019-04-02 02:45,5,0,5,0,0,0
2019-04-02 03:00,5,2,3,0,0,0
2019-04-02 03:15,0,0,0,0,0,0
2019-04-02 03:30,2,1,1,0,0,0
2019-04-02 03:45,0,0,0,0,0,0
2019-04-02 04:00,2,1,1,0,0,0
2019-04-02 04:15,0,0,0,0,0,0
2019-04-02 04:30,3,1,2,0,0,0
2019-04-02 04:45,7,3,4,0,0,0
2019-04-02 05:00,7,3,4,0,0,0
2019-04-02 05:15,8,4,4,0,0,0
2019-04-02 05:30,16,12,4,0,0,0
2019-04-02 05:45,24,19,5,0,0,0
2019-04-02 06:00,27,21,6,0,0,0
2019-04-02 06:15,31,23,8,0,0,0
2019-04-02 06:30,53,37,16,0,0,0
2019-04-02 06:45,80,52,28,0,0,0
2019-04-02 07:00,76,53,23,0,0,0
2019-04-02 07:15,108,73,35,0,0,0
2019-04-02 07:30,179,124,55,0,0,0
2019-04-02 07:45,192,141,51,0,0,0
2019-04-02 08:00,170,128,42,0,0,0
2019-04-02 08:15,168,119,49,0,0,0
2019-04-02 08:30,140,93,47,0,0,0
2019-04-02 08:45,163,115,48,0,0,0
2019-04-02 09:00,121,84,37,0,0,0
2019-04-02 09:15,115,78,37,0,0,0
2019-04-02 09:30,100,69,31,0,0,0
2019-04-02 09:45,151,107,44,0,0,0
2019-04-02 10:00,109,74,35,0,0,0
2019-04-02 10:15,110,47,63,0,0,0
2019-04-02 10:30,119,85,34,0,0,0
2019-04-02 10:45,127,77,50,0,0,0
2019-04-02 11:00,97,53,44,0,0,0
2019-04-02 11:15,109,54,55,0,0,0
2019-04-02 11:30,145,68,77,0,0,0
2019-04-02 11:45,127,57,70,0,0,0
2019-04-02 12:00,138,51,87,0,0,0
2019-04-02 12:15,147,58,89,0,0,0
2019-04-02 12:30,123,46,77,0,0,0
2019-04-02 12:45,147,62,85,0,0,0
2019-04-02 13:00,146,63,83,0,0,0
2019-04-02 13:15,151,47,104,0,0,0
2019-04-02 13:30,142,54,88,0,0,0
2019-04-02 13:45,182,85,97,0,0,0
2019-04-02 14:00,144,63,81,0,0,0
2019-04-02 14:15,119,47,72,0,0,0
2019-04-02 14:30,112,48,64,0,0,0
2019-04-02 14:45,145,73,72,0,0,0
2019-04-02 15:00,155,58,97,0,0,0
2019-04-02 15:15,153,61,92,0,0,0
2019-04-02 15:30,142,58,84,0,0,0
2019-04-02 15:45,165,55,110,0,0,0
2019-04-02 16:00,179,58,121,0,0,0
2019-04-02 16:15,202,67,135,0,0,0
2019-04-02 16:30,169,49,120,0,0,0
2019-04-02 16:45,166,60,106,0,0,0
2019-04-02 17:00,219,81,138,0,0,0
2019-04-02 17:15,164,52,112,0,0,0
2019-04-02 17:30,174,58,116,0,0,0
2019-04-02 17:45,206,80,126,0,0,0
2019-04-02 18:00,180,63,117,0,0,0
2019-04-02 18:15,155,49,106,0,0,0
2019-04-02 18:30,134,59,75,0,0,0
2019-04-02 18:45,141,64,77,0,0,0
2019-04-02 19:00,168,50,118,0,0,0
2019-04-02 19:15,141,55,86,0,0,0
2019-04-02 19:30,112,45,67,0,0,0
2019-04-02 19:45,120,51,69,0,0,0
2019-04-02 20:00,91,25,66,0,0,0
2019-04-02 20:15,58,25,33,0,0,0
2019-04-02 20:30,58,12,46,0,0,0
2019-04-02 20:45,40,15,25,0,0,0
2019-04-02 21:00,46,14,32,0,0,0
2019-04-02 21:15,59,16,43,0,0,0
2019-04-02 21:30,56,16,40,0,0,0
2019-04-02 21:45,49,20,29,0,0,0
2019-04-02 22:00,56,16,40,0,0,0
2019-04-02 22:15,60,10,50,0,0,0
2019-04-02 22:30,37,10,27,0,0,0
2019-04-02 22:45,44,9,35,0,0,0
2019-04-02 23:00,32,10,22,0,0,0
2019-04-02 23:15,23,5,18,0,0,0
2019-04-02 23:30,18,5,13,0,0,0
2019-04-02 23:45,16,5,11,0,0,0
2019-04-03 00:00,8,1,7,0,0,0
2019-04-03 00:15,13,2,11,0,0,0
2019-04-03 00:30,12,1,11,0,0,0
2019-04-03 00:45,7,2,5,0,0,0
2019-04-03 01:00,10,2,8,0,0,0
2019-04-03 01:15,2,0,2,0,0,0
2019-04-03 01:30,2,2,0,0,0,0
2019-04-03 01:45,3,2,1,0,0,0
2019-04-03 02:00,1,0,1,0,0,0
2019-04-03 02:15,3,0,3,0,0,0
2019-04-03 02:30,1,0,1,0,0,0
2019-04-03 02:45,0,0,0,0,0,0
2019-04-03 03:00,1,1,0,0,0,0
2019-04-03 03:15,0,0,0,0,0,0
2019-04-03 03:30,0,0,0,0,0,0
2019-04-03 03:45,3,1,2,0,0,0
2019-04-03 04:00,0,0,0,0,0,0
2019-04-03 04:15,1,0,1,0,0,0
2019-04-03 04:30,1,1,0,0,0,0
2019-04-03 04:45,5,3,2,0,0,0
2019-04-03 05:00,2,2,0,0,0,0
2019-04-03 05:15,11,6,5,0,0,0
2019-04-03 05:30,13,9,4,0,0,0
2019-04-03 05:45,20,18,2,0,0,0
2019-04-03 06:00,24,17,7,0,0,0
2019-04-03 06:15,32,26,6,0,0,0
2019-04-03 06:30,53,40,13,0,0,0
2019-04-03 06:45,76,51,25,0,0,0
2019-04-03 07:00,74,52,22,0,0,0
2019-04-03 07:15,133,90,43,0,0,0
2019-04-03 07:30,146,104,42,0,0,0
2019-04-03 07:45,209,161,48,0,0,0
2019-04-03 08:00,143,108,35,0,0,0
2019-04-03 08:15,131,90,41,0,0,0
2019-04-03 08:30,144,96,48,0,0,0
2019-04-03 08:45,147,106,41,0,0,0
2019-04-03 09:00,104,70,34,0,0,0
2019-04-03 09:15,104,74,30,0,0,0
2019-04-03 09:30,109,74,35,0,0,0
2019-04-03 09:45,141,109,32,0,0,0
2019-04-03 10:00,98,63,35,0,0,0
2019-04-03 10:15,96,57,39,0,0,0
2019-04-03 10:30,92,49,43,0,0,0
2019-04-03 10:45,93,53,40,0,0,0
2019-04-03 11:00,71,37,34,0,0,0
2019-04-03 11:15,86,31,55,0,0,0
2019-04-03 11:30,91,39,52,0,0,0
2019-04-03 11:45,119,56,63,0,0,0
2019-04-03 12:00,106,42,64,0,0,0
2019-04-03 12:15,102,43,59,0,0,0
2019-04-03 12:30,101,38,63,0,0,0
2019-04-03 12:45,111,45,66,0,0,0
2019-04-03 13:00,127,43,84,0,0,0
2019-04-03 13:15,109,37,72,0,0,0
2019-04-03 13:30,119,42,77,0,0,0
2019-04-03 13:45,135,62,73,0,0,0
2019-04-03 14:00,116,42,74,0,0,0
2019-04-03 14:15,102,37,65,0,0,0
2019-04-03 14:30,111,38,73,0,0,0
2019-04-03 14:45,149,64,85,0,0,0
2019-04-03 15:00,150,64,86,0,0,0
2019-04-03 15:15,135,55,80,0,0,0
2019-04-03 15:30,133,50,83,0,0,0
2019-04-03 15:45,177,71,106,0,0,0
2019-04-03 16:00,178,66,112,0,0,0
2019-04-03 16:15,192,76,116,0,0,0
2019-04-03 16:30,179,65,114,0,0,0
2019-04-03 16:45,188,74,114,0,0,0
2019-04-03 17:00,178,72,106,0,0,0
2019-04-03 17:15,176,71,105,0,0,0
2019-04-03 17:30,203,83,120,0,0,0
2019-04-03 17:45,191,85,106,0,0,0
2019-04-03 18:00,210,75,135,0,0,0
2019-04-03 18:15,146,60,86,0,0,0
2019-04-03 18:30,139,43,96,0,0,0
2019-04-03 18:45,172,60,112,0,0,0
2019-04-03 19:00,152,55,97,0,0,0
2019-04-03 19:15,148,42,106,0,0,0
2019-04-03 19:30,103,37,66,0,0,0
2019-04-03 19:45,134,69,65,0,0,0
2019-04-03 20:00,111,43,68,0,0,0
2019-04-03 20:15,83,38,45,0,0,0
2019-04-03 20:30,82,30,52,0,0,0
2019-04-03 20:45,74,28,46,0,0,0
2019-04-03 21:00,67,20,47,0,0,0
2019-04-03 21:15,55,19,36,0,0,0
2019-04-03 21:30,61,22,39,0,0,0
2019-04-03 21:45,53,25,28,0,0,0
2019-04-03 22:00,51,21,30,0,0,0
2019-04-03 22:15,55,23,32,0,0,0
2019-04-03 22:30,44,15,29,0,0,0
2019-04-03 22:45,64,34,30,0,0,0
2019-04-03 23:00,37,17,20,0,0,0
2019-04-03 23:15,42,16,26,0,0,0
2019-04-03 23:30,33,18,15,0,0,0
2019-04-03 23:45,31,18,13,0,0,0
2019-04-04 00:00,22,9,13,0,0,0
2019-04-04 00:15,17,9,8,0,0,0
2019-04-04 00:30,17,8,9,0,0,0
2019-04-04 00:45,12,7,5,0,0,0
2019-04-04 01:00,7,3,4,0,0,0
2019-04-04 01:15,15,3,12,0,0,0
2019-04-04 01:30,7,4,3,0,0,0
2019-04-04 01:45,5,2,3,0,0,0
2019-04-04 02:00,10,1,9,0,0,0
2019-04-04 02:15,6,0,6,0,0,0
2019-04-04 02:30,12,1,11,0,0,0
2019-04-04 02:45,8,0,8,0,0,0
2019-04-04 03:00,2,1,1,0,0,0
2019-04-04 03:15,8,0,8,0,0,0
2019-04-04 03:30,4,0,4,0,0,0
2019-04-04 03:45,5,1,4,0,0,0
2019-04-04 04:00,6,0,6,0,0,0
2019-04-04 04:15,3,1,2,0,0,0
2019-04-04 04:30,2,1,1,0,0,0
2019-04-04 04:45,4,4,0,0,0,0
2019-04-04 05:00,6,3,3,0,0,0
2019-04-04 05:15,7,5,2,0,0,0
2019-04-04 05:30,18,11,7,0,0,0
2019-04-04 05:45,26,20,6,0,0,0
2019-04-04 06:00,24,16,8,0,0,0
2019-04-04 06:15,29,27,2,0,0,0
2019-04-04 06:30,32,23,9,0,0,0
2019-04-04 06:45,63,51,12,0,0,0
2019-04-04 07:00,65,42,23,0,0,0
2019-04-04 07:15,102,72,30,0,0,0
2019-04-04 07:30,159,114,45,0,0,0
2019-04-04 07:45,195,146,49,0,0,0
2019-04-04 08:00,165,126,39,0,0,0
2019-04-04 08:15,130,86,44,0,0,0
2019-04-04 08:30,124,83,41,0,0,0
2019-04-04 08:45,145,109,36,0,0,0
2019-04-04 09:00,88,60,28,0,0,0
2019-04-04 09:15,84,57,27,0,0,0
2019-04-04 09:30,90,64,26,0,0,0
2019-04-04 09:45,120,84,36,0,0,0
2019-04-04 10:00,103,50,53,0,0,0
2019-04-04 10:15,76,40,36,0,0,0
2019-04-04 10:30,62,34,28,0,0,0
2019-04-04 10:45,82,39,43,0,0,0
2019-04-04 11:00,64,36,28,0,0,0
2019-04-04 11:15,73,33,40,0,0,0
2019-04-04 11:30,70,29,41,0,0,0
2019-04-04 11:45,109,48,61,0,0,0
2019-04-04 12:00,91,48,43,0,0,0
2019-04-04 12:15,98,38,60,0,0,0
2019-04-04 12:30,110,31,79,0,0,0
2019-04-04 12:45,81,36,45,0,0,0
2019-04-04 13:00,103,32,71,0,0,0
2019-04-04 13:15,98,32,66,0,0,0
2019-04-04 13:30,105,44,61,0,0,0
2019-04-04 13:45,112,47,65,0,0,0
2019-04-04 14:00,126,54,72,0,0,0
2019-04-04 14:15,87,36,51,0,0,0
2019-04-04 14:30,106,40,66,0,0,0
2019-04-04 14:45,140,52,88,0,0,0
2019-04-04 15:00,102,37,65,0,0,0
2019-04-04 15:15,125,43,82,0,0,0
2019-04-04 15:30,144,47,97,0,0,0
2019-04-04 15:45,165,67,98,0,0,0
2019-04-04 16:00,153,51,102,0,0,0
2019-04-04 16:15,142,58,84,0,0,0
2019-04-04 16:30,153,52,101,0,0,0
2019-04-04 16:45,148,58,90,0,0,0
2019-04-04 17:00,124,43,81,0,0,0
2019-04-04 17:15,137,48,89,0,0,0
2019-04-04 17:30,155,58,97,0,0,0
2019-04-04 17:45,164,66,98,0,0,0
2019-04-04 18:00,163,48,115,0,0,0
2019-04-04 18:15,158,46,112,0,0,0
2019-04-04 18:30,115,43,72,0,0,0
2019-04-04 18:45,113,44,69,0,0,0
2019-04-04 19:00,102,31,71,0,0,0
2019-04-04 19:15,104,32,72,0,0,0
2019-04-04 19:30,109,36,73,0,0,0
2019-04-04 19:45,78,35,43,0,0,0
2019-04-04 20:00,75,34,41,0,0,0
2019-04-04 20:15,69,20,49,0,0,0
2019-04-04 20:30,48,20,28,0,0,0
2019-04-04 20:45,53,22,31,0,0,0
2019-04-04 21:00,53,29,24,0,0,0
2019-04-04 21:15,44,12,32,0,0,0
2019-04-04 21:30,43,19,24,0,0,0
2019-04-04 21:45,61,15,46,0,0,0
2019-04-04 22:00,50,16,34,0,0,0
2019-04-04 22:15,42,14,28,0,0,0
2019-04-04 22:30,47,18,29,0,0,0
2019-04-04 22:45,45,15,30,0,0,0
2019-04-04 23:00,29,9,20,0,0,0
2019-04-04 23:15,30,7,23,0,0,0
2019-04-04 23:30,18,5,13,0,0,0
2019-04-04 23:45,14,1,13,0,0,0
2019-04-05 00:00,21,4,17,0,0,0
2019-04-05 00:15,10,3,7,0,0,0
2019-04-05 00:30,9,3,6,0,0,0
2019-04-05 00:45,8,5,3,0,0,0
2019-04-05 01:00,9,2,7,0,0,0
2019-04-05 01:15,3,1,2,0,0,0
2019-04-05 01:30,1,1,0,0,0,0
2019-04-05 01:45,2,1,1,0,0,0
2019-04-05 02:00,9,0,9,0,0,0
2019-04-05 02:15,2,0,2,0,0,0
2019-04-05 02:30,3,0,3,0,0,0
2019-04-05 02:45,6,3,3,0,0,0
2019-04-05 03:00,1,0,1,0,0,0
2019-04-05 03:15,0,0,0,0,0,0
2019-04-05 03:30,0,0,0,0,0,0
2019-04-05 03:45,2,0,2,0,0,0
2019-04-05 04:00,2,0,2,0,0,0
2019-04-05 04:15,2,1,1,0,0,0
2019-04-05 04:30,0,0,0,0,0,0
2019-04-05 04:45,3,3,0,0,0,0
2019-04-05 05:00,5,3,2,0,0,0
2019-04-05 05:15,4,2,2,0,0,0
2019-04-05 05:30,11,6,5,0,0,0
2019-04-05 05:45,21,19,2,0,0,0
2019-04-05 06:00,13,11,2,0,0,0
2019-04-05 06:15,31,25,6,0,0,0
2019-04-05 06:30,36,27,9,0,0,0
2019-04-05 06:45,67,45,22,0,0,0
2019-04-05 07:00,72,46,26,0,0,0
2019-04-05 07:15,93,59,34,0,0,0
2019-04-05 07:30,134,95,39,0,0,0
2019-04-05 07:45,172,131,41,0,0,0
2019-04-05 08:00,112,84,28,0,0,0
2019-04-05 08:15,115,71,44,0,0,0
2019-04-05 08:30,124,82,42,0,0,0
2019-04-05 08:45,118,83,35,0,0,0
2019-04-05 09:00,62,43,19,0,0,0
2019-04-05 09:15,68,50,18,0,0,0
2019-04-05 09:30,86,51,35,0,0,0
2019-04-05 09:45,112,86,26,0,0,0
2019-04-05 10:00,115,63,52,0,0,0
2019-04-05 10:15,89,54,35,0,0,0
2019-04-05 10:30,101,47,54,0,0,0
2019-04-05 10:45,100,52,48,0,0,0
2019-04-05 11:00,82,40,42,0,0,0
2019-04-05 11:15,108,58,50,0,0,0
2019-04-05 11:30,118,48,70,0,0,0
2019-04-05 11:45,117,62,55,0,0,0
2019-04-05 12:00,126,55,71,0,0,0
2019-04-05 12:15,116,51,65,0,0,0
2019-04-05 12:30,154,56,98,0,0,0
2019-04-05 12:45,140,54,86,0,0,0
2019-04-05 13:00,170,55,115,0,0,0
2019-04-05 13:15,171,67,104,0,0,0
2019-04-05 13:30,144,58,86,0,0,0
2019-04-05 13:45,178,72,106,0,0,0
2019-04-05 14:00,169,71,98,0,0,0
2019-04-05 14:15,149,52,97,0,0,0
2019-04-05 14:30,150,67,83,0,0,0
2019-04-05 14:45,167,60,107,0,0,0
2019-04-05 15:00,151,60,91,0,0,0
2019-04-05 15:15,156,64,92,0,0,0
2019-04-05 15:30,191,83,108,0,0,0
2019-04-05 15:45,163,60,103,0,0,0
2019-04-05 16:00,157,59,98,0,0,0
2019-04-05 16:15,119,49,70,0,0,0
2019-04-05 16:30,144,56,88,0,0,0
2019-04-05 16:45,160,68,92,0,0,0
2019-04-05 17:00,143,48,95,0,0,0
2019-04-05 17:15,163,60,103,0,0,0
2019-04-05 17:30,169,59,110,0,0,0
2019-04-05 17:45,189,64,125,0,0,0
2019-04-05 18:00,204,52,152,0,0,0
2019-04-05 18:15,216,69,147,0,0,0
2019-04-05 18:30,155,50,105,0,0,0
2019-04-05 18:45,132,55,77,0,0,0
2019-04-05 19:00,118,55,63,0,0,0
2019-04-05 19:15,118,63,55,0,0,0
2019-04-05 19:30,74,34,40,0,0,0
2019-04-05 19:45,108,44,64,0,0,0
2019-04-05 20:00,98,32,66,0,0,0
2019-04-05 20:15,87,45,42,0,0,0
2019-04-05 20:30,62,37,25,0,0,0
2019-04-05 20:45,64,43,21,0,0,0
2019-04-05 21:00,179,144,35,0,0,0
2019-04-05 21:15,142,114,28,0,0,0
2019-04-05 21:30,84,50,34,0,0,0
2019-04-05 21:45,94,46,48,0,0,0
2019-04-05 22:00,62,22,40,0,0,0
2019-04-05 22:15,62,30,32,0,0,0
2019-04-05 22:30,72,24,48,0,0,0
2019-04-05 22:45,48,26,22,0,0,0
2019-04-05 23:00,55,14,41,0,0,0
2019-04-05 23:15,44,22,22,0,0,0
2019-04-05 23:30,54,25,29,0,0,0
2019-04-05 23:45,70,33,37,0,0,0
2019-04-06 00:00,45,22,23,0,0,0
2019-04-06 00:15,38,14,24,0,0,0
2019-04-06 00:30,32,6,26,0,0,0
2019-04-06 00:45,42,6,36,0,0,0
2019-04-06 01:00,41,18,23,0,0,0
2019-04-06 01:15,20,11,9,0,0,0
2019-04-06 01:30,27,10,17,0,0,0
2019-04-06 01:45,19,2,17,0,0,0
2019-04-06 02:00,20,3,17,0,0,0
2019-04-06 02:15,27,14,13,0,0,0
2019-04-06 02:30,9,0,9,0,0,0
2019-04-06 02:45,8,2,6,0,0,0
2019-04-06 03:00,14,1,13,0,0,0
2019-04-06 03:15,13,5,8,0,0,0
2019-04-06 03:30,16,5,11,0,0,0
2019-04-06 03:45,19,1,18,0,0,0
2019-04-06 04:00,4,0,4,0,0,0
2019-04-06 04:15,6,3,3,0,0,0
2019-04-06 04:30,5,2,3,0,0,0
2019-04-06 04:45,2,1,1,0,0,0
2019-04-06 05:00,6,1,5,0,0,0
2019-04-06 05:15,8,2,6,0,0,0
2019-04-06 05:30,14,7,7,0,0,0
2019-04-06 05:45,11,6,5,0,0,0
2019-04-06 06:00,14,8,6,0,0,0
2019-04-06 06:15,6,4,2,0,0,0
2019-04-06 06:30,8,5,3,0,0,0
2019-04-06 06:45,11,7,4,0,0,0
2019-04-06 07:00,8,5,3,0,0,0
2019-04-06 07:15,13,12,1,0,0,0
2019-04-06 07:30,24,14,10,0,0,0
2019-04-06 07:45,39,28,11,0,0,0
2019-04-06 08:00,29,17,12,0,0,0
2019-04-06 08:15,34,24,10,0,0,0
2019-04-06 08:30,44,24,20,0,0,0
2019-04-06 08:45,63,47,16,0,0,0
2019-04-06 09:00,65,43,22,0,0,0
2019-04-06 09:15,74,54,20,0,0,0
2019-04-06 09:30,91,66,25,0,0,0
2019-04-06 09:45,143,107,36,0,0,0
2019-04-06 10:00,103,72,31,0,0,0
2019-04-06 10:15,135,90,45,0,0,0
2019-04-06 10:30,141,106,35,0,0,0
2019-04-06 10:45,153,102,51,0,0,0
2019-04-06 11:00,135,91,44,0,0,0
2019-04-06 11:15,145,88,57,0,0,0
2019-04-06 11:30,155,87,68,0,0,0
2019-04-06 11:45,162,104,58,0,0,0
2019-04-06 12:00,181,102,79,0,0,0
2019-04-06 12:15,190,98,92,0,0,0
2019-04-06 12:30,203,123,80,0,0,0
2019-04-06 12:45,194,102,92,0,0,0
2019-04-06 13:00,172,82,90,0,0,0
2019-04-06 13:15,209,98,111,0,0,0
2019-04-06 13:30,212,111,101,0,0,0
2019-04-06 13:45,223,107,116,0,0,0
2019-04-06 14:00,147,56,91,0,0,0
2019-04-06 14:15,205,87,118,0,0,0
2019-04-06 14:30,175,83,92,0,0,0
2019-04-06 14:45,184,62,122,0,0,0
2019-04-06 15:00,182,76,106,0,0,0
2019-04-06 15:15,149,65,84,0,0,0
2019-04-06 15:30,177,71,106,0,0,0
2019-04-06 15:45,167,63,104,0,0,0
2019-04-06 16:00,150,66,84,0,0,0
2019-04-06 16:15,157,64,93,0,0,0
2019-04-06 16:30,133,45,88,0,0,0
2019-04-06 16:45,173,55,118,0,0,0
2019-04-06 17:00,169,75,94,0,0,0
2019-04-06 17:15,154,50,104,0,0,0
2019-04-06 17:30,146,59,87,0,0,0
2019-04-06 17:45,196,84,112,0,0,0
2019-04-06 18:00,186,57,129,0,0,0
2019-04-06 18:15,176,62,114,0,0,0
2019-04-06 18:30,133,40,93,0,0,0
2019-04-06 18:45,143,65,78,0,0,0
2019-04-06 19:00,140,53,87,0,0,0
2019-04-06 19:15,114,46,68,0,0,0
2019-04-06 19:30,77,39,38,0,0,0
2019-04-06 19:45,109,55,54,0,0,0
2019-04-06 20:00,97,42,55,0,0,0
2019-04-06 20:15,95,46,49,0,0,0
2019-04-06 20:30,121,52,69,0,0,0
2019-04-06 20:45,88,33,55,0,0,0
2019-04-06 21:00,72,29,43,0,0,0
2019-04-06 21:15,60,29,31,0,0,0
2019-04-06 21:30,50,17,33,0,0,0
2019-04-06 21:45,64,35,29,0,0,0
2019-04-06 22:00,60,8,52,0,0,0
2019-04-06 22:15,63,12,51,0,0,0
2019-04-06 22:30,51,23,28,0,0,0
2019-04-06 22:45,48,18,30,0,0,0
2019-04-06 23:00,51,16,35,0,0,0
2019-04-06 23:15,67,22,45,0,0,0
2019-04-06 23:30,59,16,43,0,0,0
2019-04-06 23:45,51,11,40,0,0,0
2019-04-07 00:00,64,18,46,0,0,0
2019-04-07 00:15,33,11,22,0,0,0
2019-04-07 00:30,49,11,38,0,0,0
2019-04-07 00:45,47,21,26,0,0,0
2019-04-07 01:00,33,11,22,0,0,0
2019-04-07 01:15,33,13,20,0,0,0
2019-04-07 01:30,14,7,7,0,0,0
2019-04-07 01:45,21,13,8,0,0,0
2019-04-07 02:00,35,13,22,0,0,0
2019-04-07 02:15,18,7,11,0,0,0
2019-04-07 02:30,20,7,13,0,0,0
2019-04-07 02:45,22,6,16,0,0,0
2019-04-07 03:00,15,7,8,0,0,0
2019-04-07 03:15,14,11,3,0,0,0
2019-04-07 03:30,11,7,4,0,0,0
2019-04-07 03:45,14,4,10,0,0,0
2019-04-07 04:00,21,2,19,0,0,0
2019-04-07 04:15,11,5,6,0,0,0
2019-04-07 04:30,9,1,8,0,0,0
2019-04-07 04:45,6,3,3,0,0,0
2019-04-07 05:00,7,1,6,0,0,0
2019-04-07 05:15,7,2,5,0,0,0
2019-04-07 05:30,11,6,5,0,0,0
2019-04-07 05:45,4,3,1,0,0,0
2019-04-07 06:00,3,2,1,0,0,0
2019-04-07 06:15,4,2,2,0,0,0
2019-04-07 06:30,6,4,2,0,0,0
2019-04-07 06:45,5,1,4,0,0,0
2019-04-07 07:00,3,2,1,0,0,0
2019-04-07 07:15,3,1,2,0,0,0
2019-04-07 07:30,9,3,6,0,0,0
2019-04-07 07:45,7,5,2,0,0,0
2019-04-07 08:00,7,5,2,0,0,0
2019-04-07 08:15,7,4,3,0,0,0
2019-04-07 08:30,7,4,3,0,0,0
2019-04-07 08:45,19,15,4,0,0,0
2019-04-07 09:00,18,11,7,0,0,0
2019-04-07 09:15,30,16,14,0,0,0
2019-04-07 09:30,26,11,15,0,0,0
2019-04-07 09:45,65,39,26,0,0,0
2019-04-07 10:00,57,34,23,0,0,0
2019-04-07 10:15,46,29,17,0,0,0
2019-04-07 10:30,33,22,11,0,0,0
2019-04-07 10:45,54,36,18,0,0,0
2019-04-07 11:00,38,26,12,0,0,0
2019-04-07 11:15,50,31,19,0,0,0
2019-04-07 11:30,67,33,34,0,0,0
2019-04-07 11:45,71,41,30,0,0,0
2019-04-07 12:00,98,54,44,0,0,0
2019-04-07 12:15,79,41,38,0,0,0
2019-04-07 12:30,69,46,23,0,0,0
2019-04-07 12:45,88,45,43,0,0,0
2019-04-07 13:00,88,34,54,0,0,0
2019-04-07 13:15,67,34,33,0,0,0
2019-04-07 13:30,99,58,41,0,0,0
2019-04-07 13:45,98,63,35,0,0,0
2019-04-07 14:00,123,61,62,0,0,0
2019-04-07 14:15,102,60,42,0,0,0
2019-04-07 14:30,111,54,57,0,0,0
2019-04-07 14:45,132,70,62,0,0,0
2019-04-07 15:00,97,48,49,0,0,0
2019-04-07 15:15,150,78,72,0,0,0
2019-04-07 15:30,100,43,57,0,0,0
2019-04-07 15:45,114,53,61,0,0,0
2019-04-07 16:00,124,59,65,0,0,0
2019-04-07 16:15,121,55,66,0,0,0
2019-04-07 16:30,136,53,83,0,0,0
2019-04-07 16:45,123,61,62,0,0,0
2019-04-07 17:00,128,53,75,0,0,0
2019-04-07 17:15,127,54,73,0,0,0
2019-04-07 17:30,123,60,63,0,0,0
2019-04-07 17:45,139,57,82,0,0,0
2019-04-07 18:00,114,50,64,0,0,0
2019-04-07 18:15,98,28,70,0,0,0
2019-04-07 18:30,121,59,62,0,0,0
2019-04-07 18:45,106,43,63,0,0,0
2019-04-07 19:00,98,36,62,0,0,0
2019-04-07 19:15,86,29,57,0,0,0
2019-04-07 19:30,96,34,62,0,0,0
2019-04-07 19:45,73,26,47,0,0,0
2019-04-07 20:00,57,17,40,0,0,0
2019-04-07 20:15,61,14,47,0,0,0
2019-04-07 20:30,55,22,33,0,0,0
2019-04-07 20:45,63,21,42,0,0,0
2019-04-07 21:00,43,10,33,0,0,0
2019-04-07 21:15,31,10,21,0,0,0
2019-04-07 21:30,39,17,22,0,0,0
2019-04-07 21:45,20,6,14,0,0,0
2019-04-07 22:00,36,15,21,0,0,0
2019-04-07 22:15,68,44,24,0,0,0
2019-04-07 22:30,54,32,22,0,0,0
2019-04-07 22:45,28,12,16,0,0,0
2019-04-07 23:00,22,3,19,0,0,0
2019-04-07 23:15,19,4,15,0,0,0
2019-04-07 23:30,12,2,10,0,0,0
2019-04-07 23:45,8,1,7,0,0,0
2019-04-08 00:00,11,3,8,0,0,0
2019-04-08 00:15,4,0,4,0,0,0
2019-04-08 00:30,5,0,5,0,0,0
2019-04-08 00:45,2,0,2,0,0,0
2019-04-08 01:00,2,1,1,0,0,0
2019-04-08 01:15,4,2,2,0,0,0
2019-04-08 01:30,2,0,2,0,0,0
2019-04-08 01:45,0,0,0,0,0,0
2019-04-08 02:00,1,1,0,0,0,0
2019-04-08 02:15,2,2,0,0,0,0
2019-04-08 02:30,1,1,0,0,0,0
2019-04-08 02:45,4,4,0,0,0,0
2019-04-08 03:00,0,0,0,0,0,0
2019-04-08 03:15,0,0,0,0,0,0
2019-04-08 03:30,1,0,1,0,0,0
2019-04-08 03:45,1,1,0,0,0,0
2019-04-08 04:00,0,0,0,0,0,0
2019-04-08 04:15,4,1,3,0,0,0
2019-04-08 04:30,4,2,2,0,0,0
2019-04-08 04:45,2,2,0,0,0,0
2019-04-08 05:00,8,7,1,0,0,0
2019-04-08 05:15,10,7,3,0,0,0
2019-04-08 05:30,17,12,5,0,0,0
2019-04-08 05:45,27,16,11,0,0,0
2019-04-08 06:00,24,18,6,0,0,0
2019-04-08 06:15,38,30,8,0,0,0
2019-04-08 06:30,53,36,17,0,0,0
2019-04-08 06:45,65,45,20,0,0,0
2019-04-08 07:00,90,57,33,0,0,0
2019-04-08 07:15,104,72,32,0,0,0
2019-04-08 07:30,179,122,57,0,0,0
2019-04-08 07:45,213,162,51,0,0,0
2019-04-08 08:00,189,134,55,0,0,0
2019-04-08 08:15,158,108,50,0,0,0
2019-04-08 08:30,173,106,67,0,0,0
2019-04-08 08:45,150,109,41,0,0,0
2019-04-08 09:00,112,76,36,0,0,0
2019-04-08 09:15,115,73,42,0,0,0
2019-04-08 09:30,122,88,34,0,0,0
2019-04-08 09:45,176,119,57,0,0,0
2019-04-08 10:00,135,83,52,0,0,0
2019-04-08 10:15,114,68,46,0,0,0
2019-04-08 10:30,118,64,54,0,0,0
2019-04-08 10:45,131,73,58,0,0,0
2019-04-08 11:00,108,57,51,0,0,0
2019-04-08 11:15,154,81,73,0,0,0
2019-04-08 11:30,139,82,57,0,0,0
2019-04-08 11:45,161,75,86,0,0,0
2019-04-08 12:00,163,77,86,0,0,0
2019-04-08 12:15,143,51,92,0,0,0
2019-04-08 12:30,182,64,118,0,0,0
2019-04-08 12:45,169,86,83,0,0,0
2019-04-08 13:00,168,61,107,0,0,0
2019-04-08 13:15,183,62,121,0,0,0
2019-04-08 13:30,142,64,78,0,0,0
2019-04-08 13:45,172,89,83,0,0,0
2019-04-08 14:00,188,90,98,0,0,0
2019-04-08 14:15,159,58,101,0,0,0
2019-04-08 14:30,195,98,97,0,0,0
2019-04-08 14:45,184,98,86,0,0,0
2019-04-08 15:00,188,75,113,0,0,0
2019-04-08 15:15,180,77,103,0,0,0
2019-04-08 15:30,202,89,113,0,0,0
2019-04-08 15:45,229,95,134,0,0,0
2019-04-08 16:00,258,105,153,0,0,0
2019-04-08 16:15,217,97,120,0,0,0
2019-04-08 16:30,220,88,132,0,0,0
2019-04-08 16:45,237,88,149,0,0,0
2019-04-08 17:00,243,102,141,0,0,0
2019-04-08 17:15,232,85,147,0,0,0
2019-04-08 17:30,261,98,163,0,0,0
2019-04-08 17:45,267,102,165,0,0,0
2019-04-08 18:00,228,77,151,0,0,0
2019-04-08 18:15,232,77,155,0,0,0
2019-04-08 18:30,203,69,134,0,0,0
2019-04-08 18:45,159,65,94,0,0,0
2019-04-08 19:00,165,56,109,0,0,0
2019-04-08 19:15,158,42,116,0,0,0
2019-04-08 19:30,147,46,101,0,0,0
2019-04-08 19:45,141,46,95,0,0,0
2019-04-08 20:00,115,37,78,0,0,0
2019-04-08 20:15,88,34,54,0,0,0
2019-04-08 20:30,72,18,54,0,0,0
2019-04-08 20:45,68,25,43,0,0,0
2019-04-08 21:00,69,18,51,0,0,0
2019-04-08 21:15,65,19,46,0,0,0
2019-04-08 21:30,65,20,45,0,0,0
2019-04-08 21:45,68,24,44,0,0,0
2019-04-08 22:00,54,11,43,0,0,0
2019-04-08 22:15,51,13,38,0,0,0
2019-04-08 22:30,46,15,31,0,0,0
2019-04-08 22:45,41,14,27,0,0,0
2019-04-08 23:00,33,11,22,0,0,0
2019-04-08 23:15,19,8,11,0,0,0
2019-04-08 23:30,12,4,8,0,0,0
2019-04-08 23:45,17,1,16,0,0,0
2019-04-09 00:00,18,1,17,0,0,0
2019-04-09 00:15,12,4,8,0,0,0
2019-04-09 00:30,7,2,5,0,0,0
2019-04-09 00:45,22,7,15,0,0,0
2019-04-09 01:00,5,3,2,0,0,0
2019-04-09 01:15,3,1,2,0,0,0
2019-04-09 01:30,4,0,4,0,0,0
2019-04-09 01:45,15,5,10,0,0,0
2019-04-09 02:00,1,0,1,0,0,0
2019-04-09 02:15,0,0,0,0,0,0
2019-04-09 02:30,8,0,8,0,0,0
2019-04-09 02:45,5,3,2,0,0,0
2019-04-09 03:00,2,0,2,0,0,0
2019-04-09 03:15,1,0,1,0,0,0
2019-04-09 03:30,1,1,0,0,0,0
2019-04-09 03:45,1,1,0,0,0,0
2019-04-09 04:00,0,0,0,0,0,0
2019-04-09 04:15,2,1,1,0,0,0
2019-04-09 04:30,1,1,0,0,0,0
2019-04-09 04:45,5,5,0,0,0,0
2019-04-09 05:00,3,3,0,0,0,0
2019-04-09 05:15,12,4,8,0,0,0
2019-04-09 05:30,14,10,4,0,0,0
2019-04-09 05:45,20,18,2,0,0,0
2019-04-09 06:00,29,17,12,0,0,0
2019-04-09 06:15,29,26,3,0,0,0
2019-04-09 06:30,56,43,13,0,0,0
2019-04-09 06:45,66,49,17,0,0,0
2019-04-09 07:00,103,65,38,0,0,0
2019-04-09 07:15,127,84,43,0,0,0
2019-04-09 07:30,172,108,64,0,0,0
2019-04-09 07:45,216,159,57,0,0,0
2019-04-09 08:00,183,142,41,0,0,0
2019-04-09 08:15,167,122,45,0,0,0
2019-04-09 08:30,128,85,43,0,0,0
2019-04-09 08:45,163,115,48,0,0,0
2019-04-09 09:00,91,56,35,0,0,0
2019-04-09 09:15,111,76,35,0,0,0
2019-04-09 09:30,121,74,47,0,0,0
2019-04-09 09:45,163,118,45,0,0,0
2019-04-09 10:00,138,99,39,0,0,0
2019-04-09 10:15,115,60,55,0,0,0
2019-04-09 10:30,110,64,46,0,0,0
2019-04-09 10:45,116,63,53,0,0,0
2019-04-09 11:00,102,50,52,0,0,0
2019-04-09 11:15,123,58,65,0,0,0
2019-04-09 11:30,132,61,71,0,0,0
2019-04-09 11:45,158,71,87,0,0,0
2019-04-09 12:00,129,54,75,0,0,0
2019-04-09 12:15,129,59,70,0,0,0
2019-04-09 12:30,145,52,93,0,0,0
2019-04-09 12:45,137,54,83,0,0,0
2019-04-09 13:00,178,79,99,0,0,0
2019-04-09 13:15,177,66,111,0,0,0
2019-04-09 13:30,156,65,91,0,0,0
2019-04-09 13:45,210,100,110,0,0,0
2019-04-09 14:00,186,76,110,0,0,0
2019-04-09 14:15,161,58,103,0,0,0
2019-04-09 14:30,153,76,77,0,0,0
2019-04-09 14:45,184,86,98,0,0,0
2019-04-09 15:00,197,78,119,0,0,0
2019-04-09 15:15,161,74,87,0,0,0
2019-04-09 15:30,196,92,104,0,0,0
2019-04-09 15:45,237,103,134,0,0,0
2019-04-09 16:00,231,92,139,0,0,0
2019-04-09 16:15,200,69,131,0,0,0
2019-04-09 16:30,213,89,124,0,0,0
2019-04-09 16:45,213,70,143,0,0,0
2019-04-09 17:00,246,91,155,0,0,0
2019-04-09 17:15,235,78,157,0,0,0
2019-04-09 17:30,223,77,146,0,0,0
2019-04-09 17:45,270,102,168,0,0,0
2019-04-09 18:00,271,76,195,0,0,0
2019-04-09 18:15,220,77,143,0,0,0
2019-04-09 18:30,165,62,103,0,0,0
2019-04-09 18:45,202,76,126,0,0,0
2019-04-09 19:00,189,72,117,0,0,0
2019-04-09 19:15,191,66,125,0,0,0
2019-04-09 19:30,155,54,101,0,0,0
2019-04-09 19:45,148,47,101,0,0,0
2019-04-09 20:00,131,36,95,0,0,0
2019-04-09 20:15,106,34,72,0,0,0
2019-04-09 20:30,107,34,73,0,0,0
2019-04-09 20:45,76,30,46,0,0,0
2019-04-09 21:00,55,17,38,0,0,0
2019-04-09 21:15,76,28,48,0,0,0
2019-04-09 21:30,63,15,48,0,0,0
2019-04-09 21:45,66,13,53,0,0,0
2019-04-09 22:00,71,20,51,0,0,0
2019-04-09 22:15,64,14,50,0,0,0
2019-04-09 22:30,70,13,57,0,0,0
2019-04-09 22:45,47,12,35,0,0,0
2019-04-09 23:00,39,13,26,0,0,0
2019-04-09 23:15,41,13,28,0,0,0
2019-04-09 23:30,23,7,16,0,0,0
2019-04-09 23:45,21,9,12,0,0,0
2019-04-10 00:00,8,5,3,0,0,0
2019-04-10 00:15,21,7,14,0,0,0
2019-04-10 00:30,20,8,12,0,0,0
2019-04-10 00:45,16,6,10,0,0,0
2019-04-10 01:00,8,1,7,0,0,0
2019-04-10 01:15,6,1,5,0,0,0
2019-04-10 01:30,2,2,0,0,0,0
2019-04-10 01:45,3,1,2,0,0,0
2019-04-10 02:00,4,1,3,0,0,0
2019-04-10 02:15,3,2,1,0,0,0
2019-04-10 02:30,2,0,2,0,0,0
2019-04-10 02:45,7,1,6,0,0,0
2019-04-10 03:00,5,1,4,0,0,0
2019-04-10 03:15,0,0,0,0,0,0
2019-04-10 03:30,2,0,2,0,0,0
2019-04-10 03:45,3,1,2,0,0,0
2019-04-10 04:00,2,0,2,0,0,0
2019-04-10 04:15,6,3,3,0,0,0
2019-04-10 04:30,4,0,4,0,0,0
2019-04-10 04:45,3,3,0,0,0,0
2019-04-10 05:00,3,2,1,0,0,0
2019-04-10 05:15,9,7,2,0,0,0
2019-04-10 05:30,18,14,4,0,0,0
2019-04-10 05:45,26,22,4,0,0,0
2019-04-10 06:00,24,14,10,0,0,0
2019-04-10 06:15,37,33,4,0,0,0
2019-04-10 06:30,56,36,20,0,0,0
2019-04-10 06:45,72,57,15,0,0,0
2019-04-10 07:00,67,47,20,0,0,0
2019-04-10 07:15,112,76,36,0,0,0
2019-04-10 07:30,172,120,52,0,0,0
2019-04-10 07:45,217,157,60,0,0,0
2019-04-10 08:00,158,114,44,0,0,0
2019-04-10 08:15,193,131,62,0,0,0
2019-04-10 08:30,146,99,47,0,0,0
2019-04-10 08:45,157,115,42,0,0,0
2019-04-10 09:00,99,73,26,0,0,0
2019-04-10 09:15,132,81,51,0,0,0
2019-04-10 09:30,172,126,46,0,0,0
2019-04-10 09:45,181,136,45,0,0,0
2019-04-10 10:00,134,91,43,0,0,0
2019-04-10 10:15,105,61,44,0,0,0
2019-04-10 10:30,107,58,49,0,0,0
2019-04-10 10:45,127,73,54,0,0,0
2019-04-10 11:00,111,53,58,0,0,0
2019-04-10 11:15,139,76,63,0,0,0
2019-04-10 11:30,149,81,68,0,0,0
2019-04-10 11:45,153,87,66,0,0,0
2019-04-10 12:00,177,83,94,0,0,0
2019-04-10 12:15,165,66,99,0,0,0
2019-04-10 12:30,167,67,100,0,0,0
2019-04-10 12:45,175,70,105,0,0,0
2019-04-10 13:00,181,57,124,0,0,0
2019-04-10 13:15,185,70,115,0,0,0
2019-04-10 13:30,162,61,101,0,0,0
2019-04-10 13:45,202,90,112,0,0,0
2019-04-10 14:00,195,71,124,0,0,0
2019-04-10 14:15,186,67,119,0,0,0
2019-04-10 14:30,158,51,107,0,0,0
2019-04-10 14:45,205,89,116,0,0,0
2019-04-10 15:00,166,53,113,0,0,0
2019-04-10 15:15,146,53,93,0,0,0
2019-04-10 15:30,156,48,108,0,0,0
2019-04-10 15:45,200,87,113,0,0,0
2019-04-10 16:00,201,84,117,0,0,0
2019-04-10 16:15,208,73,135,0,0,0
2019-04-10 16:30,210,78,132,0,0,0
2019-04-10 16:45,232,92,140,0,0,0
2019-04-10 17:00,237,99,138,0,0,0
2019-04-10 17:15,181,62,119,0,0,0
2019-04-10 17:30,196,64,132,0,0,0
2019-04-10 17:45,269,114,155,0,0,0
2019-04-10 18:00,258,125,133,0,0,0
2019-04-10 18:15,207,66,141,0,0,0
2019-04-10 18:30,184,69,115,0,0,0
2019-04-10 18:45,180,64,116,0,0,0
2019-04-10 19:00,160,47,113,0,0,0
2019-04-10 19:15,178,80,98,0,0,0
2019-04-10 19:30,132,47,85,0,0,0
2019-04-10 19:45,123,44,79,0,0,0
2019-04-10 20:00,140,31,109,0,0,0
2019-04-10 20:15,97,34,63,0,0,0
2019-04-10 20:30,72,30,42,0,0,0
2019-04-10 20:45,78,29,49,0,0,0
2019-04-10 21:00,66,32,34,0,0,0
2019-04-10 21:15,58,27,31,0,0,0
2019-04-10 21:30,57,12,45,0,0,0
2019-04-10 21:45,78,24,54,0,0,0
2019-04-10 22:00,74,15,59,0,0,0
2019-04-10 22:15,48,15,33,0,0,0
2019-04-10 22:30,62,13,49,0,0,0
2019-04-10 22:45,58,16,42,0,0,0
2019-04-10 23:00,52,14,38,0,0,0
2019-04-10 23:15,42,21,21,0,0,0
2019-04-10 23:30,26,13,13,0,0,0
2019-04-10 23:45,29,7,22,0,0,0
2019-04-11 00:00,23,10,13,0,0,0
2019-04-11 00:15,9,3,6,0,0,0
2019-04-11 00:30,8,3,5,0,0,0
2019-04-11 00:45,9,3,6,0,0,0
2019-04-11 01:00,19,11,8,0,0,0
2019-04-11 01:15,4,0,4,0,0,0
2019-04-11 01:30,7,2,5,0,0,0
2019-04-11 01:45,4,1,3,0,0,0
2019-04-11 02:00,6,3,3,0,0,0
2019-04-11 02:15,5,0,5,0,0,0
2019-04-11 02:30,5,0,5,0,0,0
2019-04-11 02:45,6,2,4,0,0,0
2019-04-11 03:00,3,1,2,0,0,0
2019-04-11 03:15,2,0,2,0,0,0
2019-04-11 03:30,4,2,2,0,0,0
2019-04-11 03:45,3,1,2,0,0,0
2019-04-11 04:00,1,0,1,0,0,0
2019-04-11 04:15,2,0,2,0,0,0
2019-04-11 04:30,1,0,1,0,0,0
2019-04-11 04:45,3,3,0,0,0,0
2019-04-11 05:00,5,2,3,0,0,0
2019-04-11 05:15,8,6,2,0,0,0
2019-04-11 05:30,14,10,4,0,0,0
2019-04-11 05:45,25,21,4,0,0,0
2019-04-11 06:00,24,16,8,0,0,0
2019-04-11 06:15,28,22,6,0,0,0
2019-04-11 06:30,41,29,12,0,0,0
2019-04-11 06:45,65,47,18,0,0,0
2019-04-11 07:00,71,45,26,0,0,0
2019-04-11 07:15,114,68,46,0,0,0
2019-04-11 07:30,165,111,54,0,0,0
2019-04-11 07:45,196,143,53,0,0,0
2019-04-11 08:00,174,129,45,0,0,0
2019-04-11 08:15,177,122,55,0,0,0
2019-04-11 08:30,123,93,30,0,0,0
2019-04-11 08:45,165,123,42,0,0,0
2019-04-11 09:00,99,65,34,0,0,0
2019-04-11 09:15,118,78,40,0,0,0
2019-04-11 09:30,123,86,37,0,0,0
2019-04-11 09:45,157,116,41,0,0,0
2019-04-11 10:00,135,99,36,0,0,0
2019-04-11 10:15,108,67,41,0,0,0
2019-04-11 10:30,100,57,43,0,0,0
2019-04-11 10:45,107,57,50,0,0,0
2019-04-11 11:00,116,65,51,0,0,0
2019-04-11 11:15,130,67,63,0,0,0
2019-04-11 11:30,119,67,52,0,0,0
2019-04-11 11:45,163,82,81,0,0,0
2019-04-11 12:00,167,84,83,0,0,0
2019-04-11 12:15,147,70,77,0,0,0
2019-04-11 12:30,143,36,107,0,0,0
2019-04-11 12:45,153,64,89,0,0,0
2019-04-11 13:00,164,71,93,0,0,0
2019-04-11 13:15,149,63,86,0,0,0
2019-04-11 13:30,137,57,80,0,0,0
2019-04-11 13:45,189,87,102,0,0,0
2019-04-11 14:00,191,78,113,0,0,0
2019-04-11 14:15,147,52,95,0,0,0
2019-04-11 14:30,156,72,84,0,0,0
2019-04-11 14:45,163,71,92,0,0,0
2019-04-11 15:00,176,87,89,0,0,0
2019-04-11 15:15,183,93,90,0,0,0
2019-04-11 15:30,159,66,93,0,0,0
2019-04-11 15:45,193,76,117,0,0,0
2019-04-11 16:00,186,80,106,0,0,0
2019-04-11 16:15,220,71,149,0,0,0
2019-04-11 16:30,185,78,107,0,0,0
2019-04-11 16:45,211,80,131,0,0,0
2019-04-11 17:00,197,81,116,0,0,0
2019-04-11 17:15,225,83,142,0,0,0
2019-04-11 17:30,230,99,131,0,0,0
2019-04-11 17:45,212,105,107,0,0,0
2019-04-11 18:00,217,67,150,0,0,0
2019-04-11 18:15,224,71,153,0,0,0
2019-04-11 18:30,157,51,106,0,0,0
2019-04-11 18:45,165,65,100,0,0,0
2019-04-11 19:00,153,60,93,0,0,0
2019-04-11 19:15,149,52,97,0,0,0
2019-04-11 19:30,129,49,80,0,0,0
2019-04-11 19:45,155,51,104,0,0,0
2019-04-11 20:00,113,28,85,0,0,0
2019-04-11 20:15,78,25,53,0,0,0
2019-04-11 20:30,69,31,38,0,0,0
2019-04-11 20:45,56,20,36,0,0,0
2019-04-11 21:00,75,38,37,0,0,0
2019-04-11 21:15,66,19,47,0,0,0
2019-04-11 21:30,79,39,40,0,0,0
2019-04-11 21:45,57,21,36,0,0,0
2019-04-11 22:00,74,19,55,0,0,0
2019-04-11 22:15,62,23,39,0,0,0
2019-04-11 22:30,46,20,26,0,0,0
2019-04-11 22:45,50,12,38,0,0,0
2019-04-11 23:00,41,18,23,0,0,0
2019-04-11 23:15,27,8,19,0,0,0
2019-04-11 23:30,27,7,20,0,0,0
2019-04-11 23:45,20,7,13,0,0,0
2019-04-12 00:00,28,12,16,0,0,0
2019-04-12 00:15,24,6,18,0,0,0
2019-04-12 00:30,22,6,16,0,0,0
2019-04-12 00:45,22,4,18,0,0,0
2019-04-12 01:00,10,3,7,0,0,0
2019-04-12 01:15,11,2,9,0,0,0
2019-04-12 01:30,7,2,5,0,0,0
2019-04-12 01:45,6,1,5,0,0,0
2019-04-12 02:00,2,0,2,0,0,0
2019-04-12 02:15,8,2,6,0,0,0
2019-04-12 02:30,0,0,0,0,0,0
2019-04-12 02:45,8,2,6,0,0,0
2019-04-12 03:00,7,0,7,0,0,0
2019-04-12 03:15,2,2,0,0,0,0
2019-04-12 03:30,0,0,0,0,0,0
2019-04-12 03:45,2,0,2,0,0,0
2019-04-12 04:00,3,1,2,0,0,0
2019-04-12 04:15,1,0,1,0,0,0
2019-04-12 04:30,3,3,0,0,0,0
2019-04-12 04:45,8,5,3,0,0,0
2019-04-12 05:00,3,2,1,0,0,0
2019-04-12 05:15,9,5,4,0,0,0
2019-04-12 05:30,14,11,3,0,0,0
2019-04-12 05:45,24,21,3,0,0,0
2019-04-12 06:00,20,14,6,0,0,0
2019-04-12 06:15,21,18,3,0,0,0
2019-04-12 06:30,44,31,13,0,0,0
2019-04-12 06:45,80,60,20,0,0,0
2019-04-12 07:00,69,48,21,0,0,0
2019-04-12 07:15,113,64,49,0,0,0
2019-04-12 07:30,155,107,48,0,0,0
2019-04-12 07:45,186,142,44,0,0,0
2019-04-12 08:00,112,82,30,0,0,0
2019-04-12 08:15,145,104,41,0,0,0
2019-04-12 08:30,113,77,36,0,0,0
2019-04-12 08:45,136,102,34,0,0,0
2019-04-12 09:00,103,69,34,0,0,0
2019-04-12 09:15,97,65,32,0,0,0
2019-04-12 09:30,104,73,31,0,0,0
2019-04-12 09:45,150,107,43,0,0,0
2019-04-12 10:00,124,79,45,0,0,0
2019-04-12 10:15,95,52,43,0,0,0
2019-04-12 10:30,91,56,35,0,0,0
2019-04-12 10:45,105,67,38,0,0,0
2019-04-12 11:00,116,67,49,0,0,0
2019-04-12 11:15,92,48,44,0,0,0
2019-04-12 11:30,115,65,50,0,0,0
2019-04-12 11:45,141,64,77,0,0,0
2019-04-12 12:00,131,56,75,0,0,0
2019-04-12 12:15,157,79,78,0,0,0
2019-04-12 12:30,129,46,83,0,0,0
2019-04-12 12:45,169,66,103,0,0,0
2019-04-12 13:00,179,63,116,0,0,0
2019-04-12 13:15,158,64,94,0,0,0
2019-04-12 13:30,153,57,96,0,0,0
2019-04-12 13:45,167,68,99,0,0,0
2019-04-12 14:00,172,67,105,0,0,0
2019-04-12 14:15,147,59,88,0,0,0
2019-04-12 14:30,165,49,116,0,0,0
2019-04-12 14:45,169,65,104,0,0,0
2019-04-12 15:00,152,62,90,0,0,0
2019-04-12 15:15,150,63,87,0,0,0
2019-04-12 15:30,149,64,85,0,0,0
2019-04-12 15:45,146,62,84,0,0,0
2019-04-12 16:00,172,73,99,0,0,0
2019-04-12 16:15,137,59,78,0,0,0
2019-04-12 16:30,156,59,97,0,0,0
2019-04-12 16:45,155,66,89,0,0,0
2019-04-12 17:00,134,52,82,0,0,0
2019-04-12 17:15,155,65,90,0,0,0
2019-04-12 17:30,139,53,86,0,0,0
2019-04-12 17:45,176,82,94,0,0,0
2019-04-12 18:00,148,50,98,0,0,0
2019-04-12 18:15,138,56,82,0,0,0
2019-04-12 18:30,113,44,69,0,0,0
2019-04-12 18:45,149,66,83,0,0,0
2019-04-12 19:00,140,73,67,0,0,0
2019-04-12 19:15,130,61,69,0,0,0
2019-04-12 19:30,119,47,72,0,0,0
2019-04-12 19:45,131,55,76,0,0,0
2019-04-12 20:00,95,44,51,0,0,0
2019-04-12 20:15,93,37,56,0,0,0
2019-04-12 20:30,65,24,41,0,0,0
2019-04-12 20:45,76,35,41,0,0,0
2019-04-12 21:00,71,36,35,0,0,0
2019-04-12 21:15,53,21,32,0,0,0
2019-04-12 21:30,72,31,41,0,0,0
2019-04-12 21:45,62,19,43,0,0,0
2019-04-12 22:00,52,15,37,0,0,0
2019-04-12 22:15,63,22,41,0,0,0
2019-04-12 22:30,47,14,33,0,0,0
2019-04-12 22:45,54,19,35,0,0,0
2019-04-12 23:00,42,11,31,0,0,0
2019-04-12 23:15,42,18,24,0,0,0
2019-04-12 23:30,38,8,30,0,0,0
2019-04-12 23:45,53,17,36,0,0,0
2019-04-13 00:00,37,17,20,0,0,0
2019-04-13 00:15,53,14,39,0,0,0
2019-04-13 00:30,37,22,15,0,0,0
2019-04-13 00:45,37,10,27,0,0,0
2019-04-13 01:00,41,14,27,0,0,0
2019-04-13 01:15,45,17,28,0,0,0
2019-04-13 01:30,24,7,17,0,0,0
2019-04-13 01:45,18,2,16,0,0,0
2019-04-13 02:00,13,7,6,0,0,0
2019-04-13 02:15,13,7,6,0,0,0
2019-04-13 02:30,8,3,5,0,0,0
2019-04-13 02:45,13,5,8,0,0,0
2019-04-13 03:00,22,10,12,0,0,0
2019-04-13 03:15,7,0,7,0,0,0
2019-04-13 03:30,17,6,11,0,0,0
2019-04-13 03:45,9,3,6,0,0,0
2019-04-13 04:00,17,2,15,0,0,0
2019-04-13 04:15,4,1,3,0,0,0
2019-04-13 04:30,4,1,3,0,0,0
2019-04-13 04:45,3,0,3,0,0,0
2019-04-13 05:00,2,1,1,0,0,0
2019-04-13 05:15,9,5,4,0,0,0
2019-04-13 05:30,6,5,1,0,0,0
2019-04-13 05:45,11,9,2,0,0,0
2019-04-13 06:00,2,1,1,0,0,0
2019-04-13 06:15,9,4,5,0,0,0
2019-04-13 06:30,19,7,12,0,0,0
2019-04-13 06:45,7,3,4,0,0,0
2019-04-13 07:00,12,10,2,0,0,0
2019-04-13 07:15,9,6,3,0,0,0
2019-04-13 07:30,21,8,13,0,0,0
2019-04-13 07:45,35,25,10,0,0,0
2019-04-13 08:00,23,14,9,0,0,0
2019-04-13 08:15,30,26,4,0,0,0
2019-04-13 08:30,38,22,16,0,0,0
2019-04-13 08:45,56,40,16,0,0,0
2019-04-13 09:00,44,29,15,0,0,0
2019-04-13 09:15,76,47,29,0,0,0
2019-04-13 09:30,69,45,24,0,0,0
2019-04-13 09:45,112,96,16,0,0,0
2019-04-13 10:00,106,75,31,0,0,0
2019-04-13 10:15,103,75,28,0,0,0
2019-04-13 10:30,112,71,41,0,0,0
2019-04-13 10:45,157,104,53,0,0,0
2019-04-13 11:00,115,68,47,0,0,0
2019-04-13 11:15,113,69,44,0,0,0
2019-04-13 11:30,123,62,61,0,0,0
2019-04-13 11:45,173,102,71,0,0,0
2019-04-13 12:00,162,94,68,0,0,0
2019-04-13 12:15,130,71,59,0,0,0
2019-04-13 12:30,147,59,88,0,0,0
2019-04-13 12:45,183,95,88,0,0,0
2019-04-13 13:00,142,64,78,0,0,0
2019-04-13 13:15,130,65,65,0,0,0
2019-04-13 13:30,149,72,77,0,0,0
2019-04-13 13:45,146,68,78,0,0,0
2019-04-13 14:00,129,68,61,0,0,0
2019-04-13 14:15,119,57,62,0,0,0
2019-04-13 14:30,134,53,81,0,0,0
2019-04-13 14:45,141,66,75,0,0,0
2019-04-13 15:00,151,51,100,0,0,0
2019-04-13 15:15,91,34,57,0,0,0
2019-04-13 15:30,128,38,90,0,0,0
2019-04-13 15:45,120,48,72,0,0,0
2019-04-13 16:00,85,30,55,0,0,0
2019-04-13 16:15,86,23,63,0,0,0
2019-04-13 16:30,105,42,63,0,0,0
2019-04-13 16:45,85,39,46,0,0,0
2019-04-13 17:00,114,33,81,0,0,0
2019-04-13 17:15,102,36,66,0,0,0
2019-04-13 17:30,114,34,80,0,0,0
2019-04-13 17:45,105,39,66,0,0,0
2019-04-13 18:00,129,47,82,0,0,0
2019-04-13 18:15,117,31,86,0,0,0
2019-04-13 18:30,91,38,53,0,0,0
2019-04-13 18:45,70,27,43,0,0,0
2019-04-13 19:00,86,26,60,0,0,0
2019-04-13 19:15,96,41,55,0,0,0
2019-04-13 19:30,75,25,50,0,0,0
2019-04-13 19:45,72,30,42,0,0,0
2019-04-13 20:00,74,27,47,0,0,0
2019-04-13 20:15,61,25,36,0,0,0
2019-04-13 20:30,60,29,31,0,0,0
2019-04-13 20:45,39,23,16,0,0,0
2019-04-13 21:00,40,23,17,0,0,0
2019-04-13 21:15,32,16,16,0,0,0
2019-04-13 21:30,114,85,29,0,0,0
2019-04-13 21:45,93,76,17,0,0,0
2019-04-13 22:00,49,26,23,0,0,0
2019-04-13 22:15,37,12,25,0,0,0
2019-04-13 22:30,27,11,16,0,0,0
2019-04-13 22:45,32,13,19,0,0,0
2019-04-13 23:00,35,10,25,0,0,0
2019-04-13 23:15,45,18,27,0,0,0
2019-04-13 23:30,20,7,13,0,0,0
2019-04-13 23:45,39,14,25,0,0,0
2019-04-14 00:00,29,11,18,0,0,0
2019-04-14 00:15,27,14,13,0,0,0
2019-04-14 00:30,30,7,23,0,0,0
2019-04-14 00:45,25,8,17,0,0,0
2019-04-14 01:00,38,18,20,0,0,0
2019-04-14 01:15,30,15,15,0,0,0
2019-04-14 01:30,22,5,17,0,0,0
2019-04-14 01:45,22,7,15,0,0,0
2019-04-14 02:00,21,4,17,0,0,0
2019-04-14 02:15,17,4,13,0,0,0
2019-04-14 02:30,7,2,5,0,0,0
2019-04-14 02:45,8,1,7,0,0,0
2019-04-14 03:00,6,1,5,0,0,0
2019-04-14 03:15,14,6,8,0,0,0
2019-04-14 03:30,8,2,6,0,0,0
2019-04-14 03:45,6,0,6,0,0,0
2019-04-14 04:00,6,1,5,0,0,0
2019-04-14 04:15,13,1,12,0,0,0
2019-04-14 04:30,7,0,7,0,0,0
2019-04-14 04:45,2,0,2,0,0,0
2019-04-14 05:00,3,1,2,0,0,0
2019-04-14 05:15,5,2,3,0,0,0
2019-04-14 05:30,10,3,7,0,0,0
2019-04-14 05:45,3,3,0,0,0,0
2019-04-14 06:00,1,0,1,0,0,0
2019-04-14 06:15,1,0,1,0,0,0
2019-04-14 06:30,5,1,4,0,0,0
2019-04-14 06:45,5,3,2,0,0,0
2019-04-14 07:00,7,3,4,0,0,0
2019-04-14 07:15,1,1,0,0,0,0
2019-04-14 07:30,6,3,3,0,0,0
2019-04-14 07:45,6,5,1,0,0,0
2019-04-14 08:00,7,4,3,0,0,0
2019-04-14 08:15,6,4,2,0,0,0
2019-04-14 08:30,15,9,6,0,0,0
2019-04-14 08:45,16,9,7,0,0,0
2019-04-14 09:00,15,10,5,0,0,0
2019-04-14 09:15,26,10,16,0,0,0
2019-04-14 09:30,27,18,9,0,0,0
2019-04-14 09:45,42,21,21,0,0,0
2019-04-14 10:00,24,19,5,0,0,0
2019-04-14 10:15,46,28,18,0,0,0
2019-04-14 10:30,42,28,14,0,0,0
2019-04-14 10:45,31,20,11,0,0,0
2019-04-14 11:00,29,10,19,0,0,0
2019-04-14 11:15,52,25,27,0,0,0
2019-04-14 11:30,49,25,24,0,0,0
2019-04-14 11:45,50,35,15,0,0,0
2019-04-14 12:00,37,27,10,0,0,0
2019-04-14 12:15,42,20,22,0,0,0
2019-04-14 12:30,57,23,34,0,0,0
2019-04-14 12:45,57,33,24,0,0,0
2019-04-14 13:00,61,26,35,0,0,0
2019-04-14 13:15,60,20,40,0,0,0
2019-04-14 13:30,69,34,35,0,0,0
2019-04-14 13:45,71,32,39,0,0,0
2019-04-14 14:00,69,35,34,0,0,0
2019-04-14 14:15,75,35,40,0,0,0
2019-04-14 14:30,63,26,37,0,0,0
2019-04-14 14:45,93,48,45,0,0,0
2019-04-14 15:00,72,38,34,0,0,0
2019-04-14 15:15,61,26,35,0,0,0
2019-04-14 15:30,75,32,43,0,0,0
2019-04-14 15:45,60,28,32,0,0,0
2019-04-14 16:00,66,19,47,0,0,0
2019-04-14 16:15,67,31,36,0,0,0
2019-04-14 16:30,84,33,51,0,0,0
2019-04-14 16:45,75,31,44,0,0,0
2019-04-14 17:00,51,21,30,0,0,0
2019-04-14 17:15,53,17,36,0,0,0
2019-04-14 17:30,60,27,33,0,0,0
2019-04-14 17:45,97,39,58,0,0,0
2019-04-14 18:00,77,23,54,0,0,0
2019-04-14 18:15,64,25,39,0,0,0
2019-04-14 18:30,59,28,31,0,0,0
2019-04-14 18:45,58,35,23,0,0,0
2019-04-14 19:00,71,23,48,0,0,0
2019-04-14 19:15,59,29,30,0,0,0
2019-04-14 19:30,51,21,30,0,0,0
2019-04-14 19:45,66,19,47,0,0,0
2019-04-14 20:00,39,17,22,0,0,0
2019-04-14 20:15,35,17,18,0,0,0
2019-04-14 20:30,34,18,16,0,0,0
2019-04-14 20:45,28,13,15,0,0,0
2019-04-14 21:00,48,21,27,0,0,0
2019-04-14 21:15,35,10,25,0,0,0
2019-04-14 21:30,31,14,17,0,0,0
2019-04-14 21:45,22,9,13,0,0,0
2019-04-14 22:00,29,12,17,0,0,0
2019-04-14 22:15,23,11,12,0,0,0
2019-04-14 22:30,24,7,17,0,0,0
2019-04-14 22:45,15,6,9,0,0,0
2019-04-14 23:00,14,5,9,0,0,0
2019-04-14 23:15,18,4,14,0,0,0
2019-04-14 23:30,7,3,4,0,0,0
2019-04-14 23:45,6,0,6,0,0,0
2019-04-15 00:00,6,1,5,0,0,0
2019-04-15 00:15,8,2,6,0,0,0
2019-04-15 00:30,2,2,0,0,0,0
2019-04-15 00:45,4,2,2,0,0,0
2019-04-15 01:00,5,3,2,0,0,0
2019-04-15 01:15,4,2,2,0,0,0
2019-04-15 01:30,0,0,0,0,0,0
2019-04-15 01:45,1,0,1,0,0,0
2019-04-15 02:00,3,2,1,0,0,0
2019-04-15 02:15,0,0,0,0,0,0
2019-04-15 02:30,0,0,0,0,0,0
2019-04-15 02:45,2,2,0,0,0,0
2019-04-15 03:00,0,0,0,0,0,0
2019-04-15 03:15,0,0,0,0,0,0
2019-04-15 03:30,0,0,0,0,0,0
2019-04-15 03:45,2,1,1,0,0,0
2019-04-15 04:00,0,0,0,0,0,0
2019-04-15 04:15,4,2,2,0,0,0
2019-04-15 04:30,1,1,0,0,0,0
2019-04-15 04:45,2,2,0,0,0,0
2019-04-15 05:00,2,2,0,0,0,0
2019-04-15 05:15,10,8,2,0,0,0
2019-04-15 05:30,11,9,2,0,0,0
2019-04-15 05:45,29,19,10,0,0,0
2019-04-15 06:00,30,24,6,0,0,0
2019-04-15 06:15,28,24,4,0,0,0
2019-04-15 06:30,48,34,14,0,0,0
2019-04-15 06:45,64,46,18,0,0,0
2019-04-15 07:00,62,35,27,0,0,0
2019-04-15 07:15,94,66,28,0,0,0
2019-04-15 07:30,105,76,29,0,0,0
2019-04-15 07:45,163,119,44,0,0,0
2019-04-15 08:00,114,85,29,0,0,0
2019-04-15 08:15,121,84,37,0,0,0
2019-04-15 08:30,123,76,47,0,0,0
2019-04-15 08:45,136,88,48,0,0,0
2019-04-15 09:00,117,90,27,0,0,0
2019-04-15 09:15,105,81,24,0,0,0
2019-04-15 09:30,94,75,19,0,0,0
2019-04-15 09:45,145,112,33,0,0,0
2019-04-15 10:00,132,93,39,0,0,0
2019-04-15 10:15,102,56,46,0,0,0
2019-04-15 10:30,116,66,50,0,0,0
2019-04-15 10:45,121,82,39,0,0,0
2019-04-15 11:00,106,58,48,0,0,0
2019-04-15 11:15,118,70,48,0,0,0
2019-04-15 11:30,147,78,69,0,0,0
2019-04-15 11:45,153,91,62,0,0,0
2019-04-15 12:00,162,77,85,0,0,0
2019-04-15 12:15,100,44,56,0,0,0
2019-04-15 12:30,111,50,61,0,0,0
2019-04-15 12:45,127,57,70,0,0,0
2019-04-15 13:00,140,51,89,0,0,0
2019-04-15 13:15,113,46,67,0,0,0
2019-04-15 13:30,164,69,95,0,0,0
2019-04-15 13:45,183,96,87,0,0,0
2019-04-15 14:00,165,73,92,0,0,0
2019-04-15 14:15,142,55,87,0,0,0
2019-04-15 14:30,164,63,101,0,0,0
2019-04-15 14:45,164,90,74,0,0,0
2019-04-15 15:00,178,82,96,0,0,0
2019-04-15 15:15,180,81,99,0,0,0
2019-04-15 15:30,182,92,90,0,0,0
2019-04-15 15:45,230,108,122,0,0,0
2019-04-15 16:00,209,78,131,0,0,0
2019-04-15 16:15,197,70,127,0,0,0
2019-04-15 16:30,227,74,153,0,0,0
2019-04-15 16:45,223,78,145,0,0,0
2019-04-15 17:00,195,79,116,0,0,0
2019-04-15 17:15,208,93,115,0,0,0
2019-04-15 17:30,208,73,135,0,0,0
2019-04-15 17:45,211,76,135,0,0,0
2019-04-15 18:00,265,84,181,0,0,0
2019-04-15 18:15,200,73,127,0,0,0
2019-04-15 18:30,176,68,108,0,0,0
2019-04-15 18:45,167,71,96,0,0,0
2019-04-15 19:00,152,44,108,0,0,0
2019-04-15 19:15,166,60,106,0,0,0
2019-04-15 19:30,150,46,104,0,0,0
2019-04-15 19:45,137,47,90,0,0,0
2019-04-15 20:00,112,34,78,0,0,0
2019-04-15 20:15,92,38,54,0,0,0
2019-04-15 20:30,70,25,45,0,0,0
2019-04-15 20:45,55,20,35,0,0,0
2019-04-15 21:00,38,14,24,0,0,0
2019-04-15 21:15,52,19,33,0,0,0
2019-04-15 21:30,62,19,43,0,0,0
2019-04-15 21:45,67,22,45,0,0,0
2019-04-15 22:00,49,21,28,0,0,0
2019-04-15 22:15,64,19,45,0,0,0
2019-04-15 22:30,52,17,35,0,0,0
2019-04-15 22:45,35,10,25,0,0,0
2019-04-15 23:00,29,7,22,0,0,0
2019-04-15 23:15,29,8,21,0,0,0
2019-04-15 23:30,24,5,19,0,0,0
2019-04-15 23:45,22,5,17,0,0,0
2019-04-16 00:00,11,5,6,0,0,0
2019-04-16 00:15,21,4,17,0,0,0
2019-04-16 00:30,12,2,10,0,0,0
2019-04-16 00:45,5,1,4,0,0,0
2019-04-16 01:00,6,0,6,0,0,0
2019-04-16 01:15,3,0,3,0,0,0
2019-04-16 01:30,5,2,3,0,0,0
2019-04-16 01:45,1,1,0,0,0,0
2019-04-16 02:00,0,0,0,0,0,0
2019-04-16 02:15,0,0,0,0,0,0
2019-04-16 02:30,1,0,1,0,0,0
2019-04-16 02:45,2,1,1,0,0,0
2019-04-16 03:00,3,1,2,0,0,0
2019-04-16 03:15,0,0,0,0,0,0
2019-04-16 03:30,1,0,1,0,0,0
2019-04-16 03:45,4,1,3,0,0,0
2019-04-16 04:00,0,0,0,0,0,0
2019-04-16 04:15,0,0,0,0,0,0
2019-04-16 04:30,3,2,1,0,0,0
2019-04-16 04:45,3,3,0,0,0,0
2019-04-16 05:00,3,2,1,0,0,0
2019-04-16 05:15,6,5,1,0,0,0
2019-04-16 05:30,9,7,2,0,0,0
2019-04-16 05:45,21,16,5,0,0,0
2019-04-16 06:00,35,26,9,0,0,0
2019-04-16 06:15,35,31,4,0,0,0
2019-04-16 06:30,43,29,14,0,0,0
2019-04-16 06:45,78,52,26,0,0,0
2019-04-16 07:00,82,55,27,0,0,0
2019-04-16 07:15,94,62,32,0,0,0
2019-04-16 07:30,113,78,35,0,0,0
2019-04-16 07:45,167,130,37,0,0,0
2019-04-16 08:00,174,136,38,0,0,0
2019-04-16 08:15,146,105,41,0,0,0
2019-04-16 08:30,116,79,37,0,0,0
2019-04-16 08:45,149,103,46,0,0,0
2019-04-16 09:00,97,72,25,0,0,0
2019-04-16 09:15,118,85,33,0,0,0
2019-04-16 09:30,103,78,25,0,0,0
2019-04-16 09:45,150,102,48,0,0,0
2019-04-16 10:00,142,92,50,0,0,0
2019-04-16 10:15,123,58,65,0,0,0
2019-04-16 10:30,101,61,40,0,0,0
2019-04-16 10:45,154,103,51,0,0,0
2019-04-16 11:00,106,55,51,0,0,0
2019-04-16 11:15,109,51,58,0,0,0
2019-04-16 11:30,122,60,62,0,0,0
2019-04-16 11:45,153,85,68,0,0,0
2019-04-16 12:00,154,76,78,0,0,0
2019-04-16 12:15,153,63,90,0,0,0
2019-04-16 12:30,154,70,84,0,0,0
2019-04-16 12:45,114,54,60,0,0,0
2019-04-16 13:00,155,75,80,0,0,0
2019-04-16 13:15,152,62,90,0,0,0
2019-04-16 13:30,151,69,82,0,0,0
2019-04-16 13:45,179,80,99,0,0,0
2019-04-16 14:00,151,77,74,0,0,0
2019-04-16 14:15,195,77,118,0,0,0
2019-04-16 14:30,167,87,80,0,0,0
2019-04-16 14:45,202,102,100,0,0,0
2019-04-16 15:00,173,81,92,0,0,0
2019-04-16 15:15,191,75,116,0,0,0
2019-04-16 15:30,186,87,99,0,0,0
2019-04-16 15:45,224,101,123,0,0,0
2019-04-16 16:00,203,73,130,0,0,0
2019-04-16 16:15,229,90,139,0,0,0
2019-04-16 16:30,221,79,142,0,0,0
2019-04-16 16:45,207,81,126,0,0,0
2019-04-16 17:00,233,100,133,0,0,0
2019-04-16 17:15,206,77,129,0,0,0
2019-04-16 17:30,241,87,154,0,0,0
2019-04-16 17:45,237,111,126,0,0,0
2019-04-16 18:00,231,76,155,0,0,0
2019-04-16 18:15,199,77,122,0,0,0
2019-04-16 18:30,184,68,116,0,0,0
2019-04-16 18:45,176,77,99,0,0,0
2019-04-16 19:00,199,83,116,0,0,0
2019-04-16 19:15,158,65,93,0,0,0
2019-04-16 19:30,141,56,85,0,0,0
2019-04-16 19:45,169,66,103,0,0,0
2019-04-16 20:00,107,32,75,0,0,0
2019-04-16 20:15,96,27,69,0,0,0
2019-04-16 20:30,86,28,58,0,0,0
2019-04-16 20:45,72,16,56,0,0,0
2019-04-16 21:00,55,19,36,0,0,0
2019-04-16 21:15,68,17,51,0,0,0
2019-04-16 21:30,51,8,43,0,0,0
2019-04-16 21:45,77,17,60,0,0,0
2019-04-16 22:00,71,17,54,0,0,0
2019-04-16 22:15,64,17,47,0,0,0
2019-04-16 22:30,53,20,33,0,0,0
2019-04-16 22:45,61,13,48,0,0,0
2019-04-16 23:00,46,13,33,0,0,0
2019-04-16 23:15,36,11,25,0,0,0
2019-04-16 23:30,33,7,26,0,0,0
2019-04-16 23:45,25,11,14,0,0,0
2019-04-17 00:00,23,5,18,0,0,0
2019-04-17 00:15,14,5,9,0,0,0
2019-04-17 00:30,7,1,6,0,0,0
2019-04-17 00:45,8,0,8,0,0,0
2019-04-17 01:00,5,1,4,0,0,0
2019-04-17 01:15,5,4,1,0,0,0
2019-04-17 01:30,12,8,4,0,0,0
2019-04-17 01:45,4,0,4,0,0,0
2019-04-17 02:00,1,1,0,0,0,0
2019-04-17 02:15,4,1,3,0,0,0
2019-04-17 02:30,1,0,1,0,0,0
2019-04-17 02:45,4,2,2,0,0,0
2019-04-17 03:00,1,0,1,0,0,0
2019-04-17 03:15,1,1,0,0,0,0
2019-04-17 03:30,3,2,1,0,0,0
2019-04-17 03:45,1,0,1,0,0,0
2019-04-17 04:00,1,1,0,0,0,0
2019-04-17 04:15,1,1,0,0,0,0
2019-04-17 04:30,2,0,2,0,0,0
2019-04-17 04:45,2,2,0,0,0,0
2019-04-17 05:00,4,3,1,0,0,0
2019-04-17 05:15,10,8,2,0,0,0
2019-04-17 05:30,11,7,4,0,0,0
2019-04-17 05:45,22,18,4,0,0,0
2019-04-17 06:00,25,21,4,0,0,0
2019-04-17 06:15,40,33,7,0,0,0
2019-04-17 06:30,55,39,16,0,0,0
2019-04-17 06:45,81,61,20,0,0,0
2019-04-17 07:00,61,39,22,0,0,0
2019-04-17 07:15,107,69,38,0,0,0
2019-04-17 07:30,111,82,29,0,0,0
2019-04-17 07:45,173,132,41,0,0,0
2019-04-17 08:00,147,91,56,0,0,0
2019-04-17 08:15,162,100,62,0,0,0
2019-04-17 08:30,129,85,44,0,0,0
2019-04-17 08:45,159,100,59,0,0,0
2019-04-17 09:00,111,70,41,0,0,0
2019-04-17 09:15,126,89,37,0,0,0
2019-04-17 09:30,127,105,22,0,0,0
2019-04-17 09:45,199,151,48,0,0,0
2019-04-17 10:00,181,118,63,0,0,0
2019-04-17 10:15,130,78,52,0,0,0
2019-04-17 10:30,137,70,67,0,0,0
2019-04-17 10:45,139,89,50,0,0,0
2019-04-17 11:00,136,75,61,0,0,0
2019-04-17 11:15,134,92,42,0,0,0
2019-04-17 11:30,164,96,68,0,0,0
2019-04-17 11:45,211,122,89,0,0,0
2019-04-17 12:00,182,83,99,0,0,0
2019-04-17 12:15,203,106,97,0,0,0
2019-04-17 12:30,148,65,83,0,0,0
2019-04-17 12:45,175,81,94,0,0,0
2019-04-17 13:00,163,66,97,0,0,0
2019-04-17 13:15,164,68,96,0,0,0
2019-04-17 13:30,163,75,88,0,0,0
2019-04-17 13:45,183,66,117,0,0,0
2019-04-17 14:00,222,81,141,0,0,0
2019-04-17 14:15,184,67,117,0,0,0
2019-04-17 14:30,161,62,99,0,0,0
2019-04-17 14:45,180,82,98,0,0,0
2019-04-17 15:00,167,79,88,0,0,0
2019-04-17 15:15,164,54,110,0,0,0
2019-04-17 15:30,178,80,98,0,0,0
2019-04-17 15:45,197,81,116,0,0,0
2019-04-17 16:00,230,87,143,0,0,0
2019-04-17 16:15,206,99,107,0,0,0
2019-04-17 16:30,197,67,130,0,0,0
2019-04-17 16:45,232,88,144,0,0,0
2019-04-17 17:00,204,69,135,0,0,0
2019-04-17 17:15,206,73,133,0,0,0
2019-04-17 17:30,197,72,125,0,0,0
2019-04-17 17:45,237,78,159,0,0,0
2019-04-17 18:00,267,93,174,0,0,0
2019-04-17 18:15,197,63,134,0,0,0
2019-04-17 18:30,174,59,115,0,0,0
2019-04-17 18:45,172,74,98,0,0,0
2019-04-17 19:00,184,81,103,0,0,0
2019-04-17 19:15,152,57,95,0,0,0
2019-04-17 19:30,115,38,77,0,0,0
2019-04-17 19:45,126,50,76,0,0,0
2019-04-17 20:00,92,27,65,0,0,0
2019-04-17 20:15,117,51,66,0,0,0
2019-04-17 20:30,77,38,39,0,0,0
2019-04-17 20:45,80,26,54,0,0,0
2019-04-17 21:00,77,27,50,0,0,0
2019-04-17 21:15,57,16,41,0,0,0
2019-04-17 21:30,68,24,44,0,0,0
2019-04-17 21:45,54,21,33,0,0,0
2019-04-17 22:00,111,28,83,0,0,0
2019-04-17 22:15,62,16,46,0,0,0
2019-04-17 22:30,59,21,38,0,0,0
2019-04-17 22:45,46,13,33,0,0,0
2019-04-17 23:00,38,11,27,0,0,0
2019-04-17 23:15,58,28,30,0,0,0
2019-04-17 23:30,31,14,17,0,0,0
2019-04-17 23:45,23,13,10,0,0,0
2019-04-18 00:00,45,22,23,0,0,0
2019-04-18 00:15,21,13,8,0,0,0
2019-04-18 00:30,16,4,12,0,0,0
2019-04-18 00:45,15,7,8,0,0,0
2019-04-18 01:00,12,3,9,0,0,0
2019-04-18 01:15,3,0,3,0,0,0
2019-04-18 01:30,7,3,4,0,0,0
2019-04-18 01:45,6,1,5,0,0,0
2019-04-18 02:00,10,1,9,0,0,0
2019-04-18 02:15,6,0,6,0,0,0
2019-04-18 02:30,6,0,6,0,0,0
2019-04-18 02:45,10,0,10,0,0,0
2019-04-18 03:00,15,1,14,0,0,0
2019-04-18 03:15,7,3,4,0,0,0
2019-04-18 03:30,6,1,5,0,0,0
2019-04-18 03:45,12,1,11,0,0,0
2019-04-18 04:00,12,2,10,0,0,0
2019-04-18 04:15,4,1,3,0,0,0
2019-04-18 04:30,2,1,1,0,0,0
2019-04-18 04:45,7,1,6,0,0,0
2019-04-18 05:00,4,4,0,0,0,0
2019-04-18 05:15,4,3,1,0,0,0
2019-04-18 05:30,16,10,6,0,0,0
2019-04-18 05:45,16,14,2,0,0,0
2019-04-18 06:00,26,17,9,0,0,0
2019-04-18 06:15,34,26,8,0,0,0
2019-04-18 06:30,34,25,9,0,0,0
2019-04-18 06:45,68,46,22,0,0,0
2019-04-18 07:00,64,44,20,0,0,0
2019-04-18 07:15,80,54,26,0,0,0
2019-04-18 07:30,99,73,26,0,0,0
2019-04-18 07:45,163,129,34,0,0,0
2019-04-18 08:00,156,116,40,0,0,0
2019-04-18 08:15,142,89,53,0,0,0
2019-04-18 08:30,118,84,34,0,0,0
2019-04-18 08:45,142,97,45,0,0,0
2019-04-18 09:00,92,67,25,0,0,0
2019-04-18 09:15,81,56,25,0,0,0
2019-04-18 09:30,119,83,36,0,0,0
2019-04-18 09:45,178,129,49,0,0,0
2019-04-18 10:00,153,107,46,0,0,0
2019-04-18 10:15,121,65,56,0,0,0
2019-04-18 10:30,101,60,41,0,0,0
2019-04-18 10:45,130,80,50,0,0,0
2019-04-18 11:00,115,68,47,0,0,0
2019-04-18 11:15,121,58,63,0,0,0
2019-04-18 11:30,173,79,94,0,0,0
2019-04-18 11:45,170,95,75,0,0,0
2019-04-18 12:00,151,79,72,0,0,0
2019-04-18 12:15,152,69,83,0,0,0
2019-04-18 12:30,157,70,87,0,0,0
2019-04-18 12:45,127,67,60,0,0,0
2019-04-18 13:00,154,55,99,0,0,0
2019-04-18 13:15,170,78,92,0,0,0
2019-04-18 13:30,123,51,72,0,0,0
2019-04-18 13:45,212,88,124,0,0,0
2019-04-18 14:00,183,77,106,0,0,0
2019-04-18 14:15,192,95,97,0,0,0
2019-04-18 14:30,167,65,102,0,0,0
2019-04-18 14:45,186,98,88,0,0,0
2019-04-18 15:00,168,72,96,0,0,0
2019-04-18 15:15,190,68,122,0,0,0
2019-04-18 15:30,195,90,105,0,0,0
2019-04-18 15:45,212,92,120,0,0,0
2019-04-18 16:00,229,89,140,0,0,0
2019-04-18 16:15,232,90,142,0,0,0
2019-04-18 16:30,186,77,109,0,0,0
2019-04-18 16:45,180,63,117,0,0,0
2019-04-18 17:00,202,88,114,0,0,0
2019-04-18 17:15,211,83,128,0,0,0
2019-04-18 17:30,183,71,112,0,0,0
2019-04-18 17:45,206,85,121,0,0,0
2019-04-18 18:00,212,92,120,0,0,0
2019-04-18 18:15,182,64,118,0,0,0
2019-04-18 18:30,179,68,111,0,0,0
2019-04-18 18:45,172,73,99,0,0,0
2019-04-18 19:00,141,43,98,0,0,0
2019-04-18 19:15,159,71,88,0,0,0
2019-04-18 19:30,135,43,92,0,0,0
2019-04-18 19:45,125,48,77,0,0,0
2019-04-18 20:00,116,38,78,0,0,0
2019-04-18 20:15,78,35,43,0,0,0
2019-04-18 20:30,67,24,43,0,0,0
2019-04-18 20:45,84,17,67,0,0,0
2019-04-18 21:00,85,34,51,0,0,0
2019-04-18 21:15,59,29,30,0,0,0
2019-04-18 21:30,67,25,42,0,0,0
2019-04-18 21:45,35,11,24,0,0,0
2019-04-18 22:00,63,12,51,0,0,0
2019-04-18 22:15,55,20,35,0,0,0
2019-04-18 22:30,55,14,41,0,0,0
2019-04-18 22:45,43,8,35,0,0,0
2019-04-18 23:00,49,18,31,0,0,0
2019-04-18 23:15,41,19,22,0,0,0
2019-04-18 23:30,31,6,25,0,0,0
2019-04-18 23:45,29,13,16,0,0,0
2019-04-19 00:00,44,14,30,0,0,0
2019-04-19 00:15,38,8,30,0,0,0
2019-04-19 00:30,20,4,16,0,0,0
2019-04-19 00:45,23,7,16,0,0,0
2019-04-19 01:00,23,11,12,0,0,0
2019-04-19 01:15,17,7,10,0,0,0
2019-04-19 01:30,16,6,10,0,0,0
2019-04-19 01:45,8,2,6,0,0,0
2019-04-19 02:00,14,9,5,0,0,0
2019-04-19 02:15,9,3,6,0,0,0
2019-04-19 02:30,13,6,7,0,0,0
2019-04-19 02:45,8,0,8,0,0,0
2019-04-19 03:00,12,3,9,0,0,0
2019-04-19 03:15,5,1,4,0,0,0
2019-04-19 03:30,5,0,5,0,0,0
2019-04-19 03:45,4,0,4,0,0,0
2019-04-19 04:00,4,4,0,0,0,0
2019-04-19 04:15,1,0,1,0,0,0
2019-04-19 04:30,2,2,0,0,0,0
2019-04-19 04:45,1,1,0,0,0,0
2019-04-19 05:00,1,1,0,0,0,0
2019-04-19 05:15,4,3,1,0,0,0
2019-04-19 05:30,9,6,3,0,0,0
2019-04-19 05:45,1,1,0,0,0,0
2019-04-19 06:00,9,4,5,0,0,0
2019-04-19 06:15,1,1,0,0,0,0
2019-04-19 06:30,9,5,4,0,0,0
2019-04-19 06:45,11,6,5,0,0,0
2019-04-19 07:00,6,3,3,0,0,0
2019-04-19 07:15,7,3,4,0,0,0
2019-04-19 07:30,8,6,2,0,0,0
2019-04-19 07:45,8,6,2,0,0,0
2019-04-19 08:00,13,8,5,0,0,0
2019-04-19 08:15,18,8,10,0,0,0
2019-04-19 08:30,20,9,11,0,0,0
2019-04-19 08:45,31,13,18,0,0,0
2019-04-19 09:00,23,11,12,0,0,0
2019-04-19 09:15,21,14,7,0,0,0
2019-04-19 09:30,31,22,9,0,0,0
2019-04-19 09:45,41,19,22,0,0,0
2019-04-19 10:00,36,20,16,0,0,0
2019-04-19 10:15,41,26,15,0,0,0
2019-04-19 10:30,40,24,16,0,0,0
2019-04-19 10:45,41,32,9,0,0,0
2019-04-19 11:00,30,17,13,0,0,0
2019-04-19 11:15,39,18,21,0,0,0
2019-04-19 11:30,51,29,22,0,0,0
2019-04-19 11:45,64,32,32,0,0,0
2019-04-19 12:00,51,28,23,0,0,0
2019-04-19 12:15,82,43,39,0,0,0
2019-04-19 12:30,70,38,32,0,0,0
2019-04-19 12:45,71,35,36,0,0,0
2019-04-19 13:00,58,29,29,0,0,0
2019-04-19 13:15,73,54,19,0,0,0
2019-04-19 13:30,77,33,44,0,0,0
2019-04-19 13:45,69,44,25,0,0,0
2019-04-19 14:00,75,44,31,0,0,0
2019-04-19 14:15,81,43,38,0,0,0
2019-04-19 14:30,80,56,24,0,0,0
2019-04-19 14:45,112,56,56,0,0,0
2019-04-19 15:00,80,32,48,0,0,0
2019-04-19 15:15,67,28,39,0,0,0
2019-04-19 15:30,92,46,46,0,0,0
2019-04-19 15:45,100,42,58,0,0,0
2019-04-19 16:00,66,24,42,0,0,0
2019-04-19 16:15,66,30,36,0,0,0
2019-04-19 16:30,107,43,64,0,0,0
2019-04-19 16:45,82,38,44,0,0,0
2019-04-19 17:00,69,24,45,0,0,0
2019-04-19 17:15,59,22,37,0,0,0
2019-04-19 17:30,78,32,46,0,0,0
2019-04-19 17:45,87,29,58,0,0,0
2019-04-19 18:00,79,25,54,0,0,0
2019-04-19 18:15,74,32,42,0,0,0
2019-04-19 18:30,60,23,37,0,0,0
2019-04-19 18:45,84,30,54,0,0,0
2019-04-19 19:00,69,32,37,0,0,0
2019-04-19 19:15,74,24,50,0,0,0
2019-04-19 19:30,72,28,44,0,0,0
2019-04-19 19:45,71,25,46,0,0,0
2019-04-19 20:00,56,26,30,0,0,0
2019-04-19 20:15,84,27,57,0,0,0
2019-04-19 20:30,53,21,32,0,0,0
2019-04-19 20:45,31,15,16,0,0,0
2019-04-19 21:00,42,13,29,0,0,0
2019-04-19 21:15,30,11,19,0,0,0
2019-04-19 21:30,39,20,19,0,0,0
2019-04-19 21:45,33,13,20,0,0,0
2019-04-19 22:00,33,6,27,0,0,0
2019-04-19 22:15,22,12,10,0,0,0
2019-04-19 22:30,25,9,16,0,0,0
2019-04-19 22:45,23,8,15,0,0,0
2019-04-19 23:00,29,9,20,0,0,0
2019-04-19 23:15,22,6,16,0,0,0
2019-04-19 23:30,20,8,12,0,0,0
2019-04-19 23:45,22,5,17,0,0,0
2019-04-20 00:00,28,18,10,0,0,0
2019-04-20 00:15,22,6,16,0,0,0
2019-04-20 00:30,7,0,7,0,0,0
2019-04-20 00:45,7,6,1,0,0,0
2019-04-20 01:00,9,6,3,0,0,0
2019-04-20 01:15,10,3,7,0,0,0
2019-04-20 01:30,4,2,2,0,0,0
2019-04-20 01:45,7,3,4,0,0,0
2019-04-20 02:00,7,2,5,0,0,0
2019-04-20 02:15,5,3,2,0,0,0
2019-04-20 02:30,4,3,1,0,0,0
2019-04-20 02:45,3,3,0,0,0,0
2019-04-20 03:00,3,1,2,0,0,0
2019-04-20 03:15,1,0,1,0,0,0
2019-04-20 03:30,0,0,0,0,0,0
2019-04-20 03:45,4,0,4,0,0,0
2019-04-20 04:00,8,3,5,0,0,0
2019-04-20 04:15,3,1,2,0,0,0
2019-04-20 04:30,2,1,1,0,0,0
2019-04-20 04:45,0,0,0,0,0,0
2019-04-20 05:00,0,0,0,0,0,0
2019-04-20 05:15,4,3,1,0,0,0
2019-04-20 05:30,7,4,3,0,0,0
2019-04-20 05:45,8,5,3,0,0,0
2019-04-20 06:00,6,5,1,0,0,0
2019-04-20 06:15,6,3,3,0,0,0
2019-04-20 06:30,6,3,3,0,0,0
2019-04-20 06:45,11,9,2,0,0,0
2019-04-20 07:00,15,12,3,0,0,0
2019-04-20 07:15,22,19,3,0,0,0
2019-04-20 07:30,22,14,8,0,0,0
2019-04-20 07:45,31,21,10,0,0,0
2019-04-20 08:00,30,19,11,0,0,0
2019-04-20 08:15,39,19,20,0,0,0
2019-04-20 08:30,53,33,20,0,0,0
2019-04-20 08:45,73,44,29,0,0,0
2019-04-20 09:00,75,48,27,0,0,0
2019-04-20 09:15,102,73,29,0,0,0
2019-04-20 09:30,137,105,32,0,0,0
2019-04-20 09:45,150,110,40,0,0,0
2019-04-20 10:00,159,110,49,0,0,0
2019-04-20 10:15,147,96,51,0,0,0
2019-04-20 10:30,148,94,54,0,0,0
2019-04-20 10:45,225,146,79,0,0,0
2019-04-20 11:00,202,126,76,0,0,0
2019-04-20 11:15,161,93,68,0,0,0
2019-04-20 11:30,235,143,92,0,0,0
2019-04-20 11:45,237,138,99,0,0,0
2019-04-20 12:00,208,115,93,0,0,0
2019-04-20 12:15,214,99,115,0,0,0
2019-04-20 12:30,244,109,135,0,0,0
2019-04-20 12:45,255,107,148,0,0,0
2019-04-20 13:00,242,90,152,0,0,0
2019-04-20 13:15,187,74,113,0,0,0
2019-04-20 13:30,261,103,158,0,0,0
2019-04-20 13:45,193,75,118,0,0,0
2019-04-20 14:00,151,69,82,0,0,0
2019-04-20 14:15,157,80,77,0,0,0
2019-04-20 14:30,156,70,86,0,0,0
2019-04-20 14:45,190,76,114,0,0,0
2019-04-20 15:00,106,43,63,0,0,0
2019-04-20 15:15,156,61,95,0,0,0
2019-04-20 15:30,131,55,76,0,0,0
2019-04-20 15:45,131,63,68,0,0,0
2019-04-20 16:00,174,88,86,0,0,0
2019-04-20 16:15,203,124,79,0,0,0
2019-04-20 16:30,126,67,59,0,0,0
2019-04-20 16:45,125,69,56,0,0,0
2019-04-20 17:00,134,48,86,0,0,0
2019-04-20 17:15,113,42,71,0,0,0
2019-04-20 17:30,128,69,59,0,0,0
2019-04-20 17:45,115,43,72,0,0,0
2019-04-20 18:00,118,36,82,0,0,0
2019-04-20 18:15,110,33,77,0,0,0
2019-04-20 18:30,90,32,58,0,0,0
2019-04-20 18:45,98,36,62,0,0,0
2019-04-20 19:00,85,36,49,0,0,0
2019-04-20 19:15,76,25,51,0,0,0
2019-04-20 19:30,67,28,39,0,0,0
2019-04-20 19:45,86,34,52,0,0,0
2019-04-20 20:00,96,25,71,0,0,0
2019-04-20 20:15,71,26,45,0,0,0
2019-04-20 20:30,71,29,42,0,0,0
2019-04-20 20:45,56,23,33,0,0,0
2019-04-20 21:00,34,16,18,0,0,0
2019-04-20 21:15,29,13,16,0,0,0
2019-04-20 21:30,34,11,23,0,0,0
2019-04-20 21:45,40,15,25,0,0,0
2019-04-20 22:00,42,11,31,0,0,0
2019-04-20 22:15,35,6,29,0,0,0
2019-04-20 22:30,36,13,23,0,0,0
2019-04-20 22:45,26,8,18,0,0,0
2019-04-20 23:00,44,19,25,0,0,0
2019-04-20 23:15,32,6,26,0,0,0
2019-04-20 23:30,28,15,13,0,0,0
2019-04-20 23:45,29,5,24,0,0,0
2019-04-21 00:00,19,4,15,0,0,0
2019-04-21 00:15,17,4,13,0,0,0
2019-04-21 00:30,30,13,17,0,0,0
2019-04-21 00:45,21,8,13,0,0,0
2019-04-21 01:00,13,2,11,0,0,0
2019-04-21 01:15,17,1,16,0,0,0
2019-04-21 01:30,20,7,13,0,0,0
2019-04-21 01:45,12,6,6,0,0,0
2019-04-21 02:00,19,5,14,0,0,0
2019-04-21 02:15,11,3,8,0,0,0
2019-04-21 02:30,6,2,4,0,0,0
2019-04-21 02:45,5,1,4,0,0,0
2019-04-21 03:00,14,5,9,0,0,0
2019-04-21 03:15,10,7,3,0,0,0
2019-04-21 03:30,5,0,5,0,0,0
2019-04-21 03:45,2,0,2,0,0,0
2019-04-21 04:00,6,1,5,0,0,0
2019-04-21 04:15,9,2,7,0,0,0
2019-04-21 04:30,5,1,4,0,0,0
2019-04-21 04:45,10,3,7,0,0,0
2019-04-21 05:00,6,1,5,0,0,0
2019-04-21 05:15,3,0,3,0,0,0
2019-04-21 05:30,8,4,4,0,0,0
2019-04-21 05:45,6,1,5,0,0,0
2019-04-21 06:00,5,4,1,0,0,0
2019-04-21 06:15,1,1,0,0,0,0
2019-04-21 06:30,9,4,5,0,0,0
2019-04-21 06:45,5,4,1,0,0,0
2019-04-21 07:00,1,0,1,0,0,0
2019-04-21 07:15,9,3,6,0,0,0
2019-04-21 07:30,10,5,5,0,0,0
2019-04-21 07:45,12,7,5,0,0,0
2019-04-21 08:00,13,7,6,0,0,0
2019-04-21 08:15,7,5,2,0,0,0
2019-04-21 08:30,8,3,5,0,0,0
2019-04-21 08:45,17,8,9,0,0,0
2019-04-21 09:00,13,11,2,0,0,0
2019-04-21 09:15,28,20,8,0,0,0
2019-04-21 09:30,19,8,11,0,0,0
2019-04-21 09:45,57,31,26,0,0,0
2019-04-21 10:00,31,14,17,0,0,0
2019-04-21 10:15,32,14,18,0,0,0
2019-04-21 10:30,30,17,13,0,0,0
2019-04-21 10:45,42,26,16,0,0,0
2019-04-21 11:00,35,17,18,0,0,0
2019-04-21 11:15,37,23,14,0,0,0
2019-04-21 11:30,45,28,17,0,0,0
2019-04-21 11:45,32,15,17,0,0,0
2019-04-21 12:00,58,28,30,0,0,0
2019-04-21 12:15,49,37,12,0,0,0
2019-04-21 12:30,55,24,31,0,0,0
2019-04-21 12:45,44,25,19,0,0,0
2019-04-21 13:00,82,34,48,0,0,0
2019-04-21 13:15,25,6,19,0,0,0
2019-04-21 13:30,39,30,9,0,0,0
2019-04-21 13:45,56,32,24,0,0,0
2019-04-21 14:00,61,25,36,0,0,0
2019-04-21 14:15,53,28,25,0,0,0
2019-04-21 14:30,63,28,35,0,0,0
2019-04-21 14:45,71,33,38,0,0,0
2019-04-21 15:00,42,19,23,0,0,0
2019-04-21 15:15,39,17,22,0,0,0
2019-04-21 15:30,61,29,32,0,0,0
2019-04-21 15:45,44,24,20,0,0,0
2019-04-21 16:00,63,37,26,0,0,0
2019-04-21 16:15,48,20,28,0,0,0
2019-04-21 16:30,55,17,38,0,0,0
2019-04-21 16:45,58,27,31,0,0,0
2019-04-21 17:00,68,30,38,0,0,0
2019-04-21 17:15,57,29,28,0,0,0
2019-04-21 17:30,53,19,34,0,0,0
2019-04-21 17:45,58,18,40,0,0,0
2019-04-21 18:00,62,24,38,0,0,0
2019-04-21 18:15,53,18,35,0,0,0
2019-04-21 18:30,56,20,36,0,0,0
2019-04-21 18:45,66,30,36,0,0,0
2019-04-21 19:00,53,24,29,0,0,0
2019-04-21 19:15,63,22,41,0,0,0
2019-04-21 19:30,38,20,18,0,0,0
2019-04-21 19:45,66,44,22,0,0,0
2019-04-21 20:00,32,14,18,0,0,0
2019-04-21 20:15,39,28,11,0,0,0
2019-04-21 20:30,43,25,18,0,0,0
2019-04-21 20:45,34,18,16,0,0,0
2019-04-21 21:00,36,16,20,0,0,0
2019-04-21 21:15,34,11,23,0,0,0
2019-04-21 21:30,28,7,21,0,0,0
2019-04-21 21:45,37,12,25,0,0,0
2019-04-21 22:00,34,16,18,0,0,0
2019-04-21 22:15,32,7,25,0,0,0
2019-04-21 22:30,24,13,11,0,0,0
2019-04-21 22:45,29,9,20,0,0,0
2019-04-21 23:00,27,3,24,0,0,0
2019-04-21 23:15,25,2,23,0,0,0
2019-04-21 23:30,19,4,15,0,0,0
2019-04-21 23:45,23,5,18,0,0,0
2019-04-22 00:00,21,6,15,0,0,0
2019-04-22 00:15,18,2,16,0,0,0
2019-04-22 00:30,7,4,3,0,0,0
2019-04-22 00:45,15,3,12,0,0,0
2019-04-22 01:00,15,5,10,0,0,0
2019-04-22 01:15,11,3,8,0,0,0
2019-04-22 01:30,7,2,5,0,0,0
2019-04-22 01:45,11,4,7,0,0,0
2019-04-22 02:00,7,6,1,0,0,0
2019-04-22 02:15,5,4,1,0,0,0
2019-04-22 02:30,1,0,1,0,0,0
2019-04-22 02:45,6,1,5,0,0,0
2019-04-22 03:00,3,0,3,0,0,0
2019-04-22 03:15,1,0,1,0,0,0
2019-04-22 03:30,2,0,2,0,0,0
2019-04-22 03:45,2,1,1,0,0,0
2019-04-22 04:00,5,1,4,0,0,0
2019-04-22 04:15,2,1,1,0,0,0
2019-04-22 04:30,0,0,0,0,0,0
2019-04-22 04:45,3,1,2,0,0,0
2019-04-22 05:00,1,0,1,0,0,0
2019-04-22 05:15,2,1,1,0,0,0
2019-04-22 05:30,7,4,3,0,0,0
2019-04-22 05:45,4,2,2,0,0,0
2019-04-22 06:00,2,0,2,0,0,0
2019-04-22 06:15,6,5,1,0,0,0
2019-04-22 06:30,2,1,1,0,0,0
2019-04-22 06:45,3,1,2,0,0,0
2019-04-22 07:00,2,2,0,0,0,0
2019-04-22 07:15,8,3,5,0,0,0
2019-04-22 07:30,7,4,3,0,0,0
2019-04-22 07:45,12,10,2,0,0,0
2019-04-22 08:00,7,4,3,0,0,0
2019-04-22 08:15,5,3,2,0,0,0
2019-04-22 08:30,15,10,5,0,0,0
2019-04-22 08:45,23,18,5,0,0,0
2019-04-22 09:00,17,10,7,0,0,0
2019-04-22 09:15,21,11,10,0,0,0
2019-04-22 09:30,35,27,8,0,0,0
2019-04-22 09:45,39,25,14,0,0,0
2019-04-22 10:00,41,21,20,0,0,0
2019-04-22 10:15,31,21,10,0,0,0
2019-04-22 10:30,39,26,13,0,0,0
2019-04-22 10:45,51,33,18,0,0,0
2019-04-22 11:00,43,21,22,0,0,0
2019-04-22 11:15,43,23,20,0,0,0
2019-04-22 11:30,41,18,23,0,0,0
2019-04-22 11:45,49,21,28,0,0,0
2019-04-22 12:00,47,22,25,0,0,0
2019-04-22 12:15,70,30,40,0,0,0
2019-04-22 12:30,99,36,63,0,0,0
2019-04-22 12:45,72,35,37,0,0,0
2019-04-22 13:00,71,42,29,0,0,0
2019-04-22 13:15,56,24,32,0,0,0
2019-04-22 13:30,70,22,48,0,0,0
2019-04-22 13:45,51,31,20,0,0,0
2019-04-22 14:00,90,40,50,0,0,0
2019-04-22 14:15,63,27,36,0,0,0
2019-04-22 14:30,85,45,40,0,0,0
2019-04-22 14:45,76,29,47,0,0,0
2019-04-22 15:00,91,34,57,0,0,0
2019-04-22 15:15,97,60,37,0,0,0
2019-04-22 15:30,104,53,51,0,0,0
2019-04-22 15:45,69,25,44,0,0,0
2019-04-22 16:00,111,47,64,0,0,0
2019-04-22 16:15,70,16,54,0,0,0
2019-04-22 16:30,69,29,40,0,0,0
2019-04-22 16:45,70,28,42,0,0,0
2019-04-22 17:00,58,19,39,0,0,0
2019-04-22 17:15,68,31,37,0,0,0
2019-04-22 17:30,102,27,75,0,0,0
2019-04-22 17:45,62,27,35,0,0,0
2019-04-22 18:00,88,26,62,0,0,0
2019-04-22 18:15,81,39,42,0,0,0
2019-04-22 18:30,73,28,45,0,0,0
2019-04-22 18:45,72,25,47,0,0,0
2019-04-22 19:00,72,29,43,0,0,0
2019-04-22 19:15,81,43,38,0,0,0
2019-04-22 19:30,52,15,37,0,0,0
2019-04-22 19:45,46,11,35,0,0,0
2019-04-22 20:00,51,15,36,0,0,0
2019-04-22 20:15,61,13,48,0,0,0
2019-04-22 20:30,42,17,25,0,0,0
2019-04-22 20:45,38,18,20,0,0,0
2019-04-22 21:00,47,19,28,0,0,0
2019-04-22 21:15,21,8,13,0,0,0
2019-04-22 21:30,36,16,20,0,0,0
2019-04-22 21:45,30,13,17,0,0,0
2019-04-22 22:00,28,8,20,0,0,0
2019-04-22 22:15,32,11,21,0,0,0
2019-04-22 22:30,14,3,11,0,0,0
2019-04-22 22:45,15,5,10,0,0,0
2019-04-22 23:00,19,3,16,0,0,0
2019-04-22 23:15,5,1,4,0,0,0
2019-04-22 23:30,8,3,5,0,0,0
2019-04-22 23:45,9,2,7,0,0,0
2019-04-23 00:00,7,1,6,0,0,0
2019-04-23 00:15,6,2,4,0,0,0
2019-04-23 00:30,11,3,8,0,0,0
2019-04-23 00:45,2,0,2,0,0,0
2019-04-23 01:00,3,1,2,0,0,0
2019-04-23 01:15,3,2,1,0,0,0
2019-04-23 01:30,5,1,4,0,0,0
2019-04-23 01:45,1,0,1,0,0,0
2019-04-23 02:00,1,0,1,0,0,0
2019-04-23 02:15,0,0,0,0,0,0
2019-04-23 02:30,0,0,0,0,0,0
2019-04-23 02:45,1,1,0,0,0,0
2019-04-23 03:00,1,0,1,0,0,0
2019-04-23 03:15,3,1,2,0,0,0
2019-04-23 03:30,3,1,2,0,0,0
2019-04-23 03:45,1,1,0,0,0,0
2019-04-23 04:00,0,0,0,0,0,0
2019-04-23 04:15,3,1,2,0,0,0
2019-04-23 04:30,1,1,0,0,0,0
2019-04-23 04:45,4,4,0,0,0,0
2019-04-23 05:00,2,2,0,0,0,0
2019-04-23 05:15,7,3,4,0,0,0
2019-04-23 05:30,12,9,3,0,0,0
2019-04-23 05:45,18,15,3,0,0,0
2019-04-23 06:00,36,21,15,0,0,0
2019-04-23 06:15,24,19,5,0,0,0
2019-04-23 06:30,38,29,9,0,0,0
2019-04-23 06:45,62,43,19,0,0,0
2019-04-23 07:00,64,43,21,0,0,0
2019-04-23 07:15,74,47,27,0,0,0
2019-04-23 07:30,87,53,34,0,0,0
2019-04-23 07:45,161,113,48,0,0,0
2019-04-23 08:00,142,98,44,0,0,0
2019-04-23 08:15,125,75,50,0,0,0
2019-04-23 08:30,98,71,27,0,0,0
2019-04-23 08:45,132,100,32,0,0,0
2019-04-23 09:00,97,63,34,0,0,0
2019-04-23 09:15,120,81,39,0,0,0
2019-04-23 09:30,128,75,53,0,0,0
2019-04-23 09:45,134,93,41,0,0,0
2019-04-23 10:00,111,69,42,0,0,0
2019-04-23 10:15,108,63,45,0,0,0
2019-04-23 10:30,105,56,49,0,0,0
2019-04-23 10:45,119,69,50,0,0,0
2019-04-23 11:00,136,71,65,0,0,0
2019-04-23 11:15,131,69,62,0,0,0
2019-04-23 11:30,150,83,67,0,0,0
2019-04-23 11:45,146,85,61,0,0,0
2019-04-23 12:00,173,75,98,0,0,0
2019-04-23 12:15,152,53,99,0,0,0
2019-04-23 12:30,131,67,64,0,0,0
2019-04-23 12:45,139,62,77,0,0,0
2019-04-23 13:00,148,57,91,0,0,0
2019-04-23 13:15,143,54,89,0,0,0
2019-04-23 13:30,161,65,96,0,0,0
2019-04-23 13:45,164,79,85,0,0,0
2019-04-23 14:00,164,75,89,0,0,0
2019-04-23 14:15,181,79,102,0,0,0
2019-04-23 14:30,177,63,114,0,0,0
2019-04-23 14:45,163,74,89,0,0,0
2019-04-23 15:00,169,80,89,0,0,0
2019-04-23 15:15,183,82,101,0,0,0
2019-04-23 15:30,188,74,114,0,0,0
2019-04-23 15:45,196,91,105,0,0,0
2019-04-23 16:00,228,92,136,0,0,0
2019-04-23 16:15,185,75,110,0,0,0
2019-04-23 16:30,205,73,132,0,0,0
2019-04-23 16:45,205,72,133,0,0,0
2019-04-23 17:00,203,77,126,0,0,0
2019-04-23 17:15,189,77,112,0,0,0
2019-04-23 17:30,173,67,106,0,0,0
2019-04-23 17:45,216,89,127,0,0,0
2019-04-23 18:00,220,84,136,0,0,0
2019-04-23 18:15,196,81,115,0,0,0
2019-04-23 18:30,156,53,103,0,0,0
2019-04-23 18:45,182,71,111,0,0,0
2019-04-23 19:00,167,57,110,0,0,0
2019-04-23 19:15,145,33,112,0,0,0
2019-04-23 19:30,113,37,76,0,0,0
2019-04-23 19:45,149,50,99,0,0,0
2019-04-23 20:00,112,36,76,0,0,0
2019-04-23 20:15,113,28,85,0,0,0
2019-04-23 20:30,88,31,57,0,0,0
2019-04-23 20:45,63,16,47,0,0,0
2019-04-23 21:00,51,14,37,0,0,0
2019-04-23 21:15,47,15,32,0,0,0
2019-04-23 21:30,64,24,40,0,0,0
2019-04-23 21:45,63,22,41,0,0,0
2019-04-23 22:00,50,14,36,0,0,0
2019-04-23 22:15,46,18,28,0,0,0
2019-04-23 22:30,43,8,35,0,0,0
2019-04-23 22:45,56,16,40,0,0,0
2019-04-23 23:00,37,14,23,0,0,0
2019-04-23 23:15,26,7,19,0,0,0
2019-04-23 23:30,33,4,29,0,0,0
2019-04-23 23:45,24,0,24,0,0,0
2019-04-24 00:00,23,12,11,0,0,0
2019-04-24 00:15,16,5,11,0,0,0
2019-04-24 00:30,8,5,3,0,0,0
2019-04-24 00:45,12,4,8,0,0,0
2019-04-24 01:00,7,1,6,0,0,0
2019-04-24 01:15,2,2,0,0,0,0
2019-04-24 01:30,1,0,1,0,0,0
2019-04-24 01:45,1,0,1,0,0,0
2019-04-24 02:00,1,0,1,0,0,0
2019-04-24 02:15,0,0,0,0,0,0
2019-04-24 02:30,0,0,0,0,0,0
2019-04-24 02:45,4,1,3,0,0,0
2019-04-24 03:00,4,2,2,0,0,0
2019-04-24 03:15,3,0,3,0,0,0
2019-04-24 03:30,6,2,4,0,0,0
2019-04-24 03:45,3,2,1,0,0,0
2019-04-24 04:00,0,0,0,0,0,0
2019-04-24 04:15,1,1,0,0,0,0
2019-04-24 04:30,4,1,3,0,0,0
2019-04-24 04:45,6,6,0,0,0,0
2019-04-24 05:00,1,1,0,0,0,0
2019-04-24 05:15,8,6,2,0,0,0
2019-04-24 05:30,15,8,7,0,0,0
2019-04-24 05:45,29,21,8,0,0,0
2019-04-24 06:00,27,19,8,0,0,0
2019-04-24 06:15,38,31,7,0,0,0
2019-04-24 06:30,49,35,14,0,0,0
2019-04-24 06:45,62,43,19,0,0,0
2019-04-24 07:00,67,51,16,0,0,0
2019-04-24 07:15,104,80,24,0,0,0
2019-04-24 07:30,122,81,41,0,0,0
2019-04-24 07:45,161,112,49,0,0,0
2019-04-24 08:00,170,121,49,0,0,0
2019-04-24 08:15,141,83,58,0,0,0
2019-04-24 08:30,109,71,38,0,0,0
2019-04-24 08:45,146,108,38,0,0,0
2019-04-24 09:00,101,70,31,0,0,0
2019-04-24 09:15,124,98,26,0,0,0
2019-04-24 09:30,128,83,45,0,0,0
2019-04-24 09:45,167,121,46,0,0,0
2019-04-24 10:00,155,107,48,0,0,0
2019-04-24 10:15,129,68,61,0,0,0
2019-04-24 10:30,118,66,52,0,0,0
2019-04-24 10:45,169,103,66,0,0,0
2019-04-24 11:00,138,75,63,0,0,0
2019-04-24 11:15,161,80,81,0,0,0
2019-04-24 11:30,149,80,69,0,0,0
2019-04-24 11:45,192,109,83,0,0,0
2019-04-24 12:00,161,80,81,0,0,0
2019-04-24 12:15,163,75,88,0,0,0
2019-04-24 12:30,160,63,97,0,0,0
2019-04-24 12:45,142,55,87,0,0,0
2019-04-24 13:00,177,68,109,0,0,0
2019-04-24 13:15,167,70,97,0,0,0
2019-04-24 13:30,136,59,77,0,0,0
2019-04-24 13:45,197,100,97,0,0,0
2019-04-24 14:00,170,81,89,0,0,0
2019-04-24 14:15,179,83,96,0,0,0
2019-04-24 14:30,179,84,95,0,0,0
2019-04-24 14:45,151,65,86,0,0,0
2019-04-24 15:00,149,61,88,0,0,0
2019-04-24 15:15,164,72,92,0,0,0
2019-04-24 15:30,145,77,68,0,0,0
2019-04-24 15:45,205,76,129,0,0,0
2019-04-24 16:00,217,80,137,0,0,0
2019-04-24 16:15,198,60,138,0,0,0
2019-04-24 16:30,207,92,115,0,0,0
2019-04-24 16:45,201,80,121,0,0,0
2019-04-24 17:00,203,61,142,0,0,0
2019-04-24 17:15,174,65,109,0,0,0
2019-04-24 17:30,204,93,111,0,0,0
2019-04-24 17:45,240,100,140,0,0,0
2019-04-24 18:00,224,67,157,0,0,0
2019-04-24 18:15,190,65,125,0,0,0
2019-04-24 18:30,182,63,119,0,0,0
2019-04-24 18:45,174,75,99,0,0,0
2019-04-24 19:00,163,62,101,0,0,0
2019-04-24 19:15,156,64,92,0,0,0
2019-04-24 19:30,158,44,114,0,0,0
2019-04-24 19:45,136,51,85,0,0,0
2019-04-24 20:00,86,21,65,0,0,0
2019-04-24 20:15,116,33,83,0,0,0
2019-04-24 20:30,88,33,55,0,0,0
2019-04-24 20:45,85,33,52,0,0,0
2019-04-24 21:00,73,21,52,0,0,0
2019-04-24 21:15,48,7,41,0,0,0
2019-04-24 21:30,31,9,22,0,0,0
2019-04-24 21:45,38,12,26,0,0,0
2019-04-24 22:00,39,8,31,0,0,0
2019-04-24 22:15,56,18,38,0,0,0
2019-04-24 22:30,45,28,17,0,0,0
2019-04-24 22:45,94,59,35,0,0,0
2019-04-24 23:00,79,42,37,0,0,0
2019-04-24 23:15,25,11,14,0,0,0
2019-04-24 23:30,33,16,17,0,0,0
2019-04-24 23:45,29,10,19,0,0,0
2019-04-25 00:00,18,10,8,0,0,0
2019-04-25 00:15,14,4,10,0,0,0
2019-04-25 00:30,12,4,8,0,0,0
2019-04-25 00:45,19,6,13,0,0,0
2019-04-25 01:00,5,3,2,0,0,0
2019-04-25 01:15,12,3,9,0,0,0
2019-04-25 01:30,12,5,7,0,0,0
2019-04-25 01:45,1,0,1,0,0,0
2019-04-25 02:00,1,0,1,0,0,0
2019-04-25 02:15,13,3,10,0,0,0
2019-04-25 02:30,5,0,5,0,0,0
2019-04-25 02:45,7,3,4,0,0,0
2019-04-25 03:00,5,1,4,0,0,0
2019-04-25 03:15,2,0,2,0,0,0
2019-04-25 03:30,3,2,1,0,0,0
2019-04-25 03:45,6,1,5,0,0,0
2019-04-25 04:00,6,0,6,0,0,0
2019-04-25 04:15,4,0,4,0,0,0
2019-04-25 04:30,3,0,3,0,0,0
2019-04-25 04:45,9,5,4,0,0,0
2019-04-25 05:00,5,3,2,0,0,0
2019-04-25 05:15,9,3,6,0,0,0
2019-04-25 05:30,17,12,5,0,0,0
2019-04-25 05:45,22,16,6,0,0,0
2019-04-25 06:00,27,18,9,0,0,0
2019-04-25 06:15,41,34,7,0,0,0
2019-04-25 06:30,35,25,10,0,0,0
2019-04-25 06:45,58,42,16,0,0,0
2019-04-25 07:00,70,47,23,0,0,0
2019-04-25 07:15,85,64,21,0,0,0
2019-04-25 07:30,107,73,34,0,0,0
2019-04-25 07:45,152,115,37,0,0,0
2019-04-25 08:00,152,111,41,0,0,0
2019-04-25 08:15,140,99,41,0,0,0
2019-04-25 08:30,108,83,25,0,0,0
2019-04-25 08:45,147,95,52,0,0,0
2019-04-25 09:00,101,75,26,0,0,0
2019-04-25 09:15,79,51,28,0,0,0
2019-04-25 09:30,115,88,27,0,0,0
2019-04-25 09:45,154,105,49,0,0,0
2019-04-25 10:00,130,85,45,0,0,0
2019-04-25 10:15,114,60,54,0,0,0
2019-04-25 10:30,117,69,48,0,0,0
2019-04-25 10:45,121,77,44,0,0,0
2019-04-25 11:00,110,61,49,0,0,0
2019-04-25 11:15,101,56,45,0,0,0
2019-04-25 11:30,113,58,55,0,0,0
2019-04-25 11:45,171,91,80,0,0,0
2019-04-25 12:00,154,76,78,0,0,0
2019-04-25 12:15,160,62,98,0,0,0
2019-04-25 12:30,128,63,65,0,0,0
2019-04-25 12:45,123,58,65,0,0,0
2019-04-25 13:00,111,37,74,0,0,0
2019-04-25 13:15,145,67,78,0,0,0
2019-04-25 13:30,152,65,87,0,0,0
2019-04-25 13:45,171,73,98,0,0,0
2019-04-25 14:00,196,96,100,0,0,0
2019-04-25 14:15,162,69,93,0,0,0
2019-04-25 14:30,165,71,94,0,0,0
2019-04-25 14:45,176,76,100,0,0,0
2019-04-25 15:00,180,76,104,0,0,0
2019-04-25 15:15,163,71,92,0,0,0
2019-04-25 15:30,183,62,121,0,0,0
2019-04-25 15:45,268,122,146,0,0,0
2019-04-25 16:00,216,91,125,0,0,0
2019-04-25 16:15,169,54,115,0,0,0
2019-04-25 16:30,226,72,154,0,0,0
2019-04-25 16:45,210,68,142,0,0,0
2019-04-25 17:00,186,64,122,0,0,0
2019-04-25 17:15,198,85,113,0,0,0
2019-04-25 17:30,223,75,148,0,0,0
2019-04-25 17:45,239,74,165,0,0,0
2019-04-25 18:00,200,57,143,0,0,0
2019-04-25 18:15,179,72,107,0,0,0
2019-04-25 18:30,157,56,101,0,0,0
2019-04-25 18:45,144,62,82,0,0,0
2019-04-25 19:00,140,40,100,0,0,0
2019-04-25 19:15,163,61,102,0,0,0
2019-04-25 19:30,109,30,79,0,0,0
2019-04-25 19:45,133,44,89,0,0,0
2019-04-25 20:00,109,21,88,0,0,0
2019-04-25 20:15,99,27,72,0,0,0
2019-04-25 20:30,63,28,35,0,0,0
2019-04-25 20:45,54,18,36,0,0,0
2019-04-25 21:00,43,12,31,0,0,0
2019-04-25 21:15,57,19,38,0,0,0
2019-04-25 21:30,58,15,43,0,0,0
2019-04-25 21:45,54,14,40,0,0,0
2019-04-25 22:00,87,26,61,0,0,0
2019-04-25 22:15,50,12,38,0,0,0
2019-04-25 22:30,61,17,44,0,0,0
2019-04-25 22:45,44,5,39,0,0,0
2019-04-25 23:00,50,16,34,0,0,0
2019-04-25 23:15,20,9,11,0,0,0
2019-04-25 23:30,36,14,22,0,0,0
2019-04-25 23:45,31,10,21,0,0,0
2019-04-26 00:00,23,6,17,0,0,0
2019-04-26 00:15,21,9,12,0,0,0
2019-04-26 00:30,6,1,5,0,0,0
2019-04-26 00:45,11,1,10,0,0,0
2019-04-26 01:00,8,1,7,0,0,0
2019-04-26 01:15,12,5,7,0,0,0
2019-04-26 01:30,2,0,2,0,0,0
2019-04-26 01:45,3,2,1,0,0,0
2019-04-26 02:00,4,2,2,0,0,0
2019-04-26 02:15,3,1,2,0,0,0
2019-04-26 02:30,4,4,0,0,0,0
2019-04-26 02:45,6,3,3,0,0,0
2019-04-26 03:00,4,2,2,0,0,0
2019-04-26 03:15,3,1,2,0,0,0
2019-04-26 03:30,3,1,2,0,0,0
2019-04-26 03:45,4,1,3,0,0,0
2019-04-26 04:00,2,0,2,0,0,0
2019-04-26 04:15,4,0,4,0,0,0
2019-04-26 04:30,1,0,1,0,0,0
2019-04-26 04:45,5,5,0,0,0,0
2019-04-26 05:00,4,3,1,0,0,0
2019-04-26 05:15,11,6,5,0,0,0
2019-04-26 05:30,12,9,3,0,0,0
2019-04-26 05:45,25,21,4,0,0,0
2019-04-26 06:00,28,20,8,0,0,0
2019-04-26 06:15,35,25,10,0,0,0
2019-04-26 06:30,37,21,16,0,0,0
2019-04-26 06:45,60,42,18,0,0,0
2019-04-26 07:00,59,38,21,0,0,0
2019-04-26 07:15,69,49,20,0,0,0
2019-04-26 07:30,82,57,25,0,0,0
2019-04-26 07:45,129,110,19,0,0,0
2019-04-26 08:00,99,80,19,0,0,0
2019-04-26 08:15,109,76,33,0,0,0
2019-04-26 08:30,75,48,27,0,0,0
2019-04-26 08:45,91,68,23,0,0,0
2019-04-26 09:00,64,44,20,0,0,0
2019-04-26 09:15,77,47,30,0,0,0
2019-04-26 09:30,80,55,25,0,0,0
2019-04-26 09:45,130,95,35,0,0,0
2019-04-26 10:00,113,84,29,0,0,0
2019-04-26 10:15,75,47,28,0,0,0
2019-04-26 10:30,83,50,33,0,0,0
2019-04-26 10:45,84,56,28,0,0,0
2019-04-26 11:00,62,33,29,0,0,0
2019-04-26 11:15,86,48,38,0,0,0
2019-04-26 11:30,105,47,58,0,0,0
2019-04-26 11:45,122,73,49,0,0,0
2019-04-26 12:00,109,53,56,0,0,0
2019-04-26 12:15,119,46,73,0,0,0
2019-04-26 12:30,139,56,83,0,0,0
2019-04-26 12:45,140,63,77,0,0,0
2019-04-26 13:00,132,50,82,0,0,0
2019-04-26 13:15,126,41,85,0,0,0
2019-04-26 13:30,159,61,98,0,0,0
2019-04-26 13:45,169,73,96,0,0,0
2019-04-26 14:00,156,53,103,0,0,0
2019-04-26 14:15,152,61,91,0,0,0
2019-04-26 14:30,147,57,90,0,0,0
2019-04-26 14:45,145,54,91,0,0,0
2019-04-26 15:00,161,66,95,0,0,0
2019-04-26 15:15,148,65,83,0,0,0
2019-04-26 15:30,154,60,94,0,0,0
2019-04-26 15:45,168,58,110,0,0,0
2019-04-26 16:00,173,76,97,0,0,0
2019-04-26 16:15,173,62,111,0,0,0
2019-04-26 16:30,159,58,101,0,0,0
2019-04-26 16:45,161,72,89,0,0,0
2019-04-26 17:00,143,58,85,0,0,0
2019-04-26 17:15,137,61,76,0,0,0
2019-04-26 17:30,133,46,87,0,0,0
2019-04-26 17:45,174,71,103,0,0,0
2019-04-26 18:00,147,64,83,0,0,0
2019-04-26 18:15,150,50,100,0,0,0
2019-04-26 18:30,138,46,92,0,0,0
2019-04-26 18:45,134,61,73,0,0,0
2019-04-26 19:00,125,41,84,0,0,0
2019-04-26 19:15,148,66,82,0,0,0
2019-04-26 19:30,132,61,71,0,0,0
2019-04-26 19:45,122,53,69,0,0,0
2019-04-26 20:00,126,61,65,0,0,0
2019-04-26 20:15,88,30,58,0,0,0
2019-04-26 20:30,98,29,69,0,0,0
2019-04-26 20:45,87,41,46,0,0,0
2019-04-26 21:00,71,34,37,0,0,0
2019-04-26 21:15,66,18,48,0,0,0
2019-04-26 21:30,64,24,40,0,0,0
2019-04-26 21:45,59,19,40,0,0,0
2019-04-26 22:00,47,14,33,0,0,0
2019-04-26 22:15,52,8,44,0,0,0
2019-04-26 22:30,50,24,26,0,0,0
2019-04-26 22:45,76,36,40,0,0,0
2019-04-26 23:00,56,26,30,0,0,0
2019-04-26 23:15,55,12,43,0,0,0
2019-04-26 23:30,48,11,37,0,0,0
2019-04-26 23:45,44,20,24,0,0,0
2019-04-27 00:00,35,15,20,0,0,0
2019-04-27 00:15,36,11,25,0,0,0
2019-04-27 00:30,37,11,26,0,0,0
2019-04-27 00:45,34,12,22,0,0,0
2019-04-27 01:00,34,3,31,0,0,0
2019-04-27 01:15,25,5,20,0,0,0
2019-04-27 01:30,24,8,16,0,0,0
2019-04-27 01:45,33,20,13,0,0,0
2019-04-27 02:00,19,6,13,0,0,0
2019-04-27 02:15,19,7,12,0,0,0
2019-04-27 02:30,13,4,9,0,0,0
2019-04-27 02:45,12,3,9,0,0,0
2019-04-27 03:00,8,3,5,0,0,0
2019-04-27 03:15,9,1,8,0,0,0
2019-04-27 03:30,11,3,8,0,0,0
2019-04-27 03:45,11,5,6,0,0,0
2019-04-27 04:00,10,3,7,0,0,0
2019-04-27 04:15,6,1,5,0,0,0
2019-04-27 04:30,2,0,2,0,0,0
2019-04-27 04:45,9,2,7,0,0,0
2019-04-27 05:00,2,0,2,0,0,0
2019-04-27 05:15,6,3,3,0,0,0
2019-04-27 05:30,12,8,4,0,0,0
2019-04-27 05:45,16,12,4,0,0,0
2019-04-27 06:00,5,4,1,0,0,0
2019-04-27 06:15,7,6,1,0,0,0
2019-04-27 06:30,6,2,4,0,0,0
2019-04-27 06:45,7,2,5,0,0,0
2019-04-27 07:00,7,6,1,0,0,0
2019-04-27 07:15,16,11,5,0,0,0
2019-04-27 07:30,26,18,8,0,0,0
2019-04-27 07:45,27,19,8,0,0,0
2019-04-27 08:00,34,21,13,0,0,0
2019-04-27 08:15,54,33,21,0,0,0
2019-04-27 08:30,32,18,14,0,0,0
2019-04-27 08:45,66,36,30,0,0,0
2019-04-27 09:00,65,52,13,0,0,0
2019-04-27 09:15,84,59,25,0,0,0
2019-04-27 09:30,119,85,34,0,0,0
2019-04-27 09:45,116,87,29,0,0,0
2019-04-27 10:00,86,47,39,0,0,0
2019-04-27 10:15,72,39,33,0,0,0
2019-04-27 10:30,74,34,40,0,0,0
2019-04-27 10:45,92,57,35,0,0,0
2019-04-27 11:00,96,68,28,0,0,0
2019-04-27 11:15,89,50,39,0,0,0
2019-04-27 11:30,84,39,45,0,0,0
2019-04-27 11:45,97,46,51,0,0,0
2019-04-27 12:00,91,53,38,0,0,0
2019-04-27 12:15,103,54,49,0,0,0
2019-04-27 12:30,90,47,43,0,0,0
2019-04-27 12:45,111,42,69,0,0,0
2019-04-27 13:00,101,44,57,0,0,0
2019-04-27 13:15,64,26,38,0,0,0
2019-04-27 13:30,82,34,48,0,0,0
2019-04-27 13:45,88,38,50,0,0,0
2019-04-27 14:00,91,50,41,0,0,0
2019-04-27 14:15,87,28,59,0,0,0
2019-04-27 14:30,77,31,46,0,0,0
2019-04-27 14:45,125,47,78,0,0,0
2019-04-27 15:00,96,34,62,0,0,0
2019-04-27 15:15,128,59,69,0,0,0
2019-04-27 15:30,108,51,57,0,0,0
2019-04-27 15:45,76,40,36,0,0,0
2019-04-27 16:00,92,40,52,0,0,0
2019-04-27 16:15,106,41,65,0,0,0
2019-04-27 16:30,80,28,52,0,0,0
2019-04-27 16:45,99,56,43,0,0,0
2019-04-27 17:00,72,30,42,0,0,0
2019-04-27 17:15,93,51,42,0,0,0
2019-04-27 17:30,143,30,113,0,0,0
2019-04-27 17:45,132,62,70,0,0,0
2019-04-27 18:00,74,15,59,0,0,0
2019-04-27 18:15,66,15,51,0,0,0
2019-04-27 18:30,73,12,61,0,0,0
2019-04-27 18:45,92,34,58,0,0,0
2019-04-27 19:00,75,30,45,0,0,0
2019-04-27 19:15,72,40,32,0,0,0
2019-04-27 19:30,57,12,45,0,0,0
2019-04-27 19:45,81,41,40,0,0,0
2019-04-27 20:00,70,29,41,0,0,0
2019-04-27 20:15,58,26,32,0,0,0
2019-04-27 20:30,67,32,35,0,0,0
2019-04-27 20:45,49,30,19,0,0,0
2019-04-27 21:00,42,21,21,0,0,0
2019-04-27 21:15,32,12,20,0,0,0
2019-04-27 21:30,42,21,21,0,0,0
2019-04-27 21:45,79,57,22,0,0,0
2019-04-27 22:00,69,40,29,0,0,0
2019-04-27 22:15,51,30,21,0,0,0
2019-04-27 22:30,28,19,9,0,0,0
2019-04-27 22:45,37,19,18,0,0,0
2019-04-27 23:00,41,11,30,0,0,0
2019-04-27 23:15,41,24,17,0,0,0
2019-04-27 23:30,38,7,31,0,0,0
2019-04-27 23:45,28,7,21,0,0,0
2019-04-28 00:00,34,19,15,0,0,0
2019-04-28 00:15,39,14,25,0,0,0
2019-04-28 00:30,29,8,21,0,0,0
2019-04-28 00:45,23,11,12,0,0,0
2019-04-28 01:00,14,4,10,0,0,0
2019-04-28 01:15,19,5,14,0,0,0
2019-04-28 01:30,23,8,15,0,0,0
2019-04-28 01:45,11,5,6,0,0,0
2019-04-28 02:00,24,8,16,0,0,0
2019-04-28 02:15,16,3,13,0,0,0
2019-04-28 02:30,4,2,2,0,0,0
2019-04-28 02:45,17,7,10,0,0,0
2019-04-28 03:00,9,1,8,0,0,0
2019-04-28 03:15,7,2,5,0,0,0
2019-04-28 03:30,7,2,5,0,0,0
2019-04-28 03:45,14,0,14,0,0,0
2019-04-28 04:00,7,0,7,0,0,0
2019-04-28 04:15,8,1,7,0,0,0
2019-04-28 04:30,3,0,3,0,0,0
2019-04-28 04:45,3,1,2,0,0,0
2019-04-28 05:00,3,0,3,0,0,0
2019-04-28 05:15,4,2,2,0,0,0
2019-04-28 05:30,6,1,5,0,0,0
2019-04-28 05:45,8,1,7,0,0,0
2019-04-28 06:00,2,0,2,0,0,0
2019-04-28 06:15,9,3,6,0,0,0
2019-04-28 06:30,4,0,4,0,0,0
2019-04-28 06:45,9,4,5,0,0,0
2019-04-28 07:00,3,1,2,0,0,0
2019-04-28 07:15,5,3,2,0,0,0
2019-04-28 07:30,6,4,2,0,0,0
2019-04-28 07:45,9,7,2,0,0,0
2019-04-28 08:00,11,8,3,0,0,0
2019-04-28 08:15,13,7,6,0,0,0
2019-04-28 08:30,10,7,3,0,0,0
2019-04-28 08:45,11,8,3,0,0,0
2019-04-28 09:00,14,9,5,0,0,0
2019-04-28 09:15,25,14,11,0,0,0
2019-04-28 09:30,34,17,17,0,0,0
2019-04-28 09:45,43,30,13,0,0,0
2019-04-28 10:00,32,23,9,0,0,0
2019-04-28 10:15,35,24,11,0,0,0
2019-04-28 10:30,33,17,16,0,0,0
2019-04-28 10:45,55,33,22,0,0,0
2019-04-28 11:00,29,12,17,0,0,0
2019-04-28 11:15,27,10,17,0,0,0
2019-04-28 11:30,25,18,7,0,0,0
2019-04-28 11:45,52,31,21,0,0,0
2019-04-28 12:00,36,19,17,0,0,0
2019-04-28 12:15,40,18,22,0,0,0
2019-04-28 12:30,50,21,29,0,0,0
2019-04-28 12:45,52,21,31,0,0,0
2019-04-28 13:00,45,22,23,0,0,0
2019-04-28 13:15,44,12,32,0,0,0
2019-04-28 13:30,39,16,23,0,0,0
2019-04-28 13:45,56,38,18,0,0,0
2019-04-28 14:00,47,21,26,0,0,0
2019-04-28 14:15,57,20,37,0,0,0
2019-04-28 14:30,72,32,40,0,0,0
2019-04-28 14:45,54,30,24,0,0,0
2019-04-28 15:00,21,2,19,0,0,0
2019-04-28 15:15,54,25,29,0,0,0
2019-04-28 15:30,53,28,25,0,0,0
2019-04-28 15:45,78,36,42,0,0,0
2019-04-28 16:00,53,16,37,0,0,0
2019-04-28 16:15,60,26,34,0,0,0
2019-04-28 16:30,64,30,34,0,0,0
2019-04-28 16:45,57,28,29,0,0,0
2019-04-28 17:00,52,25,27,0,0,0
2019-04-28 17:15,51,15,36,0,0,0
2019-04-28 17:30,63,23,40,0,0,0
2019-04-28 17:45,88,37,51,0,0,0
2019-04-28 18:00,67,27,40,0,0,0
2019-04-28 18:15,61,27,34,0,0,0
2019-04-28 18:30,65,22,43,0,0,0
2019-04-28 18:45,47,18,29,0,0,0
2019-04-28 19:00,61,14,47,0,0,0
2019-04-28 19:15,67,35,32,0,0,0
2019-04-28 19:30,68,22,46,0,0,0
2019-04-28 19:45,61,21,40,0,0,0
2019-04-28 20:00,57,19,38,0,0,0
2019-04-28 20:15,43,18,25,0,0,0
2019-04-28 20:30,47,18,29,0,0,0
2019-04-28 20:45,39,18,21,0,0,0
2019-04-28 21:00,28,6,22,0,0,0
2019-04-28 21:15,34,10,24,0,0,0
2019-04-28 21:30,23,10,13,0,0,0
2019-04-28 21:45,24,15,9,0,0,0
2019-04-28 22:00,17,5,12,0,0,0
2019-04-28 22:15,22,4,18,0,0,0
2019-04-28 22:30,13,6,7,0,0,0
2019-04-28 22:45,20,11,9,0,0,0
2019-04-28 23:00,12,2,10,0,0,0
2019-04-28 23:15,14,2,12,0,0,0
2019-04-28 23:30,13,4,9,0,0,0
2019-04-28 23:45,12,5,7,0,0,0
2019-04-29 00:00,12,3,9,0,0,0
2019-04-29 00:15,6,2,4,0,0,0
2019-04-29 00:30,8,4,4,0,0,0
2019-04-29 00:45,10,3,7,0,0,0
2019-04-29 01:00,6,2,4,0,0,0
2019-04-29 01:15,3,0,3,0,0,0
2019-04-29 01:30,1,1,0,0,0,0
2019-04-29 01:45,0,0,0,0,0,0
2019-04-29 02:00,1,0,1,0,0,0
2019-04-29 02:15,0,0,0,0,0,0
2019-04-29 02:30,0,0,0,0,0,0
2019-04-29 02:45,2,2,0,0,0,0
2019-04-29 03:00,0,0,0,0,0,0
2019-04-29 03:15,1,1,0,0,0,0
2019-04-29 03:30,2,0,2,0,0,0
2019-04-29 03:45,2,1,1,0,0,0
2019-04-29 04:00,0,0,0,0,0,0
2019-04-29 04:15,1,0,1,0,0,0
2019-04-29 04:30,1,0,1,0,0,0
2019-04-29 04:45,3,2,1,0,0,0
2019-04-29 05:00,3,2,1,0,0,0
2019-04-29 05:15,9,8,1,0,0,0
2019-04-29 05:30,13,12,1,0,0,0
2019-04-29 05:45,16,11,5,0,0,0
2019-04-29 06:00,24,19,5,0,0,0
2019-04-29 06:15,37,31,6,0,0,0
2019-04-29 06:30,29,17,12,0,0,0
2019-04-29 06:45,69,50,19,0,0,0
2019-04-29 07:00,74,45,29,0,0,0
2019-04-29 07:15,92,57,35,0,0,0
2019-04-29 07:30,168,109,59,0,0,0
2019-04-29 07:45,192,137,55,0,0,0
2019-04-29 08:00,153,115,38,0,0,0
2019-04-29 08:15,154,114,40,0,0,0
2019-04-29 08:30,121,85,36,0,0,0
2019-04-29 08:45,140,98,42,0,0,0
2019-04-29 09:00,122,80,42,0,0,0
2019-04-29 09:15,139,93,46,0,0,0
2019-04-29 09:30,125,92,33,0,0,0
2019-04-29 09:45,152,117,35,0,0,0
2019-04-29 10:00,135,85,50,0,0,0
2019-04-29 10:15,122,74,48,0,0,0
2019-04-29 10:30,100,52,48,0,0,0
2019-04-29 10:45,121,65,56,0,0,0
2019-04-29 11:00,143,79,64,0,0,0
2019-04-29 11:15,127,67,60,0,0,0
2019-04-29 11:30,149,70,79,0,0,0
2019-04-29 11:45,194,94,100,0,0,0
2019-04-29 12:00,158,64,94,0,0,0
2019-04-29 12:15,161,69,92,0,0,0
2019-04-29 12:30,144,62,82,0,0,0
2019-04-29 12:45,158,70,88,0,0,0
2019-04-29 13:00,136,46,90,0,0,0
2019-04-29 13:15,161,57,104,0,0,0
2019-04-29 13:30,179,72,107,0,0,0
2019-04-29 13:45,171,78,93,0,0,0
2019-04-29 14:00,150,47,103,0,0,0
2019-04-29 14:15,145,54,91,0,0,0
2019-04-29 14:30,183,72,111,0,0,0
2019-04-29 14:45,150,79,71,0,0,0
2019-04-29 15:00,166,50,116,0,0,0
2019-04-29 15:15,163,56,107,0,0,0
2019-04-29 15:30,206,90,116,0,0,0
2019-04-29 15:45,225,88,137,0,0,0
2019-04-29 16:00,207,79,128,0,0,0
2019-04-29 16:15,176,52,124,0,0,0
2019-04-29 16:30,182,65,117,0,0,0
2019-04-29 16:45,196,62,134,0,0,0
2019-04-29 17:00,206,61,145,0,0,0
2019-04-29 17:15,209,76,133,0,0,0
2019-04-29 17:30,186,70,116,0,0,0
2019-04-29 17:45,186,73,113,0,0,0
2019-04-29 18:00,197,63,134,0,0,0
2019-04-29 18:15,208,66,142,0,0,0
2019-04-29 18:30,153,50,103,0,0,0
2019-04-29 18:45,156,46,110,0,0,0
2019-04-29 19:00,148,48,100,0,0,0
2019-04-29 19:15,125,42,83,0,0,0
2019-04-29 19:30,127,38,89,0,0,0
2019-04-29 19:45,144,48,96,0,0,0
2019-04-29 20:00,104,31,73,0,0,0
2019-04-29 20:15,93,30,63,0,0,0
2019-04-29 20:30,58,23,35,0,0,0
2019-04-29 20:45,66,20,46,0,0,0
2019-04-29 21:00,55,11,44,0,0,0
2019-04-29 21:15,52,13,39,0,0,0
2019-04-29 21:30,60,18,42,0,0,0
2019-04-29 21:45,59,15,44,0,0,0
2019-04-29 22:00,62,10,52,0,0,0
2019-04-29 22:15,75,16,59,0,0,0
2019-04-29 22:30,28,8,20,0,0,0
2019-04-29 22:45,43,18,25,0,0,0
2019-04-29 23:00,28,8,20,0,0,0
2019-04-29 23:15,47,12,35,0,0,0
2019-04-29 23:30,17,4,13,0,0,0
2019-04-29 23:45,13,4,9,0,0,0
2019-04-30 00:00,20,6,14,0,0,0
2019-04-30 00:15,16,6,10,0,0,0
2019-04-30 00:30,6,0,6,0,0,0
2019-04-30 00:45,9,5,4,0,0,0
2019-04-30 01:00,9,1,8,0,0,0
2019-04-30 01:15,1,1,0,0,0,0
2019-04-30 01:30,6,1,5,0,0,0
2019-04-30 01:45,1,0,1,0,0,0
2019-04-30 02:00,1,0,1,0,0,0
2019-04-30 02:15,1,0,1,0,0,0
2019-04-30 02:30,1,0,1,0,0,0
2019-04-30 02:45,3,1,2,0,0,0
2019-04-30 03:00,3,1,2,0,0,0
2019-04-30 03:15,1,1,0,0,0,0
2019-04-30 03:30,2,1,1,0,0,0
2019-04-30 03:45,6,1,5,0,0,0
2019-04-30 04:00,2,0,2,0,0,0
2019-04-30 04:15,2,1,1,0,0,0
2019-04-30 04:30,1,1,0,0,0,0
2019-04-30 04:45,3,3,0,0,0,0
2019-04-30 05:00,4,4,0,0,0,0
2019-04-30 05:15,9,8,1,0,0,0
2019-04-30 05:30,18,13,5,0,0,0
2019-04-30 05:45,24,21,3,0,0,0
2019-04-30 06:00,21,13,8,0,0,0
2019-04-30 06:15,34,31,3,0,0,0
2019-04-30 06:30,50,37,13,0,0,0
2019-04-30 06:45,74,48,26,0,0,0
2019-04-30 07:00,80,49,31,0,0,0
2019-04-30 07:15,131,72,59,0,0,0
2019-04-30 07:30,181,109,72,0,0,0
2019-04-30 07:45,192,135,57,0,0,0
2019-04-30 08:00,169,122,47,0,0,0
2019-04-30 08:15,189,126,63,0,0,0
2019-04-30 08:30,135,91,44,0,0,0
2019-04-30 08:45,158,110,48,0,0,0
2019-04-30 09:00,117,70,47,0,0,0
2019-04-30 09:15,111,66,45,0,0,0
2019-04-30 09:30,117,67,50,0,0,0
2019-04-30 09:45,186,144,42,0,0,0
2019-04-30 10:00,136,92,44,0,0,0
2019-04-30 10:15,133,68,65,0,0,0
2019-04-30 10:30,125,75,50,0,0,0
2019-04-30 10:45,128,63,65,0,0,0
2019-04-30 11:00,132,66,66,0,0,0
2019-04-30 11:15,162,76,86,0,0,0
2019-04-30 11:30,151,77,74,0,0,0
2019-04-30 11:45,188,92,96,0,0,0
2019-04-30 12:00,213,96,117,0,0,0
2019-04-30 12:15,143,64,79,0,0,0
2019-04-30 12:30,172,70,102,0,0,0
2019-04-30 12:45,177,61,116,0,0,0
2019-04-30 13:00,162,82,80,0,0,0
2019-04-30 13:15,157,65,92,0,0,0
2019-04-30 13:30,151,65,86,0,0,0
2019-04-30 13:45,227,93,134,0,0,0
2019-04-30 14:00,211,84,127,0,0,0
2019-04-30 14:15,168,71,97,0,0,0
2019-04-30 14:30,199,71,128,0,0,0
2019-04-30 14:45,192,98,94,0,0,0
2019-04-30 15:00,137,58,79,0,0,0
2019-04-30 15:15,204,83,121,0,0,0
2019-04-30 15:30,197,74,123,0,0,0
2019-04-30 15:45,239,105,134,0,0,0
2019-04-30 16:00,271,106,165,0,0,0
2019-04-30 16:15,243,96,147,0,0,0
2019-04-30 16:30,260,94,166,0,0,0
2019-04-30 16:45,238,94,144,0,0,0
2019-04-30 17:00,241,95,146,0,0,0
2019-04-30 17:15,223,78,145,0,0,0
2019-04-30 17:30,243,100,143,0,0,0
2019-04-30 17:45,260,109,151,0,0,0
2019-04-30 18:00,257,116,141,0,0,0
2019-04-30 18:15,182,65,117,0,0,0
2019-04-30 18:30,191,60,131,0,0,0
2019-04-30 18:45,201,84,117,0,0,0
2019-04-30 19:00,169,71,98,0,0,0
2019-04-30 19:15,173,77,96,0,0,0
2019-04-30 19:30,178,65,113,0,0,0
2019-04-30 19:45,204,105,99,0,0,0
2019-04-30 20:00,162,69,93,0,0,0
2019-04-30 20:15,137,61,76,0,0,0
2019-04-30 20:30,100,54,46,0,0,0
2019-04-30 20:45,115,62,53,0,0,0
2019-04-30 21:00,131,60,71,0,0,0
2019-04-30 21:15,86,36,50,0,0,0
2019-04-30 21:30,103,47,56,0,0,0
2019-04-30 21:45,87,38,49,0,0,0
2019-04-30 22:00,86,26,60,0,0,0
2019-04-30 22:15,72,35,37,0,0,0
2019-04-30 22:30,69,21,48,0,0,0
2019-04-30 22:45,62,20,42,0,0,0
2019-04-30 23:00,51,22,29,0,0,0
2019-04-30 23:15,62,18,44,0,0,0
2019-04-30 23:30,75,35,40,0,0,0
2019-04-30 23:45,63,33,30,0,0,0
