Datetime,100034980 (Hammer Straße),101034980 (Hammer Straße stadteinwärts),102034980 (Hammer Straße stadtauswärts),100034980-status,101034980-status,102034980-status
2021-11-01 00:00,28,11,17,0,0,0
2021-11-01 00:15,22,10,12,0,0,0
2021-11-01 00:30,32,19,13,0,0,0
2021-11-01 00:45,22,15,7,0,0,0
2021-11-01 01:00,33,10,23,0,0,0
2021-11-01 01:15,20,3,17,0,0,0
2021-11-01 01:30,24,12,12,0,0,0
2021-11-01 01:45,14,4,10,0,0,0
2021-11-01 02:00,22,8,14,0,0,0
2021-11-01 02:15,23,3,20,0,0,0
2021-11-01 02:30,26,8,18,0,0,0
2021-11-01 02:45,19,6,13,0,0,0
2021-11-01 03:00,18,6,12,0,0,0
2021-11-01 03:15,24,12,12,0,0,0
2021-11-01 03:30,16,5,11,0,0,0
2021-11-01 03:45,14,1,13,0,0,0
2021-11-01 04:00,5,1,4,0,0,0
2021-11-01 04:15,5,1,4,0,0,0
2021-11-01 04:30,5,1,4,0,0,0
2021-11-01 04:45,5,1,4,0,0,0
2021-11-01 05:00,5,1,4,0,0,0
2021-11-01 05:15,5,0,5,0,0,0
2021-11-01 05:30,6,3,3,0,0,0
2021-11-01 05:45,5,3,2,0,0,0
2021-11-01 06:00,9,6,3,0,0,0
2021-11-01 06:15,7,1,6,0,0,0
2021-11-01 06:30,3,0,3,0,0,0
2021-11-01 06:45,6,3,3,0,0,0
2021-11-01 07:00,3,1,2,0,0,0
2021-11-01 07:15,7,5,2,0,0,0
2021-11-01 07:30,8,7,1,0,0,0
2021-11-01 07:45,19,13,6,0,0,0
2021-11-01 08:00,8,5,3,0,0,0
2021-11-01 08:15,12,7,5,0,0,0
2021-11-01 08:30,19,10,9,0,0,0
2021-11-01 08:45,25,15,10,0,0,0
2021-11-01 09:00,14,12,2,0,0,0
2021-11-01 09:15,16,9,7,0,0,0
2021-11-01 09:30,29,16,13,0,0,0
2021-11-01 09:45,37,20,17,0,0,0
2021-11-01 10:00,35,21,14,0,0,0
2021-11-01 10:15,44,26,18,0,0,0
2021-11-01 10:30,43,16,27,0,0,0
2021-11-01 10:45,34,21,13,0,0,0
2021-11-01 11:00,20,12,8,0,0,0
2021-11-01 11:15,43,19,24,0,0,0
2021-11-01 11:30,37,13,24,0,0,0
2021-11-01 11:45,77,23,54,0,0,0
2021-11-01 12:00,51,25,26,0,0,0
2021-11-01 12:15,60,30,30,0,0,0
2021-11-01 12:30,50,26,24,0,0,0
2021-11-01 12:45,64,43,21,0,0,0
2021-11-01 13:00,52,21,31,0,0,0
2021-11-01 13:15,55,26,29,0,0,0
2021-11-01 13:30,48,19,29,0,0,0
2021-11-01 13:45,75,31,44,0,0,0
2021-11-01 14:00,64,33,31,0,0,0
2021-11-01 14:15,62,27,35,0,0,0
2021-11-01 14:30,56,26,30,0,0,0
2021-11-01 14:45,87,37,50,0,0,0
2021-11-01 15:00,94,44,50,0,0,0
2021-11-01 15:15,82,40,42,0,0,0
2021-11-01 15:30,65,20,45,0,0,0
2021-11-01 15:45,70,32,38,0,0,0
2021-11-01 16:00,62,26,36,0,0,0
2021-11-01 16:15,75,29,46,0,0,0
2021-11-01 16:30,68,29,39,0,0,0
2021-11-01 16:45,83,45,38,0,0,0
2021-11-01 17:00,97,38,59,0,0,0
2021-11-01 17:15,55,20,35,0,0,0
2021-11-01 17:30,67,26,41,0,0,0
2021-11-01 17:45,71,30,41,0,0,0
2021-11-01 18:00,48,24,24,0,0,0
2021-11-01 18:15,64,32,32,0,0,0
2021-11-01 18:30,57,21,36,0,0,0
2021-11-01 18:45,54,26,28,0,0,0
2021-11-01 19:00,47,26,21,0,0,0
2021-11-01 19:15,44,23,21,0,0,0
2021-11-01 19:30,49,25,24,0,0,0
2021-11-01 19:45,46,23,23,0,0,0
2021-11-01 20:00,48,14,34,0,0,0
2021-11-01 20:15,46,11,35,0,0,0
2021-11-01 20:30,31,9,22,0,0,0
2021-11-01 20:45,25,7,18,0,0,0
2021-11-01 21:00,39,13,26,0,0,0
2021-11-01 21:15,27,6,21,0,0,0
2021-11-01 21:30,21,7,14,0,0,0
2021-11-01 21:45,23,7,16,0,0,0
2021-11-01 22:00,32,4,28,0,0,0
2021-11-01 22:15,29,6,23,0,0,0
2021-11-01 22:30,25,6,19,0,0,0
2021-11-01 22:45,12,5,7,0,0,0
2021-11-01 23:00,15,1,14,0,0,0
2021-11-01 23:15,9,5,4,0,0,0
2021-11-01 23:30,6,3,3,0,0,0
2021-11-01 23:45,10,1,9,0,0,0
2021-11-02 00:00,7,3,4,0,0,0
2021-11-02 00:15,5,1,4,0,0,0
2021-11-02 00:30,3,2,1,0,0,0
2021-11-02 00:45,2,2,0,0,0,0
2021-11-02 01:00,3,2,1,0,0,0
2021-11-02 01:15,2,0,2,0,0,0
2021-11-02 01:30,3,2,1,0,0,0
2021-11-02 01:45,1,1,0,0,0,0
2021-11-02 02:00,0,0,0,0,0,0
2021-11-02 02:15,0,0,0,0,0,0
2021-11-02 02:30,1,1,0,0,0,0
2021-11-02 02:45,1,0,1,0,0,0
2021-11-02 03:00,2,0,2,0,0,0
2021-11-02 03:15,1,1,0,0,0,0
2021-11-02 03:30,0,0,0,0,0,0
2021-11-02 03:45,0,0,0,0,0,0
2021-11-02 04:00,1,0,1,0,0,0
2021-11-02 04:15,0,0,0,0,0,0
2021-11-02 04:30,1,1,0,0,0,0
2021-11-02 04:45,6,6,0,0,0,0
2021-11-02 05:00,5,4,1,0,0,0
2021-11-02 05:15,13,8,5,0,0,0
2021-11-02 05:30,22,15,7,0,0,0
2021-11-02 05:45,26,24,2,0,0,0
2021-11-02 06:00,31,20,11,0,0,0
2021-11-02 06:15,29,21,8,0,0,0
2021-11-02 06:30,58,39,19,0,0,0
2021-11-02 06:45,71,45,26,0,0,0
2021-11-02 07:00,103,65,38,0,0,0
2021-11-02 07:15,115,80,35,0,0,0
2021-11-02 07:30,182,103,79,0,0,0
2021-11-02 07:45,229,145,84,0,0,0
2021-11-02 08:00,193,128,65,0,0,0
2021-11-02 08:15,172,114,58,0,0,0
2021-11-02 08:30,155,105,50,0,0,0
2021-11-02 08:45,171,119,52,0,0,0
2021-11-02 09:00,84,54,30,0,0,0
2021-11-02 09:15,108,67,41,0,0,0
2021-11-02 09:30,115,82,33,0,0,0
2021-11-02 09:45,179,111,68,0,0,0
2021-11-02 10:00,130,76,54,0,0,0
2021-11-02 10:15,129,76,53,0,0,0
2021-11-02 10:30,138,85,53,0,0,0
2021-11-02 10:45,138,70,68,0,0,0
2021-11-02 11:00,120,67,53,0,0,0
2021-11-02 11:15,136,66,70,0,0,0
2021-11-02 11:30,146,68,78,0,0,0
2021-11-02 11:45,169,84,85,0,0,0
2021-11-02 12:00,155,61,94,0,0,0
2021-11-02 12:15,153,60,93,0,0,0
2021-11-02 12:30,126,49,77,0,0,0
2021-11-02 12:45,126,60,66,0,0,0
2021-11-02 13:00,147,58,89,0,0,0
2021-11-02 13:15,153,52,101,0,0,0
2021-11-02 13:30,158,72,86,0,0,0
2021-11-02 13:45,184,77,107,0,0,0
2021-11-02 14:00,140,49,91,0,0,0
2021-11-02 14:15,163,80,83,0,0,0
2021-11-02 14:30,163,72,91,0,0,0
2021-11-02 14:45,184,86,98,0,0,0
2021-11-02 15:00,178,71,107,0,0,0
2021-11-02 15:15,205,92,113,0,0,0
2021-11-02 15:30,185,71,114,0,0,0
2021-11-02 15:45,232,84,148,0,0,0
2021-11-02 16:00,246,91,155,0,0,0
2021-11-02 16:15,190,78,112,0,0,0
2021-11-02 16:30,219,84,135,0,0,0
2021-11-02 16:45,240,89,151,0,0,0
2021-11-02 17:00,204,78,126,0,0,0
2021-11-02 17:15,201,75,126,0,0,0
2021-11-02 17:30,212,65,147,0,0,0
2021-11-02 17:45,205,79,126,0,0,0
2021-11-02 18:00,204,67,137,0,0,0
2021-11-02 18:15,205,69,136,0,0,0
2021-11-02 18:30,161,61,100,0,0,0
2021-11-02 18:45,163,64,99,0,0,0
2021-11-02 19:00,142,41,101,0,0,0
2021-11-02 19:15,117,47,70,0,0,0
2021-11-02 19:30,84,22,62,0,0,0
2021-11-02 19:45,112,40,72,0,0,0
2021-11-02 20:00,72,23,49,0,0,0
2021-11-02 20:15,78,24,54,0,0,0
2021-11-02 20:30,68,27,41,0,0,0
2021-11-02 20:45,61,12,49,0,0,0
2021-11-02 21:00,45,14,31,0,0,0
2021-11-02 21:15,43,9,34,0,0,0
2021-11-02 21:30,71,20,51,0,0,0
2021-11-02 21:45,40,15,25,0,0,0
2021-11-02 22:00,68,24,44,0,0,0
2021-11-02 22:15,56,13,43,0,0,0
2021-11-02 22:30,54,17,37,0,0,0
2021-11-02 22:45,36,15,21,0,0,0
2021-11-02 23:00,25,4,21,0,0,0
2021-11-02 23:15,26,4,22,0,0,0
2021-11-02 23:30,11,1,10,0,0,0
2021-11-02 23:45,13,6,7,0,0,0
2021-11-03 00:00,16,3,13,0,0,0
2021-11-03 00:15,5,2,3,0,0,0
2021-11-03 00:30,2,0,2,0,0,0
2021-11-03 00:45,5,3,2,0,0,0
2021-11-03 01:00,3,1,2,0,0,0
2021-11-03 01:15,6,3,3,0,0,0
2021-11-03 01:30,4,4,0,0,0,0
2021-11-03 01:45,5,1,4,0,0,0
2021-11-03 02:00,1,0,1,0,0,0
2021-11-03 02:15,1,0,1,0,0,0
2021-11-03 02:30,1,0,1,0,0,0
2021-11-03 02:45,5,4,1,0,0,0
2021-11-03 03:00,1,0,1,0,0,0
2021-11-03 03:15,0,0,0,0,0,0
2021-11-03 03:30,1,1,0,0,0,0
2021-11-03 03:45,2,1,1,0,0,0
2021-11-03 04:00,0,0,0,0,0,0
2021-11-03 04:15,4,1,3,0,0,0
2021-11-03 04:30,2,2,0,0,0,0
2021-11-03 04:45,3,3,0,0,0,0
2021-11-03 05:00,7,7,0,0,0,0
2021-11-03 05:15,9,6,3,0,0,0
2021-11-03 05:30,18,11,7,0,0,0
2021-11-03 05:45,34,22,12,0,0,0
2021-11-03 06:00,29,19,10,0,0,0
2021-11-03 06:15,41,30,11,0,0,0
2021-11-03 06:30,51,36,15,0,0,0
2021-11-03 06:45,52,36,16,0,0,0
2021-11-03 07:00,98,59,39,0,0,0
2021-11-03 07:15,113,62,51,0,0,0
2021-11-03 07:30,162,117,45,0,0,0
2021-11-03 07:45,223,145,78,0,0,0
2021-11-03 08:00,184,138,46,0,0,0
2021-11-03 08:15,154,95,59,0,0,0
2021-11-03 08:30,129,89,40,0,0,0
2021-11-03 08:45,137,95,42,0,0,0
2021-11-03 09:00,120,71,49,0,0,0
2021-11-03 09:15,95,57,38,0,0,0
2021-11-03 09:30,127,84,43,0,0,0
2021-11-03 09:45,162,106,56,0,0,0
2021-11-03 10:00,131,71,60,0,0,0
2021-11-03 10:15,109,59,50,0,0,0
2021-11-03 10:30,105,56,49,0,0,0
2021-11-03 10:45,128,53,75,0,0,0
2021-11-03 11:00,125,57,68,0,0,0
2021-11-03 11:15,129,63,66,0,0,0
2021-11-03 11:30,131,61,70,0,0,0
2021-11-03 11:45,149,76,73,0,0,0
2021-11-03 12:00,160,80,80,0,0,0
2021-11-03 12:15,128,56,72,0,0,0
2021-11-03 12:30,136,43,93,0,0,0
2021-11-03 12:45,138,54,84,0,0,0
2021-11-03 13:00,159,70,89,0,0,0
2021-11-03 13:15,131,44,87,0,0,0
2021-11-03 13:30,129,47,82,0,0,0
2021-11-03 13:45,179,75,104,0,0,0
2021-11-03 14:00,164,56,108,0,0,0
2021-11-03 14:15,172,65,107,0,0,0
2021-11-03 14:30,158,58,100,0,0,0
2021-11-03 14:45,167,52,115,0,0,0
2021-11-03 15:00,149,45,104,0,0,0
2021-11-03 15:15,108,39,69,0,0,0
2021-11-03 15:30,122,39,83,0,0,0
2021-11-03 15:45,165,70,95,0,0,0
2021-11-03 16:00,193,60,133,0,0,0
2021-11-03 16:15,128,36,92,0,0,0
2021-11-03 16:30,143,42,101,0,0,0
2021-11-03 16:45,150,49,101,0,0,0
2021-11-03 17:00,121,39,82,0,0,0
2021-11-03 17:15,139,51,88,0,0,0
2021-11-03 17:30,148,59,89,0,0,0
2021-11-03 17:45,181,59,122,0,0,0
2021-11-03 18:00,175,50,125,0,0,0
2021-11-03 18:15,123,37,86,0,0,0
2021-11-03 18:30,117,42,75,0,0,0
2021-11-03 18:45,90,40,50,0,0,0
2021-11-03 19:00,106,34,72,0,0,0
2021-11-03 19:15,81,37,44,0,0,0
2021-11-03 19:30,90,34,56,0,0,0
2021-11-03 19:45,79,27,52,0,0,0
2021-11-03 20:00,69,22,47,0,0,0
2021-11-03 20:15,57,23,34,0,0,0
2021-11-03 20:30,36,13,23,0,0,0
2021-11-03 20:45,34,10,24,0,0,0
2021-11-03 21:00,58,15,43,0,0,0
2021-11-03 21:15,47,16,31,0,0,0
2021-11-03 21:30,43,11,32,0,0,0
2021-11-03 21:45,62,18,44,0,0,0
2021-11-03 22:00,38,11,27,0,0,0
2021-11-03 22:15,44,6,38,0,0,0
2021-11-03 22:30,37,14,23,0,0,0
2021-11-03 22:45,40,10,30,0,0,0
2021-11-03 23:00,46,17,29,0,0,0
2021-11-03 23:15,34,11,23,0,0,0
2021-11-03 23:30,17,5,12,0,0,0
2021-11-03 23:45,22,7,15,0,0,0
2021-11-04 00:00,15,4,11,0,0,0
2021-11-04 00:15,15,7,8,0,0,0
2021-11-04 00:30,16,8,8,0,0,0
2021-11-04 00:45,16,2,14,0,0,0
2021-11-04 01:00,18,7,11,0,0,0
2021-11-04 01:15,4,3,1,0,0,0
2021-11-04 01:30,3,1,2,0,0,0
2021-11-04 01:45,4,2,2,0,0,0
2021-11-04 02:00,3,1,2,0,0,0
2021-11-04 02:15,9,3,6,0,0,0
2021-11-04 02:30,6,6,0,0,0,0
2021-11-04 02:45,5,0,5,0,0,0
2021-11-04 03:00,2,0,2,0,0,0
2021-11-04 03:15,2,0,2,0,0,0
2021-11-04 03:30,2,0,2,0,0,0
2021-11-04 03:45,0,0,0,0,0,0
2021-11-04 04:00,2,0,2,0,0,0
2021-11-04 04:15,6,2,4,0,0,0
2021-11-04 04:30,5,1,4,0,0,0
2021-11-04 04:45,1,1,0,0,0,0
2021-11-04 05:00,6,6,0,0,0,0
2021-11-04 05:15,10,7,3,0,0,0
2021-11-04 05:30,18,11,7,0,0,0
2021-11-04 05:45,28,22,6,0,0,0
2021-11-04 06:00,17,12,5,0,0,0
2021-11-04 06:15,35,23,12,0,0,0
2021-11-04 06:30,41,22,19,0,0,0
2021-11-04 06:45,58,42,16,0,0,0
2021-11-04 07:00,80,50,30,0,0,0
2021-11-04 07:15,102,63,39,0,0,0
2021-11-04 07:30,146,92,54,0,0,0
2021-11-04 07:45,187,125,62,0,0,0
2021-11-04 08:00,169,124,45,0,0,0
2021-11-04 08:15,142,90,52,0,0,0
2021-11-04 08:30,115,75,40,0,0,0
2021-11-04 08:45,115,70,45,0,0,0
2021-11-04 09:00,99,55,44,0,0,0
2021-11-04 09:15,81,46,35,0,0,0
2021-11-04 09:30,102,68,34,0,0,0
2021-11-04 09:45,142,93,49,0,0,0
2021-11-04 10:00,112,68,44,0,0,0
2021-11-04 10:15,85,54,31,0,0,0
2021-11-04 10:30,100,43,57,0,0,0
2021-11-04 10:45,113,64,49,0,0,0
2021-11-04 11:00,99,45,54,0,0,0
2021-11-04 11:15,118,55,63,0,0,0
2021-11-04 11:30,123,53,70,0,0,0
2021-11-04 11:45,133,61,72,0,0,0
2021-11-04 12:00,154,65,89,0,0,0
2021-11-04 12:15,97,34,63,0,0,0
2021-11-04 12:30,129,38,91,0,0,0
2021-11-04 12:45,154,51,103,0,0,0
2021-11-04 13:00,163,55,108,0,0,0
2021-11-04 13:15,126,50,76,0,0,0
2021-11-04 13:30,122,58,64,0,0,0
2021-11-04 13:45,155,75,80,0,0,0
2021-11-04 14:00,123,53,70,0,0,0
2021-11-04 14:15,191,89,102,0,0,0
2021-11-04 14:30,146,55,91,0,0,0
2021-11-04 14:45,200,79,121,0,0,0
2021-11-04 15:00,170,66,104,0,0,0
2021-11-04 15:15,178,81,97,0,0,0
2021-11-04 15:30,180,85,95,0,0,0
2021-11-04 15:45,229,102,127,0,0,0
2021-11-04 16:00,220,81,139,0,0,0
2021-11-04 16:15,213,77,136,0,0,0
2021-11-04 16:30,222,78,144,0,0,0
2021-11-04 16:45,237,87,150,0,0,0
2021-11-04 17:00,184,58,126,0,0,0
2021-11-04 17:15,204,69,135,0,0,0
2021-11-04 17:30,181,58,123,0,0,0
2021-11-04 17:45,198,69,129,0,0,0
2021-11-04 18:00,196,48,148,0,0,0
2021-11-04 18:15,151,50,101,0,0,0
2021-11-04 18:30,116,33,83,0,0,0
2021-11-04 18:45,164,55,109,0,0,0
2021-11-04 19:00,146,45,101,0,0,0
2021-11-04 19:15,90,22,68,0,0,0
2021-11-04 19:30,69,24,45,0,0,0
2021-11-04 19:45,98,33,65,0,0,0
2021-11-04 20:00,98,26,72,0,0,0
2021-11-04 20:15,67,29,38,0,0,0
2021-11-04 20:30,78,31,47,0,0,0
2021-11-04 20:45,58,15,43,0,0,0
2021-11-04 21:00,52,29,23,0,0,0
2021-11-04 21:15,63,16,47,0,0,0
2021-11-04 21:30,62,22,40,0,0,0
2021-11-04 21:45,45,19,26,0,0,0
2021-11-04 22:00,68,21,47,0,0,0
2021-11-04 22:15,60,23,37,0,0,0
2021-11-04 22:30,52,13,39,0,0,0
2021-11-04 22:45,34,6,28,0,0,0
2021-11-04 23:00,48,19,29,0,0,0
2021-11-04 23:15,71,43,28,0,0,0
2021-11-04 23:30,29,11,18,0,0,0
2021-11-04 23:45,16,4,12,0,0,0
2021-11-05 00:00,23,7,16,0,0,0
2021-11-05 00:15,23,8,15,0,0,0
2021-11-05 00:30,10,2,8,0,0,0
2021-11-05 00:45,5,4,1,0,0,0
2021-11-05 01:00,4,0,4,0,0,0
2021-11-05 01:15,4,0,4,0,0,0
2021-11-05 01:30,13,6,7,0,0,0
2021-11-05 01:45,1,0,1,0,0,0
2021-11-05 02:00,12,3,9,0,0,0
2021-11-05 02:15,10,1,9,0,0,0
2021-11-05 02:30,6,0,6,0,0,0
2021-11-05 02:45,4,0,4,0,0,0
2021-11-05 03:00,3,0,3,0,0,0
2021-11-05 03:15,1,0,1,0,0,0
2021-11-05 03:30,3,1,2,0,0,0
2021-11-05 03:45,6,0,6,0,0,0
2021-11-05 04:00,4,1,3,0,0,0
2021-11-05 04:15,7,2,5,0,0,0
2021-11-05 04:30,3,2,1,0,0,0
2021-11-05 04:45,5,2,3,0,0,0
2021-11-05 05:00,2,1,1,0,0,0
2021-11-05 05:15,5,4,1,0,0,0
2021-11-05 05:30,14,8,6,0,0,0
2021-11-05 05:45,26,21,5,0,0,0
2021-11-05 06:00,22,13,9,0,0,0
2021-11-05 06:15,31,26,5,0,0,0
2021-11-05 06:30,42,25,17,0,0,0
2021-11-05 06:45,60,34,26,0,0,0
2021-11-05 07:00,80,46,34,0,0,0
2021-11-05 07:15,94,55,39,0,0,0
2021-11-05 07:30,128,78,50,0,0,0
2021-11-05 07:45,191,129,62,0,0,0
2021-11-05 08:00,148,98,50,0,0,0
2021-11-05 08:15,142,90,52,0,0,0
2021-11-05 08:30,116,63,53,0,0,0
2021-11-05 08:45,118,69,49,0,0,0
2021-11-05 09:00,82,49,33,0,0,0
2021-11-05 09:15,93,58,35,0,0,0
2021-11-05 09:30,104,62,42,0,0,0
2021-11-05 09:45,138,86,52,0,0,0
2021-11-05 10:00,107,72,35,0,0,0
2021-11-05 10:15,96,46,50,0,0,0
2021-11-05 10:30,92,46,46,0,0,0
2021-11-05 10:45,115,60,55,0,0,0
2021-11-05 11:00,96,49,47,0,0,0
2021-11-05 11:15,111,49,62,0,0,0
2021-11-05 11:30,145,63,82,0,0,0
2021-11-05 11:45,134,52,82,0,0,0
2021-11-05 12:00,137,51,86,0,0,0
2021-11-05 12:15,149,62,87,0,0,0
2021-11-05 12:30,150,60,90,0,0,0
2021-11-05 12:45,146,67,79,0,0,0
2021-11-05 13:00,161,63,98,0,0,0
2021-11-05 13:15,145,57,88,0,0,0
2021-11-05 13:30,186,68,118,0,0,0
2021-11-05 13:45,177,51,126,0,0,0
2021-11-05 14:00,185,67,118,0,0,0
2021-11-05 14:15,181,72,109,0,0,0
2021-11-05 14:30,191,83,108,0,0,0
2021-11-05 14:45,208,77,131,0,0,0
2021-11-05 15:00,190,70,120,0,0,0
2021-11-05 15:15,178,82,96,0,0,0
2021-11-05 15:30,173,78,95,0,0,0
2021-11-05 15:45,205,86,119,0,0,0
2021-11-05 16:00,168,73,95,0,0,0
2021-11-05 16:15,184,66,118,0,0,0
2021-11-05 16:30,175,63,112,0,0,0
2021-11-05 16:45,171,66,105,0,0,0
2021-11-05 17:00,167,55,112,0,0,0
2021-11-05 17:15,149,54,95,0,0,0
2021-11-05 17:30,183,51,132,0,0,0
2021-11-05 17:45,132,49,83,0,0,0
2021-11-05 18:00,163,47,116,0,0,0
2021-11-05 18:15,171,58,113,0,0,0
2021-11-05 18:30,118,37,81,0,0,0
2021-11-05 18:45,209,58,151,0,0,0
2021-11-05 19:00,125,33,92,0,0,0
2021-11-05 19:15,132,62,70,0,0,0
2021-11-05 19:30,64,28,36,0,0,0
2021-11-05 19:45,87,38,49,0,0,0
2021-11-05 20:00,88,33,55,0,0,0
2021-11-05 20:15,73,32,41,0,0,0
2021-11-05 20:30,60,28,32,0,0,0
2021-11-05 20:45,68,31,37,0,0,0
2021-11-05 21:00,50,17,33,0,0,0
2021-11-05 21:15,53,26,27,0,0,0
2021-11-05 21:30,97,68,29,0,0,0
2021-11-05 21:45,93,61,32,0,0,0
2021-11-05 22:00,80,47,33,0,0,0
2021-11-05 22:15,74,33,41,0,0,0
2021-11-05 22:30,42,15,27,0,0,0
2021-11-05 22:45,46,13,33,0,0,0
2021-11-05 23:00,38,10,28,0,0,0
2021-11-05 23:15,39,19,20,0,0,0
2021-11-05 23:30,54,30,24,0,0,0
2021-11-05 23:45,48,19,29,0,0,0
2021-11-06 00:00,30,17,13,0,0,0
2021-11-06 00:15,30,8,22,0,0,0
2021-11-06 00:30,40,15,25,0,0,0
2021-11-06 00:45,40,14,26,0,0,0
2021-11-06 01:00,24,5,19,0,0,0
2021-11-06 01:15,17,6,11,0,0,0
2021-11-06 01:30,18,2,16,0,0,0
2021-11-06 01:45,11,4,7,0,0,0
2021-11-06 02:00,15,0,15,0,0,0
2021-11-06 02:15,12,2,10,0,0,0
2021-11-06 02:30,25,3,22,0,0,0
2021-11-06 02:45,16,3,13,0,0,0
2021-11-06 03:00,7,2,5,0,0,0
2021-11-06 03:15,16,0,16,0,0,0
2021-11-06 03:30,2,0,2,0,0,0
2021-11-06 03:45,12,4,8,0,0,0
2021-11-06 04:00,6,0,6,0,0,0
2021-11-06 04:15,7,1,6,0,0,0
2021-11-06 04:30,5,0,5,0,0,0
2021-11-06 04:45,4,1,3,0,0,0
2021-11-06 05:00,7,3,4,0,0,0
2021-11-06 05:15,4,1,3,0,0,0
2021-11-06 05:30,8,6,2,0,0,0
2021-11-06 05:45,10,5,5,0,0,0
2021-11-06 06:00,6,5,1,0,0,0
2021-11-06 06:15,6,4,2,0,0,0
2021-11-06 06:30,9,6,3,0,0,0
2021-11-06 06:45,9,5,4,0,0,0
2021-11-06 07:00,10,7,3,0,0,0
2021-11-06 07:15,11,10,1,0,0,0
2021-11-06 07:30,13,10,3,0,0,0
2021-11-06 07:45,22,16,6,0,0,0
2021-11-06 08:00,25,15,10,0,0,0
2021-11-06 08:15,28,17,11,0,0,0
2021-11-06 08:30,57,34,23,0,0,0
2021-11-06 08:45,64,33,31,0,0,0
2021-11-06 09:00,56,33,23,0,0,0
2021-11-06 09:15,64,46,18,0,0,0
2021-11-06 09:30,69,55,14,0,0,0
2021-11-06 09:45,115,83,32,0,0,0
2021-11-06 10:00,105,57,48,0,0,0
2021-11-06 10:15,115,65,50,0,0,0
2021-11-06 10:30,117,77,40,0,0,0
2021-11-06 10:45,131,90,41,0,0,0
2021-11-06 11:00,126,70,56,0,0,0
2021-11-06 11:15,116,72,44,0,0,0
2021-11-06 11:30,150,75,75,0,0,0
2021-11-06 11:45,141,65,76,0,0,0
2021-11-06 12:00,161,83,78,0,0,0
2021-11-06 12:15,165,67,98,0,0,0
2021-11-06 12:30,189,91,98,0,0,0
2021-11-06 12:45,179,98,81,0,0,0
2021-11-06 13:00,134,67,67,0,0,0
2021-11-06 13:15,172,75,97,0,0,0
2021-11-06 13:30,181,75,106,0,0,0
2021-11-06 13:45,156,67,89,0,0,0
2021-11-06 14:00,136,54,82,0,0,0
2021-11-06 14:15,129,61,68,0,0,0
2021-11-06 14:30,151,61,90,0,0,0
2021-11-06 14:45,162,54,108,0,0,0
2021-11-06 15:00,125,53,72,0,0,0
2021-11-06 15:15,132,47,85,0,0,0
2021-11-06 15:30,115,37,78,0,0,0
2021-11-06 15:45,109,45,64,0,0,0
2021-11-06 16:00,119,38,81,0,0,0
2021-11-06 16:15,112,44,68,0,0,0
2021-11-06 16:30,139,58,81,0,0,0
2021-11-06 16:45,93,32,61,0,0,0
2021-11-06 17:00,100,39,61,0,0,0
2021-11-06 17:15,98,31,67,0,0,0
2021-11-06 17:30,101,33,68,0,0,0
2021-11-06 17:45,140,58,82,0,0,0
2021-11-06 18:00,99,33,66,0,0,0
2021-11-06 18:15,126,27,99,0,0,0
2021-11-06 18:30,127,41,86,0,0,0
2021-11-06 18:45,134,40,94,0,0,0
2021-11-06 19:00,105,32,73,0,0,0
2021-11-06 19:15,114,45,69,0,0,0
2021-11-06 19:30,79,46,33,0,0,0
2021-11-06 19:45,103,48,55,0,0,0
2021-11-06 20:00,76,25,51,0,0,0
2021-11-06 20:15,66,22,44,0,0,0
2021-11-06 20:30,52,34,18,0,0,0
2021-11-06 20:45,47,22,25,0,0,0
2021-11-06 21:00,38,14,24,0,0,0
2021-11-06 21:15,29,8,21,0,0,0
2021-11-06 21:30,64,36,28,0,0,0
2021-11-06 21:45,110,97,13,0,0,0
2021-11-06 22:00,66,36,30,0,0,0
2021-11-06 22:15,55,19,36,0,0,0
2021-11-06 22:30,73,30,43,0,0,0
2021-11-06 22:45,36,12,24,0,0,0
2021-11-06 23:00,34,9,25,0,0,0
2021-11-06 23:15,37,10,27,0,0,0
2021-11-06 23:30,28,14,14,0,0,0
2021-11-06 23:45,48,21,27,0,0,0
2021-11-07 00:00,36,6,30,0,0,0
2021-11-07 00:15,44,9,35,0,0,0
2021-11-07 00:30,41,18,23,0,0,0
2021-11-07 00:45,40,14,26,0,0,0
2021-11-07 01:00,38,20,18,0,0,0
2021-11-07 01:15,21,5,16,0,0,0
2021-11-07 01:30,24,3,21,0,0,0
2021-11-07 01:45,37,15,22,0,0,0
2021-11-07 02:00,22,5,17,0,0,0
2021-11-07 02:15,21,5,16,0,0,0
2021-11-07 02:30,21,1,20,0,0,0
2021-11-07 02:45,27,14,13,0,0,0
2021-11-07 03:00,29,10,19,0,0,0
2021-11-07 03:15,15,2,13,0,0,0
2021-11-07 03:30,16,6,10,0,0,0
2021-11-07 03:45,20,2,18,0,0,0
2021-11-07 04:00,11,0,11,0,0,0
2021-11-07 04:15,13,5,8,0,0,0
2021-11-07 04:30,8,4,4,0,0,0
2021-11-07 04:45,4,0,4,0,0,0
2021-11-07 05:00,3,2,1,0,0,0
2021-11-07 05:15,5,2,3,0,0,0
2021-11-07 05:30,7,7,0,0,0,0
2021-11-07 05:45,6,5,1,0,0,0
2021-11-07 06:00,5,3,2,0,0,0
2021-11-07 06:15,1,1,0,0,0,0
2021-11-07 06:30,6,2,4,0,0,0
2021-11-07 06:45,4,1,3,0,0,0
2021-11-07 07:00,1,1,0,0,0,0
2021-11-07 07:15,2,2,0,0,0,0
2021-11-07 07:30,3,3,0,0,0,0
2021-11-07 07:45,6,4,2,0,0,0
2021-11-07 08:00,4,1,3,0,0,0
2021-11-07 08:15,5,5,0,0,0,0
2021-11-07 08:30,9,5,4,0,0,0
2021-11-07 08:45,19,12,7,0,0,0
2021-11-07 09:00,13,6,7,0,0,0
2021-11-07 09:15,36,23,13,0,0,0
2021-11-07 09:30,21,9,12,0,0,0
2021-11-07 09:45,41,31,10,0,0,0
2021-11-07 10:00,37,16,21,0,0,0
2021-11-07 10:15,41,16,25,0,0,0
2021-11-07 10:30,37,26,11,0,0,0
2021-11-07 10:45,36,20,16,0,0,0
2021-11-07 11:00,32,13,19,0,0,0
2021-11-07 11:15,31,15,16,0,0,0
2021-11-07 11:30,47,28,19,0,0,0
2021-11-07 11:45,56,40,16,0,0,0
2021-11-07 12:00,52,25,27,0,0,0
2021-11-07 12:15,53,26,27,0,0,0
2021-11-07 12:30,38,18,20,0,0,0
2021-11-07 12:45,67,40,27,0,0,0
2021-11-07 13:00,64,31,33,0,0,0
2021-11-07 13:15,75,24,51,0,0,0
2021-11-07 13:30,69,32,37,0,0,0
2021-11-07 13:45,67,28,39,0,0,0
2021-11-07 14:00,49,29,20,0,0,0
2021-11-07 14:15,68,23,45,0,0,0
2021-11-07 14:30,68,29,39,0,0,0
2021-11-07 14:45,67,32,35,0,0,0
2021-11-07 15:00,60,28,32,0,0,0
2021-11-07 15:15,66,34,32,0,0,0
2021-11-07 15:30,66,18,48,0,0,0
2021-11-07 15:45,44,22,22,0,0,0
2021-11-07 16:00,54,15,39,0,0,0
2021-11-07 16:15,37,12,25,0,0,0
2021-11-07 16:30,41,13,28,0,0,0
2021-11-07 16:45,55,20,35,0,0,0
2021-11-07 17:00,38,13,25,0,0,0
2021-11-07 17:15,52,22,30,0,0,0
2021-11-07 17:30,49,19,30,0,0,0
2021-11-07 17:45,52,25,27,0,0,0
2021-11-07 18:00,47,15,32,0,0,0
2021-11-07 18:15,49,22,27,0,0,0
2021-11-07 18:30,46,17,29,0,0,0
2021-11-07 18:45,62,24,38,0,0,0
2021-11-07 19:00,43,18,25,0,0,0
2021-11-07 19:15,38,14,24,0,0,0
2021-11-07 19:30,37,17,20,0,0,0
2021-11-07 19:45,45,17,28,0,0,0
2021-11-07 20:00,36,16,20,0,0,0
2021-11-07 20:15,38,20,18,0,0,0
2021-11-07 20:30,21,3,18,0,0,0
2021-11-07 20:45,39,11,28,0,0,0
2021-11-07 21:00,36,13,23,0,0,0
2021-11-07 21:15,29,9,20,0,0,0
2021-11-07 21:30,33,17,16,0,0,0
2021-11-07 21:45,28,2,26,0,0,0
2021-11-07 22:00,27,9,18,0,0,0
2021-11-07 22:15,31,10,21,0,0,0
2021-11-07 22:30,19,2,17,0,0,0
2021-11-07 22:45,12,2,10,0,0,0
2021-11-07 23:00,13,3,10,0,0,0
2021-11-07 23:15,6,3,3,0,0,0
2021-11-07 23:30,6,2,4,0,0,0
2021-11-07 23:45,6,3,3,0,0,0
2021-11-08 00:00,9,2,7,0,0,0
2021-11-08 00:15,2,0,2,0,0,0
2021-11-08 00:30,6,2,4,0,0,0
2021-11-08 00:45,0,0,0,0,0,0
2021-11-08 01:00,2,1,1,0,0,0
2021-11-08 01:15,1,0,1,0,0,0
2021-11-08 01:30,3,2,1,0,0,0
2021-11-08 01:45,3,1,2,0,0,0
2021-11-08 02:00,0,0,0,0,0,0
2021-11-08 02:15,0,0,0,0,0,0
2021-11-08 02:30,1,0,1,0,0,0
2021-11-08 02:45,2,0,2,0,0,0
2021-11-08 03:00,0,0,0,0,0,0
2021-11-08 03:15,2,1,1,0,0,0
2021-11-08 03:30,0,0,0,0,0,0
2021-11-08 03:45,0,0,0,0,0,0
2021-11-08 04:00,0,0,0,0,0,0
2021-11-08 04:15,3,3,0,0,0,0
2021-11-08 04:30,2,2,0,0,0,0
2021-11-08 04:45,1,1,0,0,0,0
2021-11-08 05:00,9,7,2,0,0,0
2021-11-08 05:15,15,7,8,0,0,0
2021-11-08 05:30,16,12,4,0,0,0
2021-11-08 05:45,30,19,11,0,0,0
2021-11-08 06:00,24,18,6,0,0,0
2021-11-08 06:15,39,26,13,0,0,0
2021-11-08 06:30,49,28,21,0,0,0
2021-11-08 06:45,54,43,11,0,0,0
2021-11-08 07:00,81,46,35,0,0,0
2021-11-08 07:15,112,74,38,0,0,0
2021-11-08 07:30,152,101,51,0,0,0
2021-11-08 07:45,216,149,67,0,0,0
2021-11-08 08:00,145,97,48,0,0,0
2021-11-08 08:15,128,83,45,0,0,0
2021-11-08 08:30,127,76,51,0,0,0
2021-11-08 08:45,127,82,45,0,0,0
2021-11-08 09:00,117,77,40,0,0,0
2021-11-08 09:15,93,62,31,0,0,0
2021-11-08 09:30,118,76,42,0,0,0
2021-11-08 09:45,133,91,42,0,0,0
2021-11-08 10:00,116,68,48,0,0,0
2021-11-08 10:15,78,41,37,0,0,0
2021-11-08 10:30,120,70,50,0,0,0
2021-11-08 10:45,108,62,46,0,0,0
2021-11-08 11:00,103,41,62,0,0,0
2021-11-08 11:15,106,41,65,0,0,0
2021-11-08 11:30,111,57,54,0,0,0
2021-11-08 11:45,123,61,62,0,0,0
2021-11-08 12:00,137,64,73,0,0,0
2021-11-08 12:15,127,59,68,0,0,0
2021-11-08 12:30,117,60,57,0,0,0
2021-11-08 12:45,165,65,100,0,0,0
2021-11-08 13:00,140,55,85,0,0,0
2021-11-08 13:15,152,56,96,0,0,0
2021-11-08 13:30,130,49,81,0,0,0
2021-11-08 13:45,170,77,93,0,0,0
2021-11-08 14:00,134,47,87,0,0,0
2021-11-08 14:15,144,65,79,0,0,0
2021-11-08 14:30,146,57,89,0,0,0
2021-11-08 14:45,169,74,95,0,0,0
2021-11-08 15:00,167,62,105,0,0,0
2021-11-08 15:15,192,76,116,0,0,0
2021-11-08 15:30,164,74,90,0,0,0
2021-11-08 15:45,221,102,119,0,0,0
2021-11-08 16:00,215,70,145,0,0,0
2021-11-08 16:15,234,85,149,0,0,0
2021-11-08 16:30,195,67,128,0,0,0
2021-11-08 16:45,226,89,137,0,0,0
2021-11-08 17:00,182,74,108,0,0,0
2021-11-08 17:15,201,67,134,0,0,0
2021-11-08 17:30,191,75,116,0,0,0
2021-11-08 17:45,225,70,155,0,0,0
2021-11-08 18:00,169,54,115,0,0,0
2021-11-08 18:15,187,65,122,0,0,0
2021-11-08 18:30,137,42,95,0,0,0
2021-11-08 18:45,120,41,79,0,0,0
2021-11-08 19:00,120,33,87,0,0,0
2021-11-08 19:15,127,50,77,0,0,0
2021-11-08 19:30,111,41,70,0,0,0
2021-11-08 19:45,119,46,73,0,0,0
2021-11-08 20:00,92,27,65,0,0,0
2021-11-08 20:15,55,19,36,0,0,0
2021-11-08 20:30,58,18,40,0,0,0
2021-11-08 20:45,41,17,24,0,0,0
2021-11-08 21:00,57,24,33,0,0,0
2021-11-08 21:15,54,24,30,0,0,0
2021-11-08 21:30,39,14,25,0,0,0
2021-11-08 21:45,46,16,30,0,0,0
2021-11-08 22:00,61,15,46,0,0,0
2021-11-08 22:15,43,11,32,0,0,0
2021-11-08 22:30,50,14,36,0,0,0
2021-11-08 22:45,24,7,17,0,0,0
2021-11-08 23:00,37,9,28,0,0,0
2021-11-08 23:15,25,5,20,0,0,0
2021-11-08 23:30,17,10,7,0,0,0
2021-11-08 23:45,21,7,14,0,0,0
2021-11-09 00:00,10,2,8,0,0,0
2021-11-09 00:15,17,1,16,0,0,0
2021-11-09 00:30,10,0,10,0,0,0
2021-11-09 00:45,3,2,1,0,0,0
2021-11-09 01:00,2,1,1,0,0,0
2021-11-09 01:15,5,3,2,0,0,0
2021-11-09 01:30,1,1,0,0,0,0
2021-11-09 01:45,1,0,1,0,0,0
2021-11-09 02:00,1,0,1,0,0,0
2021-11-09 02:15,3,0,3,0,0,0
2021-11-09 02:30,2,1,1,0,0,0
2021-11-09 02:45,3,2,1,0,0,0
2021-11-09 03:00,6,0,6,0,0,0
2021-11-09 03:15,0,0,0,0,0,0
2021-11-09 03:30,0,0,0,0,0,0
2021-11-09 03:45,1,0,1,0,0,0
2021-11-09 04:00,2,1,1,0,0,0
2021-11-09 04:15,3,2,1,0,0,0
2021-11-09 04:30,1,1,0,0,0,0
2021-11-09 04:45,5,5,0,0,0,0
2021-11-09 05:00,7,5,2,0,0,0
2021-11-09 05:15,7,4,3,0,0,0
2021-11-09 05:30,17,14,3,0,0,0
2021-11-09 05:45,27,18,9,0,0,0
2021-11-09 06:00,29,18,11,0,0,0
2021-11-09 06:15,32,23,9,0,0,0
2021-11-09 06:30,41,25,16,0,0,0
2021-11-09 06:45,54,41,13,0,0,0
2021-11-09 07:00,85,49,36,0,0,0
2021-11-09 07:15,116,73,43,0,0,0
2021-11-09 07:30,143,86,57,0,0,0
2021-11-09 07:45,226,146,80,0,0,0
2021-11-09 08:00,208,139,69,0,0,0
2021-11-09 08:15,165,110,55,0,0,0
2021-11-09 08:30,122,82,40,0,0,0
2021-11-09 08:45,152,88,64,0,0,0
2021-11-09 09:00,96,60,36,0,0,0
2021-11-09 09:15,115,65,50,0,0,0
2021-11-09 09:30,97,72,25,0,0,0
2021-11-09 09:45,127,84,43,0,0,0
2021-11-09 10:00,96,66,30,0,0,0
2021-11-09 10:15,95,50,45,0,0,0
2021-11-09 10:30,117,71,46,0,0,0
2021-11-09 10:45,124,66,58,0,0,0
2021-11-09 11:00,100,54,46,0,0,0
2021-11-09 11:15,117,60,57,0,0,0
2021-11-09 11:30,93,47,46,0,0,0
2021-11-09 11:45,163,76,87,0,0,0
2021-11-09 12:00,132,68,64,0,0,0
2021-11-09 12:15,131,59,72,0,0,0
2021-11-09 12:30,124,55,69,0,0,0
2021-11-09 12:45,159,76,83,0,0,0
2021-11-09 13:00,147,66,81,0,0,0
2021-11-09 13:15,161,70,91,0,0,0
2021-11-09 13:30,137,63,74,0,0,0
2021-11-09 13:45,170,77,93,0,0,0
2021-11-09 14:00,169,73,96,0,0,0
2021-11-09 14:15,152,61,91,0,0,0
2021-11-09 14:30,154,68,86,0,0,0
2021-11-09 14:45,179,88,91,0,0,0
2021-11-09 15:00,156,59,97,0,0,0
2021-11-09 15:15,177,77,100,0,0,0
2021-11-09 15:30,182,79,103,0,0,0
2021-11-09 15:45,227,111,116,0,0,0
2021-11-09 16:00,235,90,145,0,0,0
2021-11-09 16:15,221,87,134,0,0,0
2021-11-09 16:30,206,80,126,0,0,0
2021-11-09 16:45,232,102,130,0,0,0
2021-11-09 17:00,205,90,115,0,0,0
2021-11-09 17:15,197,73,124,0,0,0
2021-11-09 17:30,188,63,125,0,0,0
2021-11-09 17:45,196,67,129,0,0,0
2021-11-09 18:00,191,60,131,0,0,0
2021-11-09 18:15,171,73,98,0,0,0
2021-11-09 18:30,128,49,79,0,0,0
2021-11-09 18:45,164,74,90,0,0,0
2021-11-09 19:00,147,40,107,0,0,0
2021-11-09 19:15,134,54,80,0,0,0
2021-11-09 19:30,110,37,73,0,0,0
2021-11-09 19:45,123,50,73,0,0,0
2021-11-09 20:00,85,21,64,0,0,0
2021-11-09 20:15,83,31,52,0,0,0
2021-11-09 20:30,51,14,37,0,0,0
2021-11-09 20:45,53,13,40,0,0,0
2021-11-09 21:00,55,13,42,0,0,0
2021-11-09 21:15,59,12,47,0,0,0
2021-11-09 21:30,44,13,31,0,0,0
2021-11-09 21:45,65,28,37,0,0,0
2021-11-09 22:00,60,12,48,0,0,0
2021-11-09 22:15,68,19,49,0,0,0
2021-11-09 22:30,43,13,30,0,0,0
2021-11-09 22:45,46,14,32,0,0,0
2021-11-09 23:00,22,5,17,0,0,0
2021-11-09 23:15,25,7,18,0,0,0
2021-11-09 23:30,22,8,14,0,0,0
2021-11-09 23:45,10,2,8,0,0,0
2021-11-10 00:00,11,3,8,0,0,0
2021-11-10 00:15,12,1,11,0,0,0
2021-11-10 00:30,6,3,3,0,0,0
2021-11-10 00:45,6,3,3,0,0,0
2021-11-10 01:00,8,2,6,0,0,0
2021-11-10 01:15,2,1,1,0,0,0
2021-11-10 01:30,8,0,8,0,0,0
2021-11-10 01:45,1,0,1,0,0,0
2021-11-10 02:00,4,0,4,0,0,0
2021-11-10 02:15,2,0,2,0,0,0
2021-11-10 02:30,3,0,3,0,0,0
2021-11-10 02:45,2,1,1,0,0,0
2021-11-10 03:00,4,0,4,0,0,0
2021-11-10 03:15,1,0,1,0,0,0
2021-11-10 03:30,0,0,0,0,0,0
2021-11-10 03:45,0,0,0,0,0,0
2021-11-10 04:00,1,1,0,0,0,0
2021-11-10 04:15,5,3,2,0,0,0
2021-11-10 04:30,1,1,0,0,0,0
2021-11-10 04:45,4,3,1,0,0,0
2021-11-10 05:00,7,7,0,0,0,0
2021-11-10 05:15,7,6,1,0,0,0
2021-11-10 05:30,12,11,1,0,0,0
2021-11-10 05:45,27,20,7,0,0,0
2021-11-10 06:00,28,17,11,0,0,0
2021-11-10 06:15,32,24,8,0,0,0
2021-11-10 06:30,48,35,13,0,0,0
2021-11-10 06:45,62,40,22,0,0,0
2021-11-10 07:00,94,58,36,0,0,0
2021-11-10 07:15,107,66,41,0,0,0
2021-11-10 07:30,152,104,48,0,0,0
2021-11-10 07:45,232,153,79,0,0,0
2021-11-10 08:00,186,120,66,0,0,0
2021-11-10 08:15,172,102,70,0,0,0
2021-11-10 08:30,111,71,40,0,0,0
2021-11-10 08:45,141,92,49,0,0,0
2021-11-10 09:00,93,53,40,0,0,0
2021-11-10 09:15,121,69,52,0,0,0
2021-11-10 09:30,127,97,30,0,0,0
2021-11-10 09:45,141,95,46,0,0,0
2021-11-10 10:00,103,52,51,0,0,0
2021-11-10 10:15,121,63,58,0,0,0
2021-11-10 10:30,116,59,57,0,0,0
2021-11-10 10:45,120,71,49,0,0,0
2021-11-10 11:00,83,49,34,0,0,0
2021-11-10 11:15,119,57,62,0,0,0
2021-11-10 11:30,127,58,69,0,0,0
2021-11-10 11:45,156,86,70,0,0,0
2021-11-10 12:00,136,59,77,0,0,0
2021-11-10 12:15,137,71,66,0,0,0
2021-11-10 12:30,134,54,80,0,0,0
2021-11-10 12:45,174,79,95,0,0,0
2021-11-10 13:00,180,67,113,0,0,0
2021-11-10 13:15,165,73,92,0,0,0
2021-11-10 13:30,164,71,93,0,0,0
2021-11-10 13:45,189,65,124,0,0,0
2021-11-10 14:00,172,64,108,0,0,0
2021-11-10 14:15,170,56,114,0,0,0
2021-11-10 14:30,160,48,112,0,0,0
2021-11-10 14:45,161,65,96,0,0,0
2021-11-10 15:00,162,61,101,0,0,0
2021-11-10 15:15,180,75,105,0,0,0
2021-11-10 15:30,178,63,115,0,0,0
2021-11-10 15:45,155,66,89,0,0,0
2021-11-10 16:00,217,105,112,0,0,0
2021-11-10 16:15,162,62,100,0,0,0
2021-11-10 16:30,184,63,121,0,0,0
2021-11-10 16:45,187,77,110,0,0,0
2021-11-10 17:00,177,58,119,0,0,0
2021-11-10 17:15,223,93,130,0,0,0
2021-11-10 17:30,149,54,95,0,0,0
2021-11-10 17:45,234,82,152,0,0,0
2021-11-10 18:00,222,88,134,0,0,0
2021-11-10 18:15,132,50,82,0,0,0
2021-11-10 18:30,134,59,75,0,0,0
2021-11-10 18:45,146,61,85,0,0,0
2021-11-10 19:00,107,38,69,0,0,0
2021-11-10 19:15,117,49,68,0,0,0
2021-11-10 19:30,92,25,67,0,0,0
2021-11-10 19:45,117,50,67,0,0,0
2021-11-10 20:00,117,27,90,0,0,0
2021-11-10 20:15,68,25,43,0,0,0
2021-11-10 20:30,59,18,41,0,0,0
2021-11-10 20:45,65,23,42,0,0,0
2021-11-10 21:00,48,17,31,0,0,0
2021-11-10 21:15,38,5,33,0,0,0
2021-11-10 21:30,59,20,39,0,0,0
2021-11-10 21:45,43,11,32,0,0,0
2021-11-10 22:00,58,16,42,0,0,0
2021-11-10 22:15,53,13,40,0,0,0
2021-11-10 22:30,54,18,36,0,0,0
2021-11-10 22:45,45,14,31,0,0,0
2021-11-10 23:00,34,9,25,0,0,0
2021-11-10 23:15,25,3,22,0,0,0
2021-11-10 23:30,24,8,16,0,0,0
2021-11-10 23:45,23,7,16,0,0,0
2021-11-11 00:00,8,2,6,0,0,0
2021-11-11 00:15,7,2,5,0,0,0
2021-11-11 00:30,10,1,9,0,0,0
2021-11-11 00:45,15,5,10,0,0,0
2021-11-11 01:00,3,0,3,0,0,0
2021-11-11 01:15,7,0,7,0,0,0
2021-11-11 01:30,5,0,5,0,0,0
2021-11-11 01:45,7,1,6,0,0,0
2021-11-11 02:00,1,1,0,0,0,0
2021-11-11 02:15,7,3,4,0,0,0
2021-11-11 02:30,5,1,4,0,0,0
2021-11-11 02:45,5,0,5,0,0,0
2021-11-11 03:00,4,1,3,0,0,0
2021-11-11 03:15,3,0,3,0,0,0
2021-11-11 03:30,6,0,6,0,0,0
2021-11-11 03:45,3,2,1,0,0,0
2021-11-11 04:00,3,0,3,0,0,0
2021-11-11 04:15,7,2,5,0,0,0
2021-11-11 04:30,5,1,4,0,0,0
2021-11-11 04:45,4,4,0,0,0,0
2021-11-11 05:00,3,3,0,0,0,0
2021-11-11 05:15,8,5,3,0,0,0
2021-11-11 05:30,13,9,4,0,0,0
2021-11-11 05:45,16,12,4,0,0,0
2021-11-11 06:00,25,16,9,0,0,0
2021-11-11 06:15,26,20,6,0,0,0
2021-11-11 06:30,45,26,19,0,0,0
2021-11-11 06:45,58,38,20,0,0,0
2021-11-11 07:00,77,49,28,0,0,0
2021-11-11 07:15,103,61,42,0,0,0
2021-11-11 07:30,138,84,54,0,0,0
2021-11-11 07:45,201,127,74,0,0,0
2021-11-11 08:00,155,101,54,0,0,0
2021-11-11 08:15,178,109,69,0,0,0
2021-11-11 08:30,109,76,33,0,0,0
2021-11-11 08:45,142,102,40,0,0,0
2021-11-11 09:00,93,53,40,0,0,0
2021-11-11 09:15,94,54,40,0,0,0
2021-11-11 09:30,85,57,28,0,0,0
2021-11-11 09:45,137,87,50,0,0,0
2021-11-11 10:00,103,67,36,0,0,0
2021-11-11 10:15,107,65,42,0,0,0
2021-11-11 10:30,88,49,39,0,0,0
2021-11-11 10:45,109,60,49,0,0,0
2021-11-11 11:00,106,48,58,0,0,0
2021-11-11 11:15,108,53,55,0,0,0
2021-11-11 11:30,125,56,69,0,0,0
2021-11-11 11:45,137,61,76,0,0,0
2021-11-11 12:00,113,46,67,0,0,0
2021-11-11 12:15,122,58,64,0,0,0
2021-11-11 12:30,114,37,77,0,0,0
2021-11-11 12:45,150,58,92,0,0,0
2021-11-11 13:00,134,42,92,0,0,0
2021-11-11 13:15,148,54,94,0,0,0
2021-11-11 13:30,127,64,63,0,0,0
2021-11-11 13:45,161,73,88,0,0,0
2021-11-11 14:00,123,60,63,0,0,0
2021-11-11 14:15,133,46,87,0,0,0
2021-11-11 14:30,148,66,82,0,0,0
2021-11-11 14:45,146,69,77,0,0,0
2021-11-11 15:00,177,74,103,0,0,0
2021-11-11 15:15,171,79,92,0,0,0
2021-11-11 15:30,192,75,117,0,0,0
2021-11-11 15:45,195,77,118,0,0,0
2021-11-11 16:00,225,92,133,0,0,0
2021-11-11 16:15,205,86,119,0,0,0
2021-11-11 16:30,213,77,136,0,0,0
2021-11-11 16:45,177,72,105,0,0,0
2021-11-11 17:00,187,59,128,0,0,0
2021-11-11 17:15,184,75,109,0,0,0
2021-11-11 17:30,153,60,93,0,0,0
2021-11-11 17:45,206,81,125,0,0,0
2021-11-11 18:00,191,59,132,0,0,0
2021-11-11 18:15,192,65,127,0,0,0
2021-11-11 18:30,160,53,107,0,0,0
2021-11-11 18:45,156,48,108,0,0,0
2021-11-11 19:00,118,34,84,0,0,0
2021-11-11 19:15,133,57,76,0,0,0
2021-11-11 19:30,85,32,53,0,0,0
2021-11-11 19:45,99,40,59,0,0,0
2021-11-11 20:00,99,30,69,0,0,0
2021-11-11 20:15,96,35,61,0,0,0
2021-11-11 20:30,82,24,58,0,0,0
2021-11-11 20:45,43,22,21,0,0,0
2021-11-11 21:00,58,26,32,0,0,0
2021-11-11 21:15,51,22,29,0,0,0
2021-11-11 21:30,55,14,41,0,0,0
2021-11-11 21:45,43,15,28,0,0,0
2021-11-11 22:00,66,17,49,0,0,0
2021-11-11 22:15,78,17,61,0,0,0
2021-11-11 22:30,51,17,34,0,0,0
2021-11-11 22:45,33,11,22,0,0,0
2021-11-11 23:00,38,10,28,0,0,0
2021-11-11 23:15,28,8,20,0,0,0
2021-11-11 23:30,39,15,24,0,0,0
2021-11-11 23:45,23,8,15,0,0,0
2021-11-12 00:00,24,9,15,0,0,0
2021-11-12 00:15,15,8,7,0,0,0
2021-11-12 00:30,11,2,9,0,0,0
2021-11-12 00:45,9,0,9,0,0,0
2021-11-12 01:00,9,1,8,0,0,0
2021-11-12 01:15,9,1,8,0,0,0
2021-11-12 01:30,2,0,2,0,0,0
2021-11-12 01:45,7,0,7,0,0,0
2021-11-12 02:00,6,3,3,0,0,0
2021-11-12 02:15,3,0,3,0,0,0
2021-11-12 02:30,8,4,4,0,0,0
2021-11-12 02:45,1,0,1,0,0,0
2021-11-12 03:00,0,0,0,0,0,0
2021-11-12 03:15,0,0,0,0,0,0
2021-11-12 03:30,3,1,2,0,0,0
2021-11-12 03:45,0,0,0,0,0,0
2021-11-12 04:00,0,0,0,0,0,0
2021-11-12 04:15,4,2,2,0,0,0
2021-11-12 04:30,6,5,1,0,0,0
2021-11-12 04:45,4,3,1,0,0,0
2021-11-12 05:00,5,3,2,0,0,0
2021-11-12 05:15,6,5,1,0,0,0
2021-11-12 05:30,16,11,5,0,0,0
2021-11-12 05:45,18,12,6,0,0,0
2021-11-12 06:00,19,17,2,0,0,0
2021-11-12 06:15,33,20,13,0,0,0
2021-11-12 06:30,56,38,18,0,0,0
2021-11-12 06:45,39,26,13,0,0,0
2021-11-12 07:00,72,40,32,0,0,0
2021-11-12 07:15,99,71,28,0,0,0
2021-11-12 07:30,135,87,48,0,0,0
2021-11-12 07:45,183,115,68,0,0,0
2021-11-12 08:00,139,98,41,0,0,0
2021-11-12 08:15,138,85,53,0,0,0
2021-11-12 08:30,124,81,43,0,0,0
2021-11-12 08:45,135,85,50,0,0,0
2021-11-12 09:00,89,56,33,0,0,0
2021-11-12 09:15,96,64,32,0,0,0
2021-11-12 09:30,100,71,29,0,0,0
2021-11-12 09:45,125,86,39,0,0,0
2021-11-12 10:00,112,65,47,0,0,0
2021-11-12 10:15,82,52,30,0,0,0
2021-11-12 10:30,112,61,51,0,0,0
2021-11-12 10:45,111,60,51,0,0,0
2021-11-12 11:00,125,63,62,0,0,0
2021-11-12 11:15,135,62,73,0,0,0
2021-11-12 11:30,115,52,63,0,0,0
2021-11-12 11:45,160,70,90,0,0,0
2021-11-12 12:00,142,55,87,0,0,0
2021-11-12 12:15,147,72,75,0,0,0
2021-11-12 12:30,154,58,96,0,0,0
2021-11-12 12:45,163,66,97,0,0,0
2021-11-12 13:00,184,75,109,0,0,0
2021-11-12 13:15,146,60,86,0,0,0
2021-11-12 13:30,171,59,112,0,0,0
2021-11-12 13:45,157,63,94,0,0,0
2021-11-12 14:00,191,73,118,0,0,0
2021-11-12 14:15,195,77,118,0,0,0
2021-11-12 14:30,171,74,97,0,0,0
2021-11-12 14:45,223,104,119,0,0,0
2021-11-12 15:00,183,72,111,0,0,0
2021-11-12 15:15,202,84,118,0,0,0
2021-11-12 15:30,157,61,96,0,0,0
2021-11-12 15:45,207,81,126,0,0,0
2021-11-12 16:00,196,76,120,0,0,0
2021-11-12 16:15,190,84,106,0,0,0
2021-11-12 16:30,187,68,119,0,0,0
2021-11-12 16:45,180,72,108,0,0,0
2021-11-12 17:00,162,62,100,0,0,0
2021-11-12 17:15,162,65,97,0,0,0
2021-11-12 17:30,139,55,84,0,0,0
2021-11-12 17:45,158,61,97,0,0,0
2021-11-12 18:00,158,70,88,0,0,0
2021-11-12 18:15,162,71,91,0,0,0
2021-11-12 18:30,143,49,94,0,0,0
2021-11-12 18:45,120,44,76,0,0,0
2021-11-12 19:00,121,48,73,0,0,0
2021-11-12 19:15,121,46,75,0,0,0
2021-11-12 19:30,70,33,37,0,0,0
2021-11-12 19:45,104,52,52,0,0,0
2021-11-12 20:00,114,58,56,0,0,0
2021-11-12 20:15,71,40,31,0,0,0
2021-11-12 20:30,60,26,34,0,0,0
2021-11-12 20:45,62,25,37,0,0,0
2021-11-12 21:00,62,31,31,0,0,0
2021-11-12 21:15,72,13,59,0,0,0
2021-11-12 21:30,45,19,26,0,0,0
2021-11-12 21:45,61,25,36,0,0,0
2021-11-12 22:00,49,11,38,0,0,0
2021-11-12 22:15,64,19,45,0,0,0
2021-11-12 22:30,37,12,25,0,0,0
2021-11-12 22:45,49,15,34,0,0,0
2021-11-12 23:00,39,10,29,0,0,0
2021-11-12 23:15,53,14,39,0,0,0
2021-11-12 23:30,56,20,36,0,0,0
2021-11-12 23:45,53,17,36,0,0,0
2021-11-13 00:00,42,13,29,0,0,0
2021-11-13 00:15,41,17,24,0,0,0
2021-11-13 00:30,43,18,25,0,0,0
2021-11-13 00:45,33,7,26,0,0,0
2021-11-13 01:00,30,12,18,0,0,0
2021-11-13 01:15,31,14,17,0,0,0
2021-11-13 01:30,9,3,6,0,0,0
2021-11-13 01:45,15,3,12,0,0,0
2021-11-13 02:00,15,1,14,0,0,0
2021-11-13 02:15,17,6,11,0,0,0
2021-11-13 02:30,10,4,6,0,0,0
2021-11-13 02:45,13,4,9,0,0,0
2021-11-13 03:00,8,3,5,0,0,0
2021-11-13 03:15,13,2,11,0,0,0
2021-11-13 03:30,11,2,9,0,0,0
2021-11-13 03:45,16,8,8,0,0,0
2021-11-13 04:00,11,3,8,0,0,0
2021-11-13 04:15,3,0,3,0,0,0
2021-11-13 04:30,6,1,5,0,0,0
2021-11-13 04:45,8,4,4,0,0,0
2021-11-13 05:00,7,3,4,0,0,0
2021-11-13 05:15,6,1,5,0,0,0
2021-11-13 05:30,11,5,6,0,0,0
2021-11-13 05:45,9,8,1,0,0,0
2021-11-13 06:00,5,3,2,0,0,0
2021-11-13 06:15,8,3,5,0,0,0
2021-11-13 06:30,9,6,3,0,0,0
2021-11-13 06:45,6,3,3,0,0,0
2021-11-13 07:00,10,8,2,0,0,0
2021-11-13 07:15,8,4,4,0,0,0
2021-11-13 07:30,27,14,13,0,0,0
2021-11-13 07:45,21,13,8,0,0,0
2021-11-13 08:00,21,12,9,0,0,0
2021-11-13 08:15,18,9,9,0,0,0
2021-11-13 08:30,40,24,16,0,0,0
2021-11-13 08:45,64,36,28,0,0,0
2021-11-13 09:00,36,24,12,0,0,0
2021-11-13 09:15,65,43,22,0,0,0
2021-11-13 09:30,59,38,21,0,0,0
2021-11-13 09:45,87,67,20,0,0,0
2021-11-13 10:00,70,49,21,0,0,0
2021-11-13 10:15,79,56,23,0,0,0
2021-11-13 10:30,89,53,36,0,0,0
2021-11-13 10:45,120,72,48,0,0,0
2021-11-13 11:00,90,56,34,0,0,0
2021-11-13 11:15,102,63,39,0,0,0
2021-11-13 11:30,145,78,67,0,0,0
2021-11-13 11:45,142,83,59,0,0,0
2021-11-13 12:00,152,79,73,0,0,0
2021-11-13 12:15,133,63,70,0,0,0
2021-11-13 12:30,184,88,96,0,0,0
2021-11-13 12:45,151,62,89,0,0,0
2021-11-13 13:00,191,63,128,0,0,0
2021-11-13 13:15,182,52,130,0,0,0
2021-11-13 13:30,169,51,118,0,0,0
2021-11-13 13:45,137,65,72,0,0,0
2021-11-13 14:00,133,67,66,0,0,0
2021-11-13 14:15,146,48,98,0,0,0
2021-11-13 14:30,121,55,66,0,0,0
2021-11-13 14:45,120,51,69,0,0,0
2021-11-13 15:00,119,50,69,0,0,0
2021-11-13 15:15,116,49,67,0,0,0
2021-11-13 15:30,101,40,61,0,0,0
2021-11-13 15:45,106,40,66,0,0,0
2021-11-13 16:00,146,75,71,0,0,0
2021-11-13 16:15,211,130,81,0,0,0
2021-11-13 16:30,165,89,76,0,0,0
2021-11-13 16:45,119,58,61,0,0,0
2021-11-13 17:00,100,49,51,0,0,0
2021-11-13 17:15,106,41,65,0,0,0
2021-11-13 17:30,115,43,72,0,0,0
2021-11-13 17:45,104,48,56,0,0,0
2021-11-13 18:00,99,34,65,0,0,0
2021-11-13 18:15,104,36,68,0,0,0
2021-11-13 18:30,139,42,97,0,0,0
2021-11-13 18:45,93,55,38,0,0,0
2021-11-13 19:00,93,40,53,0,0,0
2021-11-13 19:15,87,49,38,0,0,0
2021-11-13 19:30,90,48,42,0,0,0
2021-11-13 19:45,77,44,33,0,0,0
2021-11-13 20:00,87,32,55,0,0,0
2021-11-13 20:15,80,34,46,0,0,0
2021-11-13 20:30,52,20,32,0,0,0
2021-11-13 20:45,66,29,37,0,0,0
2021-11-13 21:00,53,26,27,0,0,0
2021-11-13 21:15,83,47,36,0,0,0
2021-11-13 21:30,35,27,8,0,0,0
2021-11-13 21:45,42,15,27,0,0,0
2021-11-13 22:00,49,24,25,0,0,0
2021-11-13 22:15,32,9,23,0,0,0
2021-11-13 22:30,34,10,24,0,0,0
2021-11-13 22:45,38,24,14,0,0,0
2021-11-13 23:00,51,34,17,0,0,0
2021-11-13 23:15,33,7,26,0,0,0
2021-11-13 23:30,47,16,31,0,0,0
2021-11-13 23:45,26,10,16,0,0,0
2021-11-14 00:00,41,19,22,0,0,0
2021-11-14 00:15,37,16,21,0,0,0
2021-11-14 00:30,19,8,11,0,0,0
2021-11-14 00:45,19,8,11,0,0,0
2021-11-14 01:00,31,11,20,0,0,0
2021-11-14 01:15,38,17,21,0,0,0
2021-11-14 01:30,27,13,14,0,0,0
2021-11-14 01:45,24,11,13,0,0,0
2021-11-14 02:00,38,14,24,0,0,0
2021-11-14 02:15,24,10,14,0,0,0
2021-11-14 02:30,23,10,13,0,0,0
2021-11-14 02:45,18,6,12,0,0,0
2021-11-14 03:00,17,10,7,0,0,0
2021-11-14 03:15,17,8,9,0,0,0
2021-11-14 03:30,12,1,11,0,0,0
2021-11-14 03:45,9,5,4,0,0,0
2021-11-14 04:00,16,2,14,0,0,0
2021-11-14 04:15,14,7,7,0,0,0
2021-11-14 04:30,7,2,5,0,0,0
2021-11-14 04:45,6,3,3,0,0,0
2021-11-14 05:00,5,4,1,0,0,0
2021-11-14 05:15,10,3,7,0,0,0
2021-11-14 05:30,7,4,3,0,0,0
2021-11-14 05:45,11,6,5,0,0,0
2021-11-14 06:00,3,2,1,0,0,0
2021-11-14 06:15,7,3,4,0,0,0
2021-11-14 06:30,3,1,2,0,0,0
2021-11-14 06:45,3,0,3,0,0,0
2021-11-14 07:00,5,1,4,0,0,0
2021-11-14 07:15,8,4,4,0,0,0
2021-11-14 07:30,11,7,4,0,0,0
2021-11-14 07:45,7,5,2,0,0,0
2021-11-14 08:00,12,7,5,0,0,0
2021-11-14 08:15,2,2,0,0,0,0
2021-11-14 08:30,12,6,6,0,0,0
2021-11-14 08:45,28,21,7,0,0,0
2021-11-14 09:00,12,7,5,0,0,0
2021-11-14 09:15,34,16,18,0,0,0
2021-11-14 09:30,17,12,5,0,0,0
2021-11-14 09:45,51,28,23,0,0,0
2021-11-14 10:00,40,20,20,0,0,0
2021-11-14 10:15,49,24,25,0,0,0
2021-11-14 10:30,29,13,16,0,0,0
2021-11-14 10:45,63,37,26,0,0,0
2021-11-14 11:00,44,25,19,0,0,0
2021-11-14 11:15,37,14,23,0,0,0
2021-11-14 11:30,39,23,16,0,0,0
2021-11-14 11:45,37,16,21,0,0,0
2021-11-14 12:00,38,19,19,0,0,0
2021-11-14 12:15,63,33,30,0,0,0
2021-11-14 12:30,40,20,20,0,0,0
2021-11-14 12:45,59,31,28,0,0,0
2021-11-14 13:00,59,30,29,0,0,0
2021-11-14 13:15,75,43,32,0,0,0
2021-11-14 13:30,66,37,29,0,0,0
2021-11-14 13:45,66,35,31,0,0,0
2021-11-14 14:00,70,34,36,0,0,0
2021-11-14 14:15,54,25,29,0,0,0
2021-11-14 14:30,80,36,44,0,0,0
2021-11-14 14:45,55,32,23,0,0,0
2021-11-14 15:00,68,29,39,0,0,0
2021-11-14 15:15,68,30,38,0,0,0
2021-11-14 15:30,85,47,38,0,0,0
2021-11-14 15:45,86,39,47,0,0,0
2021-11-14 16:00,81,29,52,0,0,0
2021-11-14 16:15,72,36,36,0,0,0
2021-11-14 16:30,77,29,48,0,0,0
2021-11-14 16:45,82,38,44,0,0,0
2021-11-14 17:00,61,28,33,0,0,0
2021-11-14 17:15,62,20,42,0,0,0
2021-11-14 17:30,68,30,38,0,0,0
2021-11-14 17:45,64,28,36,0,0,0
2021-11-14 18:00,58,29,29,0,0,0
2021-11-14 18:15,59,24,35,0,0,0
2021-11-14 18:30,49,16,33,0,0,0
2021-11-14 18:45,66,26,40,0,0,0
2021-11-14 19:00,54,12,42,0,0,0
2021-11-14 19:15,27,11,16,0,0,0
2021-11-14 19:30,34,14,20,0,0,0
2021-11-14 19:45,43,15,28,0,0,0
2021-11-14 20:00,42,21,21,0,0,0
2021-11-14 20:15,35,12,23,0,0,0
2021-11-14 20:30,37,18,19,0,0,0
2021-11-14 20:45,38,18,20,0,0,0
2021-11-14 21:00,31,11,20,0,0,0
2021-11-14 21:15,21,10,11,0,0,0
2021-11-14 21:30,21,11,10,0,0,0
2021-11-14 21:45,25,6,19,0,0,0
2021-11-14 22:00,13,5,8,0,0,0
2021-11-14 22:15,28,8,20,0,0,0
2021-11-14 22:30,22,11,11,0,0,0
2021-11-14 22:45,17,7,10,0,0,0
2021-11-14 23:00,9,1,8,0,0,0
2021-11-14 23:15,16,8,8,0,0,0
2021-11-14 23:30,15,11,4,0,0,0
2021-11-14 23:45,9,0,9,0,0,0
2021-11-15 00:00,8,3,5,0,0,0
2021-11-15 00:15,3,0,3,0,0,0
2021-11-15 00:30,3,1,2,0,0,0
2021-11-15 00:45,2,0,2,0,0,0
2021-11-15 01:00,4,2,2,0,0,0
2021-11-15 01:15,0,0,0,0,0,0
2021-11-15 01:30,1,0,1,0,0,0
2021-11-15 01:45,1,0,1,0,0,0
2021-11-15 02:00,0,0,0,0,0,0
2021-11-15 02:15,0,0,0,0,0,0
2021-11-15 02:30,0,0,0,0,0,0
2021-11-15 02:45,0,0,0,0,0,0
2021-11-15 03:00,1,0,1,0,0,0
2021-11-15 03:15,0,0,0,0,0,0
2021-11-15 03:30,1,1,0,0,0,0
2021-11-15 03:45,0,0,0,0,0,0
2021-11-15 04:00,2,2,0,0,0,0
2021-11-15 04:15,1,1,0,0,0,0
2021-11-15 04:30,2,1,1,0,0,0
2021-11-15 04:45,6,5,1,0,0,0
2021-11-15 05:00,7,7,0,0,0,0
2021-11-15 05:15,9,7,2,0,0,0
2021-11-15 05:30,23,15,8,0,0,0
2021-11-15 05:45,31,26,5,0,0,0
2021-11-15 06:00,23,14,9,0,0,0
2021-11-15 06:15,34,24,10,0,0,0
2021-11-15 06:30,45,31,14,0,0,0
2021-11-15 06:45,51,35,16,0,0,0
2021-11-15 07:00,92,51,41,0,0,0
2021-11-15 07:15,107,73,34,0,0,0
2021-11-15 07:30,132,89,43,0,0,0
2021-11-15 07:45,215,137,78,0,0,0
2021-11-15 08:00,170,107,63,0,0,0
2021-11-15 08:15,138,90,48,0,0,0
2021-11-15 08:30,112,70,42,0,0,0
2021-11-15 08:45,125,90,35,0,0,0
2021-11-15 09:00,92,64,28,0,0,0
2021-11-15 09:15,98,66,32,0,0,0
2021-11-15 09:30,107,73,34,0,0,0
2021-11-15 09:45,126,85,41,0,0,0
2021-11-15 10:00,102,65,37,0,0,0
2021-11-15 10:15,108,60,48,0,0,0
2021-11-15 10:30,85,57,28,0,0,0
2021-11-15 10:45,107,56,51,0,0,0
2021-11-15 11:00,96,44,52,0,0,0
2021-11-15 11:15,104,54,50,0,0,0
2021-11-15 11:30,112,54,58,0,0,0
2021-11-15 11:45,121,56,65,0,0,0
2021-11-15 12:00,137,58,79,0,0,0
2021-11-15 12:15,126,62,64,0,0,0
2021-11-15 12:30,111,50,61,0,0,0
2021-11-15 12:45,132,45,87,0,0,0
2021-11-15 13:00,143,57,86,0,0,0
2021-11-15 13:15,112,43,69,0,0,0
2021-11-15 13:30,136,60,76,0,0,0
2021-11-15 13:45,135,55,80,0,0,0
2021-11-15 14:00,131,46,85,0,0,0
2021-11-15 14:15,124,51,73,0,0,0
2021-11-15 14:30,127,51,76,0,0,0
2021-11-15 14:45,139,65,74,0,0,0
2021-11-15 15:00,142,60,82,0,0,0
2021-11-15 15:15,143,58,85,0,0,0
2021-11-15 15:30,158,62,96,0,0,0
2021-11-15 15:45,211,97,114,0,0,0
2021-11-15 16:00,230,95,135,0,0,0
2021-11-15 16:15,198,87,111,0,0,0
2021-11-15 16:30,155,59,96,0,0,0
2021-11-15 16:45,169,67,102,0,0,0
2021-11-15 17:00,188,63,125,0,0,0
2021-11-15 17:15,195,68,127,0,0,0
2021-11-15 17:30,214,65,149,0,0,0
2021-11-15 17:45,210,74,136,0,0,0
2021-11-15 18:00,197,59,138,0,0,0
2021-11-15 18:15,164,58,106,0,0,0
2021-11-15 18:30,135,42,93,0,0,0
2021-11-15 18:45,120,50,70,0,0,0
2021-11-15 19:00,123,44,79,0,0,0
2021-11-15 19:15,102,42,60,0,0,0
2021-11-15 19:30,94,36,58,0,0,0
2021-11-15 19:45,107,44,63,0,0,0
2021-11-15 20:00,79,22,57,0,0,0
2021-11-15 20:15,61,22,39,0,0,0
2021-11-15 20:30,47,18,29,0,0,0
2021-11-15 20:45,37,17,20,0,0,0
2021-11-15 21:00,37,14,23,0,0,0
2021-11-15 21:15,64,24,40,0,0,0
2021-11-15 21:30,53,21,32,0,0,0
2021-11-15 21:45,56,19,37,0,0,0
2021-11-15 22:00,40,14,26,0,0,0
2021-11-15 22:15,55,20,35,0,0,0
2021-11-15 22:30,29,9,20,0,0,0
2021-11-15 22:45,12,2,10,0,0,0
2021-11-15 23:00,34,11,23,0,0,0
2021-11-15 23:15,26,4,22,0,0,0
2021-11-15 23:30,18,5,13,0,0,0
2021-11-15 23:45,15,7,8,0,0,0
2021-11-16 00:00,10,5,5,0,0,0
2021-11-16 00:15,11,3,8,0,0,0
2021-11-16 00:30,5,1,4,0,0,0
2021-11-16 00:45,3,1,2,0,0,0
2021-11-16 01:00,4,2,2,0,0,0
2021-11-16 01:15,9,0,9,0,0,0
2021-11-16 01:30,3,0,3,0,0,0
2021-11-16 01:45,3,2,1,0,0,0
2021-11-16 02:00,0,0,0,0,0,0
2021-11-16 02:15,0,0,0,0,0,0
2021-11-16 02:30,1,0,1,0,0,0
2021-11-16 02:45,1,1,0,0,0,0
2021-11-16 03:00,5,3,2,0,0,0
2021-11-16 03:15,1,0,1,0,0,0
2021-11-16 03:30,0,0,0,0,0,0
2021-11-16 03:45,0,0,0,0,0,0
2021-11-16 04:00,0,0,0,0,0,0
2021-11-16 04:15,2,2,0,0,0,0
2021-11-16 04:30,4,3,1,0,0,0
2021-11-16 04:45,4,4,0,0,0,0
2021-11-16 05:00,6,6,0,0,0,0
2021-11-16 05:15,10,5,5,0,0,0
2021-11-16 05:30,19,14,5,0,0,0
2021-11-16 05:45,32,26,6,0,0,0
2021-11-16 06:00,21,14,7,0,0,0
2021-11-16 06:15,26,18,8,0,0,0
2021-11-16 06:30,51,32,19,0,0,0
2021-11-16 06:45,63,40,23,0,0,0
2021-11-16 07:00,85,52,33,0,0,0
2021-11-16 07:15,103,69,34,0,0,0
2021-11-16 07:30,172,108,64,0,0,0
2021-11-16 07:45,222,149,73,0,0,0
2021-11-16 08:00,167,110,57,0,0,0
2021-11-16 08:15,153,104,49,0,0,0
2021-11-16 08:30,97,60,37,0,0,0
2021-11-16 08:45,134,89,45,0,0,0
2021-11-16 09:00,84,56,28,0,0,0
2021-11-16 09:15,91,58,33,0,0,0
2021-11-16 09:30,86,56,30,0,0,0
2021-11-16 09:45,123,85,38,0,0,0
2021-11-16 10:00,105,62,43,0,0,0
2021-11-16 10:15,103,62,41,0,0,0
2021-11-16 10:30,113,60,53,0,0,0
2021-11-16 10:45,125,67,58,0,0,0
2021-11-16 11:00,96,49,47,0,0,0
2021-11-16 11:15,103,49,54,0,0,0
2021-11-16 11:30,99,42,57,0,0,0
2021-11-16 11:45,143,66,77,0,0,0
2021-11-16 12:00,121,47,74,0,0,0
2021-11-16 12:15,126,60,66,0,0,0
2021-11-16 12:30,125,55,70,0,0,0
2021-11-16 12:45,168,59,109,0,0,0
2021-11-16 13:00,123,38,85,0,0,0
2021-11-16 13:15,134,46,88,0,0,0
2021-11-16 13:30,123,42,81,0,0,0
2021-11-16 13:45,141,71,70,0,0,0
2021-11-16 14:00,155,60,95,0,0,0
2021-11-16 14:15,133,56,77,0,0,0
2021-11-16 14:30,142,57,85,0,0,0
2021-11-16 14:45,159,77,82,0,0,0
2021-11-16 15:00,135,59,76,0,0,0
2021-11-16 15:15,158,73,85,0,0,0
2021-11-16 15:30,208,75,133,0,0,0
2021-11-16 15:45,198,93,105,0,0,0
2021-11-16 16:00,184,73,111,0,0,0
2021-11-16 16:15,190,73,117,0,0,0
2021-11-16 16:30,167,54,113,0,0,0
2021-11-16 16:45,188,75,113,0,0,0
2021-11-16 17:00,168,61,107,0,0,0
2021-11-16 17:15,173,60,113,0,0,0
2021-11-16 17:30,151,44,107,0,0,0
2021-11-16 17:45,195,67,128,0,0,0
2021-11-16 18:00,189,48,141,0,0,0
2021-11-16 18:15,171,66,105,0,0,0
2021-11-16 18:30,121,39,82,0,0,0
2021-11-16 18:45,129,42,87,0,0,0
2021-11-16 19:00,134,42,92,0,0,0
2021-11-16 19:15,104,34,70,0,0,0
2021-11-16 19:30,99,31,68,0,0,0
2021-11-16 19:45,83,25,58,0,0,0
2021-11-16 20:00,80,35,45,0,0,0
2021-11-16 20:15,92,33,59,0,0,0
2021-11-16 20:30,39,13,26,0,0,0
2021-11-16 20:45,40,12,28,0,0,0
2021-11-16 21:00,51,15,36,0,0,0
2021-11-16 21:15,51,7,44,0,0,0
2021-11-16 21:30,52,20,32,0,0,0
2021-11-16 21:45,54,20,34,0,0,0
2021-11-16 22:00,54,16,38,0,0,0
2021-11-16 22:15,28,9,19,0,0,0
2021-11-16 22:30,36,12,24,0,0,0
2021-11-16 22:45,31,6,25,0,0,0
2021-11-16 23:00,36,9,27,0,0,0
2021-11-16 23:15,18,6,12,0,0,0
2021-11-16 23:30,24,9,15,0,0,0
2021-11-16 23:45,11,5,6,0,0,0
2021-11-17 00:00,23,8,15,0,0,0
2021-11-17 00:15,10,4,6,0,0,0
2021-11-17 00:30,9,0,9,0,0,0
2021-11-17 00:45,11,2,9,0,0,0
2021-11-17 01:00,7,2,5,0,0,0
2021-11-17 01:15,8,1,7,0,0,0
2021-11-17 01:30,6,5,1,0,0,0
2021-11-17 01:45,5,0,5,0,0,0
2021-11-17 02:00,2,2,0,0,0,0
2021-11-17 02:15,3,2,1,0,0,0
2021-11-17 02:30,1,1,0,0,0,0
2021-11-17 02:45,1,0,1,0,0,0
2021-11-17 03:00,0,0,0,0,0,0
2021-11-17 03:15,1,1,0,0,0,0
2021-11-17 03:30,4,0,4,0,0,0
2021-11-17 03:45,1,1,0,0,0,0
2021-11-17 04:00,1,1,0,0,0,0
2021-11-17 04:15,4,1,3,0,0,0
2021-11-17 04:30,2,2,0,0,0,0
2021-11-17 04:45,3,1,2,0,0,0
2021-11-17 05:00,5,5,0,0,0,0
2021-11-17 05:15,9,4,5,0,0,0
2021-11-17 05:30,18,12,6,0,0,0
2021-11-17 05:45,34,23,11,0,0,0
2021-11-17 06:00,21,14,7,0,0,0
2021-11-17 06:15,32,18,14,0,0,0
2021-11-17 06:30,44,36,8,0,0,0
2021-11-17 06:45,53,33,20,0,0,0
2021-11-17 07:00,63,38,25,0,0,0
2021-11-17 07:15,105,71,34,0,0,0
2021-11-17 07:30,149,97,52,0,0,0
2021-11-17 07:45,193,122,71,0,0,0
2021-11-17 08:00,169,114,55,0,0,0
2021-11-17 08:15,129,87,42,0,0,0
2021-11-17 08:30,113,80,33,0,0,0
2021-11-17 08:45,141,98,43,0,0,0
2021-11-17 09:00,109,65,44,0,0,0
2021-11-17 09:15,88,62,26,0,0,0
2021-11-17 09:30,94,59,35,0,0,0
2021-11-17 09:45,125,78,47,0,0,0
2021-11-17 10:00,92,56,36,0,0,0
2021-11-17 10:15,119,56,63,0,0,0
2021-11-17 10:30,91,48,43,0,0,0
2021-11-17 10:45,123,71,52,0,0,0
2021-11-17 11:00,82,47,35,0,0,0
2021-11-17 11:15,119,54,65,0,0,0
2021-11-17 11:30,107,52,55,0,0,0
2021-11-17 11:45,160,70,90,0,0,0
2021-11-17 12:00,146,68,78,0,0,0
2021-11-17 12:15,139,59,80,0,0,0
2021-11-17 12:30,118,43,75,0,0,0
2021-11-17 12:45,132,39,93,0,0,0
2021-11-17 13:00,119,36,83,0,0,0
2021-11-17 13:15,129,49,80,0,0,0
2021-11-17 13:30,107,37,70,0,0,0
2021-11-17 13:45,138,65,73,0,0,0
2021-11-17 14:00,127,43,84,0,0,0
2021-11-17 14:15,107,36,71,0,0,0
2021-11-17 14:30,155,59,96,0,0,0
2021-11-17 14:45,157,62,95,0,0,0
2021-11-17 15:00,138,51,87,0,0,0
2021-11-17 15:15,132,53,79,0,0,0
2021-11-17 15:30,140,60,80,0,0,0
2021-11-17 15:45,182,79,103,0,0,0
2021-11-17 16:00,195,79,116,0,0,0
2021-11-17 16:15,185,68,117,0,0,0
2021-11-17 16:30,170,54,116,0,0,0
2021-11-17 16:45,184,73,111,0,0,0
2021-11-17 17:00,172,68,104,0,0,0
2021-11-17 17:15,178,70,108,0,0,0
2021-11-17 17:30,160,52,108,0,0,0
2021-11-17 17:45,215,89,126,0,0,0
2021-11-17 18:00,173,59,114,0,0,0
2021-11-17 18:15,185,71,114,0,0,0
2021-11-17 18:30,135,50,85,0,0,0
2021-11-17 18:45,137,58,79,0,0,0
2021-11-17 19:00,134,41,93,0,0,0
2021-11-17 19:15,89,29,60,0,0,0
2021-11-17 19:30,85,26,59,0,0,0
2021-11-17 19:45,107,42,65,0,0,0
2021-11-17 20:00,93,38,55,0,0,0
2021-11-17 20:15,61,25,36,0,0,0
2021-11-17 20:30,49,12,37,0,0,0
2021-11-17 20:45,54,19,35,0,0,0
2021-11-17 21:00,47,23,24,0,0,0
2021-11-17 21:15,72,21,51,0,0,0
2021-11-17 21:30,68,25,43,0,0,0
2021-11-17 21:45,48,18,30,0,0,0
2021-11-17 22:00,72,28,44,0,0,0
2021-11-17 22:15,45,10,35,0,0,0
2021-11-17 22:30,46,7,39,0,0,0
2021-11-17 22:45,41,13,28,0,0,0
2021-11-17 23:00,18,3,15,0,0,0
2021-11-17 23:15,42,22,20,0,0,0
2021-11-17 23:30,28,12,16,0,0,0
2021-11-17 23:45,30,9,21,0,0,0
2021-11-18 00:00,15,5,10,0,0,0
2021-11-18 00:15,16,8,8,0,0,0
2021-11-18 00:30,23,13,10,0,0,0
2021-11-18 00:45,5,2,3,0,0,0
2021-11-18 01:00,16,10,6,0,0,0
2021-11-18 01:15,2,0,2,0,0,0
2021-11-18 01:30,0,0,0,0,0,0
2021-11-18 01:45,2,0,2,0,0,0
2021-11-18 02:00,1,0,1,0,0,0
2021-11-18 02:15,2,0,2,0,0,0
2021-11-18 02:30,4,0,4,0,0,0
2021-11-18 02:45,3,0,3,0,0,0
2021-11-18 03:00,1,0,1,0,0,0
2021-11-18 03:15,4,2,2,0,0,0
2021-11-18 03:30,6,0,6,0,0,0
2021-11-18 03:45,4,0,4,0,0,0
2021-11-18 04:00,1,0,1,0,0,0
2021-11-18 04:15,3,2,1,0,0,0
2021-11-18 04:30,8,1,7,0,0,0
2021-11-18 04:45,3,2,1,0,0,0
2021-11-18 05:00,7,6,1,0,0,0
2021-11-18 05:15,10,7,3,0,0,0
2021-11-18 05:30,21,12,9,0,0,0
2021-11-18 05:45,22,16,6,0,0,0
2021-11-18 06:00,24,15,9,0,0,0
2021-11-18 06:15,35,26,9,0,0,0
2021-11-18 06:30,47,30,17,0,0,0
2021-11-18 06:45,49,30,19,0,0,0
2021-11-18 07:00,66,38,28,0,0,0
2021-11-18 07:15,84,59,25,0,0,0
2021-11-18 07:30,118,85,33,0,0,0
2021-11-18 07:45,185,111,74,0,0,0
2021-11-18 08:00,158,111,47,0,0,0
2021-11-18 08:15,150,94,56,0,0,0
2021-11-18 08:30,109,75,34,0,0,0
2021-11-18 08:45,144,95,49,0,0,0
2021-11-18 09:00,77,45,32,0,0,0
2021-11-18 09:15,98,61,37,0,0,0
2021-11-18 09:30,96,68,28,0,0,0
2021-11-18 09:45,146,84,62,0,0,0
2021-11-18 10:00,114,78,36,0,0,0
2021-11-18 10:15,86,42,44,0,0,0
2021-11-18 10:30,111,43,68,0,0,0
2021-11-18 10:45,110,63,47,0,0,0
2021-11-18 11:00,80,42,38,0,0,0
2021-11-18 11:15,108,57,51,0,0,0
2021-11-18 11:30,111,43,68,0,0,0
2021-11-18 11:45,143,58,85,0,0,0
2021-11-18 12:00,145,66,79,0,0,0
2021-11-18 12:15,125,56,69,0,0,0
2021-11-18 12:30,133,56,77,0,0,0
2021-11-18 12:45,143,64,79,0,0,0
2021-11-18 13:00,144,55,89,0,0,0
2021-11-18 13:15,134,53,81,0,0,0
2021-11-18 13:30,129,59,70,0,0,0
2021-11-18 13:45,150,67,83,0,0,0
2021-11-18 14:00,177,82,95,0,0,0
2021-11-18 14:15,151,59,92,0,0,0
2021-11-18 14:30,137,70,67,0,0,0
2021-11-18 14:45,166,72,94,0,0,0
2021-11-18 15:00,185,71,114,0,0,0
2021-11-18 15:15,167,80,87,0,0,0
2021-11-18 15:30,193,72,121,0,0,0
2021-11-18 15:45,210,86,124,0,0,0
2021-11-18 16:00,202,80,122,0,0,0
2021-11-18 16:15,205,77,128,0,0,0
2021-11-18 16:30,227,85,142,0,0,0
2021-11-18 16:45,190,84,106,0,0,0
2021-11-18 17:00,192,77,115,0,0,0
2021-11-18 17:15,170,58,112,0,0,0
2021-11-18 17:30,178,65,113,0,0,0
2021-11-18 17:45,184,71,113,0,0,0
2021-11-18 18:00,170,58,112,0,0,0
2021-11-18 18:15,153,61,92,0,0,0
2021-11-18 18:30,139,46,93,0,0,0
2021-11-18 18:45,178,61,117,0,0,0
2021-11-18 19:00,131,40,91,0,0,0
2021-11-18 19:15,115,52,63,0,0,0
2021-11-18 19:30,97,42,55,0,0,0
2021-11-18 19:45,85,40,45,0,0,0
2021-11-18 20:00,110,33,77,0,0,0
2021-11-18 20:15,65,24,41,0,0,0
2021-11-18 20:30,45,19,26,0,0,0
2021-11-18 20:45,62,21,41,0,0,0
2021-11-18 21:00,52,17,35,0,0,0
2021-11-18 21:15,40,12,28,0,0,0
2021-11-18 21:30,69,29,40,0,0,0
2021-11-18 21:45,68,31,37,0,0,0
2021-11-18 22:00,51,7,44,0,0,0
2021-11-18 22:15,38,16,22,0,0,0
2021-11-18 22:30,46,20,26,0,0,0
2021-11-18 22:45,41,13,28,0,0,0
2021-11-18 23:00,44,15,29,0,0,0
2021-11-18 23:15,32,14,18,0,0,0
2021-11-18 23:30,23,7,16,0,0,0
2021-11-18 23:45,23,9,14,0,0,0
2021-11-19 00:00,17,2,15,0,0,0
2021-11-19 00:15,24,11,13,0,0,0
2021-11-19 00:30,12,2,10,0,0,0
2021-11-19 00:45,7,0,7,0,0,0
2021-11-19 01:00,7,3,4,0,0,0
2021-11-19 01:15,8,0,8,0,0,0
2021-11-19 01:30,8,5,3,0,0,0
2021-11-19 01:45,5,1,4,0,0,0
2021-11-19 02:00,6,0,6,0,0,0
2021-11-19 02:15,8,0,8,0,0,0
2021-11-19 02:30,8,1,7,0,0,0
2021-11-19 02:45,6,0,6,0,0,0
2021-11-19 03:00,1,1,0,0,0,0
2021-11-19 03:15,12,2,10,0,0,0
2021-11-19 03:30,5,0,5,0,0,0
2021-11-19 03:45,0,0,0,0,0,0
2021-11-19 04:00,0,0,0,0,0,0
2021-11-19 04:15,5,3,2,0,0,0
2021-11-19 04:30,1,1,0,0,0,0
2021-11-19 04:45,5,3,2,0,0,0
2021-11-19 05:00,5,5,0,0,0,0
2021-11-19 05:15,4,2,2,0,0,0
2021-11-19 05:30,16,14,2,0,0,0
2021-11-19 05:45,23,19,4,0,0,0
2021-11-19 06:00,29,18,11,0,0,0
2021-11-19 06:15,34,20,14,0,0,0
2021-11-19 06:30,37,29,8,0,0,0
2021-11-19 06:45,45,28,17,0,0,0
2021-11-19 07:00,82,42,40,0,0,0
2021-11-19 07:15,84,53,31,0,0,0
2021-11-19 07:30,131,89,42,0,0,0
2021-11-19 07:45,150,103,47,0,0,0
2021-11-19 08:00,138,88,50,0,0,0
2021-11-19 08:15,125,80,45,0,0,0
2021-11-19 08:30,96,67,29,0,0,0
2021-11-19 08:45,124,85,39,0,0,0
2021-11-19 09:00,88,52,36,0,0,0
2021-11-19 09:15,70,44,26,0,0,0
2021-11-19 09:30,88,63,25,0,0,0
2021-11-19 09:45,111,90,21,0,0,0
2021-11-19 10:00,94,62,32,0,0,0
2021-11-19 10:15,89,54,35,0,0,0
2021-11-19 10:30,102,54,48,0,0,0
2021-11-19 10:45,127,56,71,0,0,0
2021-11-19 11:00,92,47,45,0,0,0
2021-11-19 11:15,124,58,66,0,0,0
2021-11-19 11:30,102,50,52,0,0,0
2021-11-19 11:45,129,57,72,0,0,0
2021-11-19 12:00,102,39,63,0,0,0
2021-11-19 12:15,109,58,51,0,0,0
2021-11-19 12:30,140,53,87,0,0,0
2021-11-19 12:45,124,48,76,0,0,0
2021-11-19 13:00,146,48,98,0,0,0
2021-11-19 13:15,147,59,88,0,0,0
2021-11-19 13:30,126,48,78,0,0,0
2021-11-19 13:45,173,66,107,0,0,0
2021-11-19 14:00,131,51,80,0,0,0
2021-11-19 14:15,180,59,121,0,0,0
2021-11-19 14:30,152,49,103,0,0,0
2021-11-19 14:45,163,52,111,0,0,0
2021-11-19 15:00,148,50,98,0,0,0
2021-11-19 15:15,162,69,93,0,0,0
2021-11-19 15:30,140,43,97,0,0,0
2021-11-19 15:45,184,79,105,0,0,0
2021-11-19 16:00,170,58,112,0,0,0
2021-11-19 16:15,164,78,86,0,0,0
2021-11-19 16:30,164,71,93,0,0,0
2021-11-19 16:45,152,48,104,0,0,0
2021-11-19 17:00,135,55,80,0,0,0
2021-11-19 17:15,132,49,83,0,0,0
2021-11-19 17:30,154,64,90,0,0,0
2021-11-19 17:45,165,64,101,0,0,0
2021-11-19 18:00,127,50,77,0,0,0
2021-11-19 18:15,120,52,68,0,0,0
2021-11-19 18:30,141,57,84,0,0,0
2021-11-19 18:45,147,58,89,0,0,0
2021-11-19 19:00,114,49,65,0,0,0
2021-11-19 19:15,112,46,66,0,0,0
2021-11-19 19:30,98,35,63,0,0,0
2021-11-19 19:45,101,31,70,0,0,0
2021-11-19 20:00,85,27,58,0,0,0
2021-11-19 20:15,57,27,30,0,0,0
2021-11-19 20:30,52,24,28,0,0,0
2021-11-19 20:45,47,22,25,0,0,0
2021-11-19 21:00,57,19,38,0,0,0
2021-11-19 21:15,43,21,22,0,0,0
2021-11-19 21:30,54,15,39,0,0,0
2021-11-19 21:45,45,14,31,0,0,0
2021-11-19 22:00,33,8,25,0,0,0
2021-11-19 22:15,32,8,24,0,0,0
2021-11-19 22:30,37,11,26,0,0,0
2021-11-19 22:45,32,6,26,0,0,0
2021-11-19 23:00,48,21,27,0,0,0
2021-11-19 23:15,40,12,28,0,0,0
2021-11-19 23:30,39,20,19,0,0,0
2021-11-19 23:45,49,18,31,0,0,0
2021-11-20 00:00,50,17,33,0,0,0
2021-11-20 00:15,44,22,22,0,0,0
2021-11-20 00:30,19,5,14,0,0,0
2021-11-20 00:45,44,18,26,0,0,0
2021-11-20 01:00,27,9,18,0,0,0
2021-11-20 01:15,34,12,22,0,0,0
2021-11-20 01:30,20,6,14,0,0,0
2021-11-20 01:45,24,12,12,0,0,0
2021-11-20 02:00,17,9,8,0,0,0
2021-11-20 02:15,17,3,14,0,0,0
2021-11-20 02:30,18,7,11,0,0,0
2021-11-20 02:45,17,11,6,0,0,0
2021-11-20 03:00,14,4,10,0,0,0
2021-11-20 03:15,8,4,4,0,0,0
2021-11-20 03:30,10,3,7,0,0,0
2021-11-20 03:45,5,1,4,0,0,0
2021-11-20 04:00,8,0,8,0,0,0
2021-11-20 04:15,10,4,6,0,0,0
2021-11-20 04:30,2,0,2,0,0,0
2021-11-20 04:45,7,1,6,0,0,0
2021-11-20 05:00,5,3,2,0,0,0
2021-11-20 05:15,3,1,2,0,0,0
2021-11-20 05:30,10,6,4,0,0,0
2021-11-20 05:45,12,7,5,0,0,0
2021-11-20 06:00,4,2,2,0,0,0
2021-11-20 06:15,8,7,1,0,0,0
2021-11-20 06:30,12,9,3,0,0,0
2021-11-20 06:45,17,11,6,0,0,0
2021-11-20 07:00,13,8,5,0,0,0
2021-11-20 07:15,16,10,6,0,0,0
2021-11-20 07:30,18,12,6,0,0,0
2021-11-20 07:45,27,18,9,0,0,0
2021-11-20 08:00,21,14,7,0,0,0
2021-11-20 08:15,24,8,16,0,0,0
2021-11-20 08:30,35,23,12,0,0,0
2021-11-20 08:45,50,35,15,0,0,0
2021-11-20 09:00,56,35,21,0,0,0
2021-11-20 09:15,54,41,13,0,0,0
2021-11-20 09:30,72,46,26,0,0,0
2021-11-20 09:45,122,90,32,0,0,0
2021-11-20 10:00,119,76,43,0,0,0
2021-11-20 10:15,114,75,39,0,0,0
2021-11-20 10:30,113,72,41,0,0,0
2021-11-20 10:45,104,60,44,0,0,0
2021-11-20 11:00,134,74,60,0,0,0
2021-11-20 11:15,156,97,59,0,0,0
2021-11-20 11:30,136,67,69,0,0,0
2021-11-20 11:45,155,95,60,0,0,0
2021-11-20 12:00,146,72,74,0,0,0
2021-11-20 12:15,156,76,80,0,0,0
2021-11-20 12:30,157,71,86,0,0,0
2021-11-20 12:45,172,73,99,0,0,0
2021-11-20 13:00,128,50,78,0,0,0
2021-11-20 13:15,145,78,67,0,0,0
2021-11-20 13:30,149,48,101,0,0,0
2021-11-20 13:45,139,58,81,0,0,0
2021-11-20 14:00,122,49,73,0,0,0
2021-11-20 14:15,146,57,89,0,0,0
2021-11-20 14:30,145,61,84,0,0,0
2021-11-20 14:45,140,45,95,0,0,0
2021-11-20 15:00,129,51,78,0,0,0
2021-11-20 15:15,125,66,59,0,0,0
2021-11-20 15:30,102,41,61,0,0,0
2021-11-20 15:45,116,41,75,0,0,0
2021-11-20 16:00,127,42,85,0,0,0
2021-11-20 16:15,110,41,69,0,0,0
2021-11-20 16:30,98,40,58,0,0,0
2021-11-20 16:45,128,58,70,0,0,0
2021-11-20 17:00,84,28,56,0,0,0
2021-11-20 17:15,97,40,57,0,0,0
2021-11-20 17:30,95,30,65,0,0,0
2021-11-20 17:45,103,44,59,0,0,0
2021-11-20 18:00,100,37,63,0,0,0
2021-11-20 18:15,127,40,87,0,0,0
2021-11-20 18:30,142,44,98,0,0,0
2021-11-20 18:45,125,47,78,0,0,0
2021-11-20 19:00,105,50,55,0,0,0
2021-11-20 19:15,98,48,50,0,0,0
2021-11-20 19:30,71,35,36,0,0,0
2021-11-20 19:45,85,43,42,0,0,0
2021-11-20 20:00,65,21,44,0,0,0
2021-11-20 20:15,81,32,49,0,0,0
2021-11-20 20:30,70,31,39,0,0,0
2021-11-20 20:45,53,19,34,0,0,0
2021-11-20 21:00,42,27,15,0,0,0
2021-11-20 21:15,43,17,26,0,0,0
2021-11-20 21:30,72,43,29,0,0,0
2021-11-20 21:45,104,76,28,0,0,0
2021-11-20 22:00,62,30,32,0,0,0
2021-11-20 22:15,41,7,34,0,0,0
2021-11-20 22:30,43,8,35,0,0,0
2021-11-20 22:45,44,21,23,0,0,0
2021-11-20 23:00,34,18,16,0,0,0
2021-11-20 23:15,46,13,33,0,0,0
2021-11-20 23:30,30,19,11,0,0,0
2021-11-20 23:45,51,17,34,0,0,0
2021-11-21 00:00,40,20,20,0,0,0
2021-11-21 00:15,47,21,26,0,0,0
2021-11-21 00:30,24,14,10,0,0,0
2021-11-21 00:45,25,4,21,0,0,0
2021-11-21 01:00,21,10,11,0,0,0
2021-11-21 01:15,25,12,13,0,0,0
2021-11-21 01:30,27,7,20,0,0,0
2021-11-21 01:45,16,5,11,0,0,0
2021-11-21 02:00,21,15,6,0,0,0
2021-11-21 02:15,23,2,21,0,0,0
2021-11-21 02:30,18,7,11,0,0,0
2021-11-21 02:45,24,12,12,0,0,0
2021-11-21 03:00,11,3,8,0,0,0
2021-11-21 03:15,17,1,16,0,0,0
2021-11-21 03:30,14,2,12,0,0,0
2021-11-21 03:45,5,0,5,0,0,0
2021-11-21 04:00,10,0,10,0,0,0
2021-11-21 04:15,5,1,4,0,0,0
2021-11-21 04:30,5,2,3,0,0,0
2021-11-21 04:45,1,0,1,0,0,0
2021-11-21 05:00,3,0,3,0,0,0
2021-11-21 05:15,7,3,4,0,0,0
2021-11-21 05:30,7,4,3,0,0,0
2021-11-21 05:45,2,0,2,0,0,0
2021-11-21 06:00,4,1,3,0,0,0
2021-11-21 06:15,1,0,1,0,0,0
2021-11-21 06:30,2,2,0,0,0,0
2021-11-21 06:45,4,3,1,0,0,0
2021-11-21 07:00,3,2,1,0,0,0
2021-11-21 07:15,5,2,3,0,0,0
2021-11-21 07:30,7,4,3,0,0,0
2021-11-21 07:45,11,4,7,0,0,0
2021-11-21 08:00,4,1,3,0,0,0
2021-11-21 08:15,4,3,1,0,0,0
2021-11-21 08:30,15,9,6,0,0,0
2021-11-21 08:45,16,12,4,0,0,0
2021-11-21 09:00,11,6,5,0,0,0
2021-11-21 09:15,27,17,10,0,0,0
2021-11-21 09:30,25,16,9,0,0,0
2021-11-21 09:45,36,23,13,0,0,0
2021-11-21 10:00,31,22,9,0,0,0
2021-11-21 10:15,31,19,12,0,0,0
2021-11-21 10:30,32,18,14,0,0,0
2021-11-21 10:45,47,20,27,0,0,0
2021-11-21 11:00,20,11,9,0,0,0
2021-11-21 11:15,29,14,15,0,0,0
2021-11-21 11:30,31,21,10,0,0,0
2021-11-21 11:45,41,14,27,0,0,0
2021-11-21 12:00,46,24,22,0,0,0
2021-11-21 12:15,44,25,19,0,0,0
2021-11-21 12:30,37,14,23,0,0,0
2021-11-21 12:45,35,20,15,0,0,0
2021-11-21 13:00,52,30,22,0,0,0
2021-11-21 13:15,57,33,24,0,0,0
2021-11-21 13:30,58,31,27,0,0,0
2021-11-21 13:45,57,33,24,0,0,0
2021-11-21 14:00,62,34,28,0,0,0
2021-11-21 14:15,71,40,31,0,0,0
2021-11-21 14:30,93,51,42,0,0,0
2021-11-21 14:45,88,41,47,0,0,0
2021-11-21 15:00,57,30,27,0,0,0
2021-11-21 15:15,80,40,40,0,0,0
2021-11-21 15:30,86,28,58,0,0,0
2021-11-21 15:45,89,47,42,0,0,0
2021-11-21 16:00,90,46,44,0,0,0
2021-11-21 16:15,81,29,52,0,0,0
2021-11-21 16:30,71,35,36,0,0,0
2021-11-21 16:45,85,27,58,0,0,0
2021-11-21 17:00,57,13,44,0,0,0
2021-11-21 17:15,59,23,36,0,0,0
2021-11-21 17:30,66,25,41,0,0,0
2021-11-21 17:45,57,30,27,0,0,0
2021-11-21 18:00,47,23,24,0,0,0
2021-11-21 18:15,40,20,20,0,0,0
2021-11-21 18:30,40,13,27,0,0,0
2021-11-21 18:45,53,25,28,0,0,0
2021-11-21 19:00,41,18,23,0,0,0
2021-11-21 19:15,46,25,21,0,0,0
2021-11-21 19:30,39,13,26,0,0,0
2021-11-21 19:45,51,32,19,0,0,0
2021-11-21 20:00,42,23,19,0,0,0
2021-11-21 20:15,34,16,18,0,0,0
2021-11-21 20:30,35,6,29,0,0,0
2021-11-21 20:45,33,11,22,0,0,0
2021-11-21 21:00,18,8,10,0,0,0
2021-11-21 21:15,19,8,11,0,0,0
2021-11-21 21:30,28,12,16,0,0,0
2021-11-21 21:45,27,6,21,0,0,0
2021-11-21 22:00,25,8,17,0,0,0
2021-11-21 22:15,24,10,14,0,0,0
2021-11-21 22:30,22,7,15,0,0,0
2021-11-21 22:45,18,9,9,0,0,0
2021-11-21 23:00,11,3,8,0,0,0
2021-11-21 23:15,10,7,3,0,0,0
2021-11-21 23:30,9,3,6,0,0,0
2021-11-21 23:45,15,8,7,0,0,0
2021-11-22 00:00,9,1,8,0,0,0
2021-11-22 00:15,5,1,4,0,0,0
2021-11-22 00:30,1,1,0,0,0,0
2021-11-22 00:45,5,2,3,0,0,0
2021-11-22 01:00,3,1,2,0,0,0
2021-11-22 01:15,1,1,0,0,0,0
2021-11-22 01:30,0,0,0,0,0,0
2021-11-22 01:45,5,2,3,0,0,0
2021-11-22 02:00,3,1,2,0,0,0
2021-11-22 02:15,1,0,1,0,0,0
2021-11-22 02:30,0,0,0,0,0,0
2021-11-22 02:45,0,0,0,0,0,0
2021-11-22 03:00,2,1,1,0,0,0
2021-11-22 03:15,0,0,0,0,0,0
2021-11-22 03:30,1,0,1,0,0,0
2021-11-22 03:45,0,0,0,0,0,0
2021-11-22 04:00,0,0,0,0,0,0
2021-11-22 04:15,3,2,1,0,0,0
2021-11-22 04:30,1,1,0,0,0,0
2021-11-22 04:45,3,3,0,0,0,0
2021-11-22 05:00,4,3,1,0,0,0
2021-11-22 05:15,8,6,2,0,0,0
2021-11-22 05:30,16,11,5,0,0,0
2021-11-22 05:45,23,19,4,0,0,0
2021-11-22 06:00,17,12,5,0,0,0
2021-11-22 06:15,27,19,8,0,0,0
2021-11-22 06:30,31,22,9,0,0,0
2021-11-22 06:45,63,38,25,0,0,0
2021-11-22 07:00,77,48,29,0,0,0
2021-11-22 07:15,93,66,27,0,0,0
2021-11-22 07:30,127,85,42,0,0,0
2021-11-22 07:45,181,111,70,0,0,0
2021-11-22 08:00,164,103,61,0,0,0
2021-11-22 08:15,130,85,45,0,0,0
2021-11-22 08:30,104,71,33,0,0,0
2021-11-22 08:45,105,69,36,0,0,0
2021-11-22 09:00,93,51,42,0,0,0
2021-11-22 09:15,93,60,33,0,0,0
2021-11-22 09:30,112,82,30,0,0,0
2021-11-22 09:45,114,72,42,0,0,0
2021-11-22 10:00,94,63,31,0,0,0
2021-11-22 10:15,86,56,30,0,0,0
2021-11-22 10:30,90,47,43,0,0,0
2021-11-22 10:45,119,58,61,0,0,0
2021-11-22 11:00,85,47,38,0,0,0
2021-11-22 11:15,113,52,61,0,0,0
2021-11-22 11:30,118,59,59,0,0,0
2021-11-22 11:45,143,67,76,0,0,0
2021-11-22 12:00,118,51,67,0,0,0
2021-11-22 12:15,117,51,66,0,0,0
2021-11-22 12:30,143,58,85,0,0,0
2021-11-22 12:45,138,66,72,0,0,0
2021-11-22 13:00,143,50,93,0,0,0
2021-11-22 13:15,133,65,68,0,0,0
2021-11-22 13:30,140,66,74,0,0,0
2021-11-22 13:45,179,85,94,0,0,0
2021-11-22 14:00,160,87,73,0,0,0
2021-11-22 14:15,144,71,73,0,0,0
2021-11-22 14:30,191,87,104,0,0,0
2021-11-22 14:45,202,84,118,0,0,0
2021-11-22 15:00,166,67,99,0,0,0
2021-11-22 15:15,146,70,76,0,0,0
2021-11-22 15:30,181,78,103,0,0,0
2021-11-22 15:45,210,84,126,0,0,0
2021-11-22 16:00,197,77,120,0,0,0
2021-11-22 16:15,196,87,109,0,0,0
2021-11-22 16:30,211,92,119,0,0,0
2021-11-22 16:45,216,81,135,0,0,0
2021-11-22 17:00,193,72,121,0,0,0
2021-11-22 17:15,197,76,121,0,0,0
2021-11-22 17:30,227,73,154,0,0,0
2021-11-22 17:45,196,82,114,0,0,0
2021-11-22 18:00,186,67,119,0,0,0
2021-11-22 18:15,172,80,92,0,0,0
2021-11-22 18:30,142,56,86,0,0,0
2021-11-22 18:45,135,52,83,0,0,0
2021-11-22 19:00,139,47,92,0,0,0
2021-11-22 19:15,108,38,70,0,0,0
2021-11-22 19:30,108,24,84,0,0,0
2021-11-22 19:45,116,35,81,0,0,0
2021-11-22 20:00,99,18,81,0,0,0
2021-11-22 20:15,108,23,85,0,0,0
2021-11-22 20:30,67,9,58,0,0,0
2021-11-22 20:45,61,10,51,0,0,0
2021-11-22 21:00,48,13,35,0,0,0
2021-11-22 21:15,40,8,32,0,0,0
2021-11-22 21:30,47,13,34,0,0,0
2021-11-22 21:45,48,10,38,0,0,0
2021-11-22 22:00,43,10,33,0,0,0
2021-11-22 22:15,38,7,31,0,0,0
2021-11-22 22:30,26,5,21,0,0,0
2021-11-22 22:45,26,6,20,0,0,0
2021-11-22 23:00,36,4,32,0,0,0
2021-11-22 23:15,14,5,9,0,0,0
2021-11-22 23:30,18,2,16,0,0,0
2021-11-22 23:45,19,2,17,0,0,0
2021-11-23 00:00,15,4,11,0,0,0
2021-11-23 00:15,6,1,5,0,0,0
2021-11-23 00:30,5,0,5,0,0,0
2021-11-23 00:45,3,2,1,0,0,0
2021-11-23 01:00,4,1,3,0,0,0
2021-11-23 01:15,5,3,2,0,0,0
2021-11-23 01:30,6,1,5,0,0,0
2021-11-23 01:45,0,0,0,0,0,0
2021-11-23 02:00,2,1,1,0,0,0
2021-11-23 02:15,1,1,0,0,0,0
2021-11-23 02:30,0,0,0,0,0,0
2021-11-23 02:45,0,0,0,0,0,0
2021-11-23 03:00,0,0,0,0,0,0
2021-11-23 03:15,1,1,0,0,0,0
2021-11-23 03:30,2,0,2,0,0,0
2021-11-23 03:45,1,0,1,0,0,0
2021-11-23 04:00,0,0,0,0,0,0
2021-11-23 04:15,1,1,0,0,0,0
2021-11-23 04:30,1,1,0,0,0,0
2021-11-23 04:45,3,3,0,0,0,0
2021-11-23 05:00,4,3,1,0,0,0
2021-11-23 05:15,7,3,4,0,0,0
2021-11-23 05:30,10,6,4,0,0,0
2021-11-23 05:45,27,21,6,0,0,0
2021-11-23 06:00,12,9,3,0,0,0
2021-11-23 06:15,29,21,8,0,0,0
2021-11-23 06:30,38,19,19,0,0,0
2021-11-23 06:45,59,43,16,0,0,0
2021-11-23 07:00,64,41,23,0,0,0
2021-11-23 07:15,85,54,31,0,0,0
2021-11-23 07:30,133,93,40,0,0,0
2021-11-23 07:45,188,109,79,0,0,0
2021-11-23 08:00,164,107,57,0,0,0
2021-11-23 08:15,148,96,52,0,0,0
2021-11-23 08:30,106,77,29,0,0,0
2021-11-23 08:45,96,60,36,0,0,0
2021-11-23 09:00,116,53,63,0,0,0
2021-11-23 09:15,79,54,25,0,0,0
2021-11-23 09:30,84,57,27,0,0,0
2021-11-23 09:45,151,89,62,0,0,0
2021-11-23 10:00,91,63,28,0,0,0
2021-11-23 10:15,89,52,37,0,0,0
2021-11-23 10:30,93,63,30,0,0,0
2021-11-23 10:45,105,65,40,0,0,0
2021-11-23 11:00,97,45,52,0,0,0
2021-11-23 11:15,113,44,69,0,0,0
2021-11-23 11:30,97,38,59,0,0,0
2021-11-23 11:45,121,63,58,0,0,0
2021-11-23 12:00,120,46,74,0,0,0
2021-11-23 12:15,126,49,77,0,0,0
2021-11-23 12:30,111,50,61,0,0,0
2021-11-23 12:45,108,51,57,0,0,0
2021-11-23 13:00,103,47,56,0,0,0
2021-11-23 13:15,116,39,77,0,0,0
2021-11-23 13:30,106,45,61,0,0,0
2021-11-23 13:45,156,70,86,0,0,0
2021-11-23 14:00,114,51,63,0,0,0
2021-11-23 14:15,141,54,87,0,0,0
2021-11-23 14:30,105,45,60,0,0,0
2021-11-23 14:45,158,64,94,0,0,0
2021-11-23 15:00,131,59,72,0,0,0
2021-11-23 15:15,170,66,104,0,0,0
2021-11-23 15:30,176,76,100,0,0,0
2021-11-23 15:45,162,58,104,0,0,0
2021-11-23 16:00,185,75,110,0,0,0
2021-11-23 16:15,180,63,117,0,0,0
2021-11-23 16:30,175,69,106,0,0,0
2021-11-23 16:45,200,82,118,0,0,0
2021-11-23 17:00,183,68,115,0,0,0
2021-11-23 17:15,181,60,121,0,0,0
2021-11-23 17:30,186,81,105,0,0,0
2021-11-23 17:45,188,70,118,0,0,0
2021-11-23 18:00,187,68,119,0,0,0
2021-11-23 18:15,191,65,126,0,0,0
2021-11-23 18:30,141,50,91,0,0,0
2021-11-23 18:45,154,66,88,0,0,0
2021-11-23 19:00,113,28,85,0,0,0
2021-11-23 19:15,95,35,60,0,0,0
2021-11-23 19:30,115,31,84,0,0,0
2021-11-23 19:45,111,42,69,0,0,0
2021-11-23 20:00,90,23,67,0,0,0
2021-11-23 20:15,101,21,80,0,0,0
2021-11-23 20:30,52,17,35,0,0,0
2021-11-23 20:45,53,14,39,0,0,0
2021-11-23 21:00,63,15,48,0,0,0
2021-11-23 21:15,32,5,27,0,0,0
2021-11-23 21:30,54,13,41,0,0,0
2021-11-23 21:45,49,14,35,0,0,0
2021-11-23 22:00,48,7,41,0,0,0
2021-11-23 22:15,38,10,28,0,0,0
2021-11-23 22:30,33,13,20,0,0,0
2021-11-23 22:45,17,6,11,0,0,0
2021-11-23 23:00,29,13,16,0,0,0
2021-11-23 23:15,17,8,9,0,0,0
2021-11-23 23:30,28,5,23,0,0,0
2021-11-23 23:45,17,5,12,0,0,0
2021-11-24 00:00,7,3,4,0,0,0
2021-11-24 00:15,10,6,4,0,0,0
2021-11-24 00:30,12,3,9,0,0,0
2021-11-24 00:45,2,0,2,0,0,0
2021-11-24 01:00,7,0,7,0,0,0
2021-11-24 01:15,5,2,3,0,0,0
2021-11-24 01:30,5,0,5,0,0,0
2021-11-24 01:45,0,0,0,0,0,0
2021-11-24 02:00,2,0,2,0,0,0
2021-11-24 02:15,0,0,0,0,0,0
2021-11-24 02:30,1,1,0,0,0,0
2021-11-24 02:45,1,1,0,0,0,0
2021-11-24 03:00,2,0,2,0,0,0
2021-11-24 03:15,3,1,2,0,0,0
2021-11-24 03:30,1,1,0,0,0,0
2021-11-24 03:45,0,0,0,0,0,0
2021-11-24 04:00,0,0,0,0,0,0
2021-11-24 04:15,0,0,0,0,0,0
2021-11-24 04:30,3,3,0,0,0,0
2021-11-24 04:45,5,3,2,0,0,0
2021-11-24 05:00,5,3,2,0,0,0
2021-11-24 05:15,5,4,1,0,0,0
2021-11-24 05:30,11,6,5,0,0,0
2021-11-24 05:45,31,21,10,0,0,0
2021-11-24 06:00,22,16,6,0,0,0
2021-11-24 06:15,31,24,7,0,0,0
2021-11-24 06:30,51,36,15,0,0,0
2021-11-24 06:45,68,45,23,0,0,0
2021-11-24 07:00,68,40,28,0,0,0
2021-11-24 07:15,102,68,34,0,0,0
2021-11-24 07:30,139,84,55,0,0,0
2021-11-24 07:45,202,142,60,0,0,0
2021-11-24 08:00,168,116,52,0,0,0
2021-11-24 08:15,154,105,49,0,0,0
2021-11-24 08:30,125,87,38,0,0,0
2021-11-24 08:45,122,78,44,0,0,0
2021-11-24 09:00,142,92,50,0,0,0
2021-11-24 09:15,109,68,41,0,0,0
2021-11-24 09:30,115,82,33,0,0,0
2021-11-24 09:45,160,96,64,0,0,0
2021-11-24 10:00,118,72,46,0,0,0
2021-11-24 10:15,105,57,48,0,0,0
2021-11-24 10:30,121,62,59,0,0,0
2021-11-24 10:45,112,58,54,0,0,0
2021-11-24 11:00,136,51,85,0,0,0
2021-11-24 11:15,134,82,52,0,0,0
2021-11-24 11:30,114,52,62,0,0,0
2021-11-24 11:45,159,71,88,0,0,0
2021-11-24 12:00,179,87,92,0,0,0
2021-11-24 12:15,141,65,76,0,0,0
2021-11-24 12:30,143,70,73,0,0,0
2021-11-24 12:45,177,87,90,0,0,0
2021-11-24 13:00,189,67,122,0,0,0
2021-11-24 13:15,210,83,127,0,0,0
2021-11-24 13:30,173,76,97,0,0,0
2021-11-24 13:45,194,89,105,0,0,0
2021-11-24 14:00,164,74,90,0,0,0
2021-11-24 14:15,152,64,88,0,0,0
2021-11-24 14:30,188,84,104,0,0,0
2021-11-24 14:45,185,80,105,0,0,0
2021-11-24 15:00,177,55,122,0,0,0
2021-11-24 15:15,172,82,90,0,0,0
2021-11-24 15:30,180,75,105,0,0,0
2021-11-24 15:45,196,89,107,0,0,0
2021-11-24 16:00,219,88,131,0,0,0
2021-11-24 16:15,216,91,125,0,0,0
2021-11-24 16:30,166,74,92,0,0,0
2021-11-24 16:45,169,64,105,0,0,0
2021-11-24 17:00,180,66,114,0,0,0
2021-11-24 17:15,185,87,98,0,0,0
2021-11-24 17:30,202,93,109,0,0,0
2021-11-24 17:45,194,96,98,0,0,0
2021-11-24 18:00,184,73,111,0,0,0
2021-11-24 18:15,213,103,110,0,0,0
2021-11-24 18:30,135,50,85,0,0,0
2021-11-24 18:45,148,49,99,0,0,0
2021-11-24 19:00,121,42,79,0,0,0
2021-11-24 19:15,109,38,71,0,0,0
2021-11-24 19:30,103,35,68,0,0,0
2021-11-24 19:45,123,40,83,0,0,0
2021-11-24 20:00,127,30,97,0,0,0
2021-11-24 20:15,112,31,81,0,0,0
2021-11-24 20:30,67,10,57,0,0,0
2021-11-24 20:45,73,20,53,0,0,0
2021-11-24 21:00,53,15,38,0,0,0
2021-11-24 21:15,49,11,38,0,0,0
2021-11-24 21:30,64,15,49,0,0,0
2021-11-24 21:45,52,16,36,0,0,0
2021-11-24 22:00,38,10,28,0,0,0
2021-11-24 22:15,50,10,40,0,0,0
2021-11-24 22:30,30,7,23,0,0,0
2021-11-24 22:45,41,6,35,0,0,0
2021-11-24 23:00,42,5,37,0,0,0
2021-11-24 23:15,31,11,20,0,0,0
2021-11-24 23:30,23,9,14,0,0,0
2021-11-24 23:45,30,8,22,0,0,0
2021-11-25 00:00,19,5,14,0,0,0
2021-11-25 00:15,23,4,19,0,0,0
2021-11-25 00:30,13,2,11,0,0,0
2021-11-25 00:45,7,3,4,0,0,0
2021-11-25 01:00,2,0,2,0,0,0
2021-11-25 01:15,6,0,6,0,0,0
2021-11-25 01:30,8,4,4,0,0,0
2021-11-25 01:45,5,0,5,0,0,0
2021-11-25 02:00,8,2,6,0,0,0
2021-11-25 02:15,6,2,4,0,0,0
2021-11-25 02:30,5,1,4,0,0,0
2021-11-25 02:45,7,5,2,0,0,0
2021-11-25 03:00,2,2,0,0,0,0
2021-11-25 03:15,1,0,1,0,0,0
2021-11-25 03:30,2,0,2,0,0,0
2021-11-25 03:45,2,0,2,0,0,0
2021-11-25 04:00,1,1,0,0,0,0
2021-11-25 04:15,4,1,3,0,0,0
2021-11-25 04:30,3,3,0,0,0,0
2021-11-25 04:45,6,3,3,0,0,0
2021-11-25 05:00,2,2,0,0,0,0
2021-11-25 05:15,7,3,4,0,0,0
2021-11-25 05:30,11,8,3,0,0,0
2021-11-25 05:45,23,19,4,0,0,0
2021-11-25 06:00,27,19,8,0,0,0
2021-11-25 06:15,21,14,7,0,0,0
2021-11-25 06:30,44,26,18,0,0,0
2021-11-25 06:45,41,23,18,0,0,0
2021-11-25 07:00,70,42,28,0,0,0
2021-11-25 07:15,81,55,26,0,0,0
2021-11-25 07:30,134,94,40,0,0,0
2021-11-25 07:45,183,118,65,0,0,0
2021-11-25 08:00,157,102,55,0,0,0
2021-11-25 08:15,140,94,46,0,0,0
2021-11-25 08:30,102,69,33,0,0,0
2021-11-25 08:45,132,82,50,0,0,0
2021-11-25 09:00,84,47,37,0,0,0
2021-11-25 09:15,102,62,40,0,0,0
2021-11-25 09:30,97,68,29,0,0,0
2021-11-25 09:45,137,90,47,0,0,0
2021-11-25 10:00,112,79,33,0,0,0
2021-11-25 10:15,106,52,54,0,0,0
2021-11-25 10:30,97,52,45,0,0,0
2021-11-25 10:45,136,81,55,0,0,0
2021-11-25 11:00,98,53,45,0,0,0
2021-11-25 11:15,119,56,63,0,0,0
2021-11-25 11:30,113,50,63,0,0,0
2021-11-25 11:45,161,73,88,0,0,0
2021-11-25 12:00,116,46,70,0,0,0
2021-11-25 12:15,133,56,77,0,0,0
2021-11-25 12:30,140,58,82,0,0,0
2021-11-25 12:45,139,54,85,0,0,0
2021-11-25 13:00,152,43,109,0,0,0
2021-11-25 13:15,124,49,75,0,0,0
2021-11-25 13:30,139,59,80,0,0,0
2021-11-25 13:45,145,65,80,0,0,0
2021-11-25 14:00,104,55,49,0,0,0
2021-11-25 14:15,133,63,70,0,0,0
2021-11-25 14:30,124,44,80,0,0,0
2021-11-25 14:45,130,69,61,0,0,0
2021-11-25 15:00,128,57,71,0,0,0
2021-11-25 15:15,182,80,102,0,0,0
2021-11-25 15:30,164,70,94,0,0,0
2021-11-25 15:45,175,75,100,0,0,0
2021-11-25 16:00,181,74,107,0,0,0
2021-11-25 16:15,139,66,73,0,0,0
2021-11-25 16:30,177,72,105,0,0,0
2021-11-25 16:45,170,72,98,0,0,0
2021-11-25 17:00,152,57,95,0,0,0
2021-11-25 17:15,181,81,100,0,0,0
2021-11-25 17:30,168,67,101,0,0,0
2021-11-25 17:45,226,96,130,0,0,0
2021-11-25 18:00,153,55,98,0,0,0
2021-11-25 18:15,150,54,96,0,0,0
2021-11-25 18:30,151,50,101,0,0,0
2021-11-25 18:45,166,65,101,0,0,0
2021-11-25 19:00,117,43,74,0,0,0
2021-11-25 19:15,109,47,62,0,0,0
2021-11-25 19:30,115,31,84,0,0,0
2021-11-25 19:45,92,26,66,0,0,0
2021-11-25 20:00,116,23,93,0,0,0
2021-11-25 20:15,104,19,85,0,0,0
2021-11-25 20:30,68,14,54,0,0,0
2021-11-25 20:45,64,14,50,0,0,0
2021-11-25 21:00,44,12,32,0,0,0
2021-11-25 21:15,46,4,42,0,0,0
2021-11-25 21:30,35,15,20,0,0,0
2021-11-25 21:45,44,10,34,0,0,0
2021-11-25 22:00,74,16,58,0,0,0
2021-11-25 22:15,48,13,35,0,0,0
2021-11-25 22:30,56,16,40,0,0,0
2021-11-25 22:45,31,9,22,0,0,0
2021-11-25 23:00,30,6,24,0,0,0
2021-11-25 23:15,32,8,24,0,0,0
2021-11-25 23:30,19,6,13,0,0,0
2021-11-25 23:45,21,12,9,0,0,0
2021-11-26 00:00,19,4,15,0,0,0
2021-11-26 00:15,24,11,13,0,0,0
2021-11-26 00:30,16,5,11,0,0,0
2021-11-26 00:45,13,4,9,0,0,0
2021-11-26 01:00,9,2,7,0,0,0
2021-11-26 01:15,5,2,3,0,0,0
2021-11-26 01:30,8,5,3,0,0,0
2021-11-26 01:45,4,0,4,0,0,0
2021-11-26 02:00,5,1,4,0,0,0
2021-11-26 02:15,1,0,1,0,0,0
2021-11-26 02:30,4,0,4,0,0,0
2021-11-26 02:45,2,1,1,0,0,0
2021-11-26 03:00,3,1,2,0,0,0
2021-11-26 03:15,0,0,0,0,0,0
2021-11-26 03:30,3,0,3,0,0,0
2021-11-26 03:45,2,2,0,0,0,0
2021-11-26 04:00,0,0,0,0,0,0
2021-11-26 04:15,2,2,0,0,0,0
2021-11-26 04:30,6,4,2,0,0,0
2021-11-26 04:45,2,1,1,0,0,0
2021-11-26 05:00,2,2,0,0,0,0
2021-11-26 05:15,10,5,5,0,0,0
2021-11-26 05:30,11,8,3,0,0,0
2021-11-26 05:45,21,15,6,0,0,0
2021-11-26 06:00,20,16,4,0,0,0
2021-11-26 06:15,28,24,4,0,0,0
2021-11-26 06:30,30,20,10,0,0,0
2021-11-26 06:45,45,26,19,0,0,0
2021-11-26 07:00,67,49,18,0,0,0
2021-11-26 07:15,73,47,26,0,0,0
2021-11-26 07:30,107,76,31,0,0,0
2021-11-26 07:45,146,90,56,0,0,0
2021-11-26 08:00,112,76,36,0,0,0
2021-11-26 08:15,120,78,42,0,0,0
2021-11-26 08:30,82,53,29,0,0,0
2021-11-26 08:45,98,66,32,0,0,0
2021-11-26 09:00,81,46,35,0,0,0
2021-11-26 09:15,62,36,26,0,0,0
2021-11-26 09:30,82,60,22,0,0,0
2021-11-26 09:45,97,67,30,0,0,0
2021-11-26 10:00,109,70,39,0,0,0
2021-11-26 10:15,109,62,47,0,0,0
2021-11-26 10:30,105,58,47,0,0,0
2021-11-26 10:45,102,67,35,0,0,0
2021-11-26 11:00,89,44,45,0,0,0
2021-11-26 11:15,101,40,61,0,0,0
2021-11-26 11:30,122,49,73,0,0,0
2021-11-26 11:45,128,68,60,0,0,0
2021-11-26 12:00,158,56,102,0,0,0
2021-11-26 12:15,149,60,89,0,0,0
2021-11-26 12:30,133,52,81,0,0,0
2021-11-26 12:45,153,65,88,0,0,0
2021-11-26 13:00,175,59,116,0,0,0
2021-11-26 13:15,173,70,103,0,0,0
2021-11-26 13:30,154,73,81,0,0,0
2021-11-26 13:45,173,90,83,0,0,0
2021-11-26 14:00,160,58,102,0,0,0
2021-11-26 14:15,192,84,108,0,0,0
2021-11-26 14:30,167,56,111,0,0,0
2021-11-26 14:45,176,83,93,0,0,0
2021-11-26 15:00,150,55,95,0,0,0
2021-11-26 15:15,171,69,102,0,0,0
2021-11-26 15:30,163,58,105,0,0,0
2021-11-26 15:45,167,61,106,0,0,0
2021-11-26 16:00,177,68,109,0,0,0
2021-11-26 16:15,170,79,91,0,0,0
2021-11-26 16:30,175,83,92,0,0,0
2021-11-26 16:45,172,73,99,0,0,0
2021-11-26 17:00,141,50,91,0,0,0
2021-11-26 17:15,138,60,78,0,0,0
2021-11-26 17:30,130,49,81,0,0,0
2021-11-26 17:45,154,43,111,0,0,0
2021-11-26 18:00,161,49,112,0,0,0
2021-11-26 18:15,149,65,84,0,0,0
2021-11-26 18:30,125,39,86,0,0,0
2021-11-26 18:45,109,42,67,0,0,0
2021-11-26 19:00,116,45,71,0,0,0
2021-11-26 19:15,121,51,70,0,0,0
2021-11-26 19:30,77,28,49,0,0,0
2021-11-26 19:45,94,43,51,0,0,0
2021-11-26 20:00,76,27,49,0,0,0
2021-11-26 20:15,76,24,52,0,0,0
2021-11-26 20:30,49,17,32,0,0,0
2021-11-26 20:45,43,16,27,0,0,0
2021-11-26 21:00,92,40,52,0,0,0
2021-11-26 21:15,82,53,29,0,0,0
2021-11-26 21:30,55,17,38,0,0,0
2021-11-26 21:45,51,15,36,0,0,0
2021-11-26 22:00,54,16,38,0,0,0
2021-11-26 22:15,50,20,30,0,0,0
2021-11-26 22:30,49,16,33,0,0,0
2021-11-26 22:45,42,19,23,0,0,0
2021-11-26 23:00,38,15,23,0,0,0
2021-11-26 23:15,38,23,15,0,0,0
2021-11-26 23:30,57,17,40,0,0,0
2021-11-26 23:45,54,14,40,0,0,0
2021-11-27 00:00,32,6,26,0,0,0
2021-11-27 00:15,37,18,19,0,0,0
2021-11-27 00:30,20,4,16,0,0,0
2021-11-27 00:45,15,5,10,0,0,0
2021-11-27 01:00,12,3,9,0,0,0
2021-11-27 01:15,26,12,14,0,0,0
2021-11-27 01:30,17,8,9,0,0,0
2021-11-27 01:45,15,2,13,0,0,0
2021-11-27 02:00,22,4,18,0,0,0
2021-11-27 02:15,16,4,12,0,0,0
2021-11-27 02:30,11,9,2,0,0,0
2021-11-27 02:45,13,3,10,0,0,0
2021-11-27 03:00,12,2,10,0,0,0
2021-11-27 03:15,13,2,11,0,0,0
2021-11-27 03:30,6,0,6,0,0,0
2021-11-27 03:45,5,0,5,0,0,0
2021-11-27 04:00,4,1,3,0,0,0
2021-11-27 04:15,8,2,6,0,0,0
2021-11-27 04:30,5,2,3,0,0,0
2021-11-27 04:45,5,3,2,0,0,0
2021-11-27 05:00,4,2,2,0,0,0
2021-11-27 05:15,9,3,6,0,0,0
2021-11-27 05:30,10,4,6,0,0,0
2021-11-27 05:45,6,6,0,0,0,0
2021-11-27 06:00,9,5,4,0,0,0
2021-11-27 06:15,6,1,5,0,0,0
2021-11-27 06:30,7,3,4,0,0,0
2021-11-27 06:45,9,4,5,0,0,0
2021-11-27 07:00,11,6,5,0,0,0
2021-11-27 07:15,16,10,6,0,0,0
2021-11-27 07:30,22,12,10,0,0,0
2021-11-27 07:45,23,13,10,0,0,0
2021-11-27 08:00,22,17,5,0,0,0
2021-11-27 08:15,25,17,8,0,0,0
2021-11-27 08:30,32,18,14,0,0,0
2021-11-27 08:45,47,30,17,0,0,0
2021-11-27 09:00,49,38,11,0,0,0
2021-11-27 09:15,63,37,26,0,0,0
2021-11-27 09:30,62,47,15,0,0,0
2021-11-27 09:45,116,81,35,0,0,0
2021-11-27 10:00,102,70,32,0,0,0
2021-11-27 10:15,94,56,38,0,0,0
2021-11-27 10:30,112,70,42,0,0,0
2021-11-27 10:45,118,68,50,0,0,0
2021-11-27 11:00,127,74,53,0,0,0
2021-11-27 11:15,115,61,54,0,0,0
2021-11-27 11:30,113,47,66,0,0,0
2021-11-27 11:45,117,68,49,0,0,0
2021-11-27 12:00,128,57,71,0,0,0
2021-11-27 12:15,144,60,84,0,0,0
2021-11-27 12:30,108,50,58,0,0,0
2021-11-27 12:45,114,60,54,0,0,0
2021-11-27 13:00,129,66,63,0,0,0
2021-11-27 13:15,138,57,81,0,0,0
2021-11-27 13:30,122,58,64,0,0,0
2021-11-27 13:45,124,66,58,0,0,0
2021-11-27 14:00,149,62,87,0,0,0
2021-11-27 14:15,123,57,66,0,0,0
2021-11-27 14:30,106,47,59,0,0,0
2021-11-27 14:45,128,47,81,0,0,0
2021-11-27 15:00,114,48,66,0,0,0
2021-11-27 15:15,139,56,83,0,0,0
2021-11-27 15:30,109,54,55,0,0,0
2021-11-27 15:45,119,51,68,0,0,0
2021-11-27 16:00,99,44,55,0,0,0
2021-11-27 16:15,126,56,70,0,0,0
2021-11-27 16:30,123,55,68,0,0,0
2021-11-27 16:45,117,53,64,0,0,0
2021-11-27 17:00,103,42,61,0,0,0
2021-11-27 17:15,84,39,45,0,0,0
2021-11-27 17:30,96,38,58,0,0,0
2021-11-27 17:45,119,59,60,0,0,0
2021-11-27 18:00,110,35,75,0,0,0
2021-11-27 18:15,101,38,63,0,0,0
2021-11-27 18:30,97,38,59,0,0,0
2021-11-27 18:45,112,61,51,0,0,0
2021-11-27 19:00,109,50,59,0,0,0
2021-11-27 19:15,77,32,45,0,0,0
2021-11-27 19:30,76,34,42,0,0,0
2021-11-27 19:45,77,41,36,0,0,0
2021-11-27 20:00,80,26,54,0,0,0
2021-11-27 20:15,62,17,45,0,0,0
2021-11-27 20:30,65,19,46,0,0,0
2021-11-27 20:45,51,18,33,0,0,0
2021-11-27 21:00,53,18,35,0,0,0
2021-11-27 21:15,55,11,44,0,0,0
2021-11-27 21:30,47,19,28,0,0,0
2021-11-27 21:45,32,5,27,0,0,0
2021-11-27 22:00,55,11,44,0,0,0
2021-11-27 22:15,38,10,28,0,0,0
2021-11-27 22:30,44,11,33,0,0,0
2021-11-27 22:45,39,13,26,0,0,0
2021-11-27 23:00,29,6,23,0,0,0
2021-11-27 23:15,29,11,18,0,0,0
2021-11-27 23:30,35,13,22,0,0,0
2021-11-27 23:45,34,9,25,0,0,0
2021-11-28 00:00,39,17,22,0,0,0
2021-11-28 00:15,25,7,18,0,0,0
2021-11-28 00:30,15,8,7,0,0,0
2021-11-28 00:45,24,14,10,0,0,0
2021-11-28 01:00,20,5,15,0,0,0
2021-11-28 01:15,11,7,4,0,0,0
2021-11-28 01:30,16,8,8,0,0,0
2021-11-28 01:45,24,6,18,0,0,0
2021-11-28 02:00,22,16,6,0,0,0
2021-11-28 02:15,14,3,11,0,0,0
2021-11-28 02:30,19,8,11,0,0,0
2021-11-28 02:45,12,3,9,0,0,0
2021-11-28 03:00,20,6,14,0,0,0
2021-11-28 03:15,5,2,3,0,0,0
2021-11-28 03:30,7,2,5,0,0,0
2021-11-28 03:45,7,3,4,0,0,0
2021-11-28 04:00,7,2,5,0,0,0
2021-11-28 04:15,2,0,2,0,0,0
2021-11-28 04:30,3,1,2,0,0,0
2021-11-28 04:45,7,3,4,0,0,0
2021-11-28 05:00,2,1,1,0,0,0
2021-11-28 05:15,3,1,2,0,0,0
2021-11-28 05:30,10,6,4,0,0,0
2021-11-28 05:45,4,2,2,0,0,0
2021-11-28 06:00,1,1,0,0,0,0
2021-11-28 06:15,2,1,1,0,0,0
2021-11-28 06:30,7,4,3,0,0,0
2021-11-28 06:45,1,0,1,0,0,0
2021-11-28 07:00,1,0,1,0,0,0
2021-11-28 07:15,0,0,0,0,0,0
2021-11-28 07:30,5,5,0,0,0,0
2021-11-28 07:45,13,9,4,0,0,0
2021-11-28 08:00,10,6,4,0,0,0
2021-11-28 08:15,3,1,2,0,0,0
2021-11-28 08:30,14,8,6,0,0,0
2021-11-28 08:45,20,10,10,0,0,0
2021-11-28 09:00,13,9,4,0,0,0
2021-11-28 09:15,18,12,6,0,0,0
2021-11-28 09:30,26,13,13,0,0,0
2021-11-28 09:45,26,17,9,0,0,0
2021-11-28 10:00,25,15,10,0,0,0
2021-11-28 10:15,29,19,10,0,0,0
2021-11-28 10:30,37,14,23,0,0,0
2021-11-28 10:45,36,18,18,0,0,0
2021-11-28 11:00,23,8,15,0,0,0
2021-11-28 11:15,34,17,17,0,0,0
2021-11-28 11:30,47,29,18,0,0,0
2021-11-28 11:45,45,19,26,0,0,0
2021-11-28 12:00,53,31,22,0,0,0
2021-11-28 12:15,49,22,27,0,0,0
2021-11-28 12:30,51,19,32,0,0,0
2021-11-28 12:45,66,27,39,0,0,0
2021-11-28 13:00,56,28,28,0,0,0
2021-11-28 13:15,59,28,31,0,0,0
2021-11-28 13:30,45,22,23,0,0,0
2021-11-28 13:45,74,46,28,0,0,0
2021-11-28 14:00,75,41,34,0,0,0
2021-11-28 14:15,68,33,35,0,0,0
2021-11-28 14:30,52,25,27,0,0,0
2021-11-28 14:45,80,46,34,0,0,0
2021-11-28 15:00,57,19,38,0,0,0
2021-11-28 15:15,49,25,24,0,0,0
2021-11-28 15:30,62,23,39,0,0,0
2021-11-28 15:45,82,44,38,0,0,0
2021-11-28 16:00,71,22,49,0,0,0
2021-11-28 16:15,46,22,24,0,0,0
2021-11-28 16:30,52,27,25,0,0,0
2021-11-28 16:45,73,31,42,0,0,0
2021-11-28 17:00,56,26,30,0,0,0
2021-11-28 17:15,58,30,28,0,0,0
2021-11-28 17:30,46,25,21,0,0,0
2021-11-28 17:45,72,33,39,0,0,0
2021-11-28 18:00,67,18,49,0,0,0
2021-11-28 18:15,54,24,30,0,0,0
2021-11-28 18:30,48,20,28,0,0,0
2021-11-28 18:45,54,22,32,0,0,0
2021-11-28 19:00,45,16,29,0,0,0
2021-11-28 19:15,59,25,34,0,0,0
2021-11-28 19:30,46,18,28,0,0,0
2021-11-28 19:45,35,14,21,0,0,0
2021-11-28 20:00,37,11,26,0,0,0
2021-11-28 20:15,24,6,18,0,0,0
2021-11-28 20:30,44,12,32,0,0,0
2021-11-28 20:45,38,7,31,0,0,0
2021-11-28 21:00,36,10,26,0,0,0
2021-11-28 21:15,23,3,20,0,0,0
2021-11-28 21:30,14,7,7,0,0,0
2021-11-28 21:45,26,7,19,0,0,0
2021-11-28 22:00,18,4,14,0,0,0
2021-11-28 22:15,25,9,16,0,0,0
2021-11-28 22:30,18,5,13,0,0,0
2021-11-28 22:45,12,1,11,0,0,0
2021-11-28 23:00,8,1,7,0,0,0
2021-11-28 23:15,6,3,3,0,0,0
2021-11-28 23:30,4,2,2,0,0,0
2021-11-28 23:45,4,0,4,0,0,0
2021-11-29 00:00,1,1,0,0,0,0
2021-11-29 00:15,3,0,3,0,0,0
2021-11-29 00:30,6,1,5,0,0,0
2021-11-29 00:45,3,0,3,0,0,0
2021-11-29 01:00,3,3,0,0,0,0
2021-11-29 01:15,1,0,1,0,0,0
2021-11-29 01:30,3,0,3,0,0,0
2021-11-29 01:45,3,3,0,0,0,0
2021-11-29 02:00,0,0,0,0,0,0
2021-11-29 02:15,0,0,0,0,0,0
2021-11-29 02:30,0,0,0,0,0,0
2021-11-29 02:45,1,0,1,0,0,0
2021-11-29 03:00,0,0,0,0,0,0
2021-11-29 03:15,2,2,0,0,0,0
2021-11-29 03:30,1,0,1,0,0,0
2021-11-29 03:45,0,0,0,0,0,0
2021-11-29 04:00,0,0,0,0,0,0
2021-11-29 04:15,3,2,1,0,0,0
2021-11-29 04:30,2,1,1,0,0,0
2021-11-29 04:45,2,2,0,0,0,0
2021-11-29 05:00,2,2,0,0,0,0
2021-11-29 05:15,9,9,0,0,0,0
2021-11-29 05:30,13,10,3,0,0,0
2021-11-29 05:45,25,18,7,0,0,0
2021-11-29 06:00,30,23,7,0,0,0
2021-11-29 06:15,24,17,7,0,0,0
2021-11-29 06:30,50,31,19,0,0,0
2021-11-29 06:45,54,34,20,0,0,0
2021-11-29 07:00,56,37,19,0,0,0
2021-11-29 07:15,82,62,20,0,0,0
2021-11-29 07:30,141,90,51,0,0,0
2021-11-29 07:45,179,135,44,0,0,0
2021-11-29 08:00,157,93,64,0,0,0
2021-11-29 08:15,118,77,41,0,0,0
2021-11-29 08:30,103,68,35,0,0,0
2021-11-29 08:45,109,74,35,0,0,0
2021-11-29 09:00,80,57,23,0,0,0
2021-11-29 09:15,93,68,25,0,0,0
2021-11-29 09:30,88,61,27,0,0,0
2021-11-29 09:45,112,79,33,0,0,0
2021-11-29 10:00,85,61,24,0,0,0
2021-11-29 10:15,94,59,35,0,0,0
2021-11-29 10:30,89,47,42,0,0,0
2021-11-29 10:45,99,63,36,0,0,0
2021-11-29 11:00,90,47,43,0,0,0
2021-11-29 11:15,98,53,45,0,0,0
2021-11-29 11:30,84,45,39,0,0,0
2021-11-29 11:45,134,55,79,0,0,0
2021-11-29 12:00,114,53,61,0,0,0
2021-11-29 12:15,105,58,47,0,0,0
2021-11-29 12:30,128,63,65,0,0,0
2021-11-29 12:45,130,57,73,0,0,0
2021-11-29 13:00,129,60,69,0,0,0
2021-11-29 13:15,112,40,72,0,0,0
2021-11-29 13:30,119,48,71,0,0,0
2021-11-29 13:45,133,71,62,0,0,0
2021-11-29 14:00,139,55,84,0,0,0
2021-11-29 14:15,118,49,69,0,0,0
2021-11-29 14:30,118,48,70,0,0,0
2021-11-29 14:45,162,77,85,0,0,0
2021-11-29 15:00,171,79,92,0,0,0
2021-11-29 15:15,134,64,70,0,0,0
2021-11-29 15:30,156,64,92,0,0,0
2021-11-29 15:45,211,92,119,0,0,0
2021-11-29 16:00,209,87,122,0,0,0
2021-11-29 16:15,182,77,105,0,0,0
2021-11-29 16:30,165,66,99,0,0,0
2021-11-29 16:45,199,74,125,0,0,0
2021-11-29 17:00,181,65,116,0,0,0
2021-11-29 17:15,187,72,115,0,0,0
2021-11-29 17:30,177,72,105,0,0,0
2021-11-29 17:45,184,70,114,0,0,0
2021-11-29 18:00,182,57,125,0,0,0
2021-11-29 18:15,192,82,110,0,0,0
2021-11-29 18:30,107,32,75,0,0,0
2021-11-29 18:45,129,50,79,0,0,0
2021-11-29 19:00,118,40,78,0,0,0
2021-11-29 19:15,101,31,70,0,0,0
2021-11-29 19:30,96,23,73,0,0,0
2021-11-29 19:45,97,28,69,0,0,0
2021-11-29 20:00,111,33,78,0,0,0
2021-11-29 20:15,80,26,54,0,0,0
2021-11-29 20:30,51,13,38,0,0,0
2021-11-29 20:45,35,12,23,0,0,0
2021-11-29 21:00,28,8,20,0,0,0
2021-11-29 21:15,39,12,27,0,0,0
2021-11-29 21:30,34,9,25,0,0,0
2021-11-29 21:45,47,13,34,0,0,0
2021-11-29 22:00,39,5,34,0,0,0
2021-11-29 22:15,33,14,19,0,0,0
2021-11-29 22:30,32,11,21,0,0,0
2021-11-29 22:45,22,9,13,0,0,0
2021-11-29 23:00,16,1,15,0,0,0
2021-11-29 23:15,11,3,8,0,0,0
2021-11-29 23:30,22,5,17,0,0,0
2021-11-29 23:45,13,7,6,0,0,0
