Datetime,100034980 (Hammer Straße),101034980 (Hammer Straße stadteinwärts),102034980 (Hammer Straße stadtauswärts),100034980-status,101034980-status,102034980-status
2021-10-01 00:00,14,4,10,0,0,0
2021-10-01 00:15,15,1,14,0,0,0
2021-10-01 00:30,14,2,12,0,0,0
2021-10-01 00:45,16,9,7,0,0,0
2021-10-01 01:00,15,6,9,0,0,0
2021-10-01 01:15,3,0,3,0,0,0
2021-10-01 01:30,10,2,8,0,0,0
2021-10-01 01:45,4,2,2,0,0,0
2021-10-01 02:00,13,2,11,0,0,0
2021-10-01 02:15,8,1,7,0,0,0
2021-10-01 02:30,7,3,4,0,0,0
2021-10-01 02:45,6,0,6,0,0,0
2021-10-01 03:00,1,1,0,0,0,0
2021-10-01 03:15,3,1,2,0,0,0
2021-10-01 03:30,0,0,0,0,0,0
2021-10-01 03:45,4,0,4,0,0,0
2021-10-01 04:00,0,0,0,0,0,0
2021-10-01 04:15,3,2,1,0,0,0
2021-10-01 04:30,4,1,3,0,0,0
2021-10-01 04:45,1,1,0,0,0,0
2021-10-01 05:00,3,2,1,0,0,0
2021-10-01 05:15,9,6,3,0,0,0
2021-10-01 05:30,18,12,6,0,0,0
2021-10-01 05:45,24,16,8,0,0,0
2021-10-01 06:00,25,21,4,0,0,0
2021-10-01 06:15,28,17,11,0,0,0
2021-10-01 06:30,32,21,11,0,0,0
2021-10-01 06:45,41,25,16,0,0,0
2021-10-01 07:00,73,46,27,0,0,0
2021-10-01 07:15,77,53,24,0,0,0
2021-10-01 07:30,158,93,65,0,0,0
2021-10-01 07:45,160,106,54,0,0,0
2021-10-01 08:00,136,78,58,0,0,0
2021-10-01 08:15,125,77,48,0,0,0
2021-10-01 08:30,113,76,37,0,0,0
2021-10-01 08:45,123,88,35,0,0,0
2021-10-01 09:00,80,48,32,0,0,0
2021-10-01 09:15,101,64,37,0,0,0
2021-10-01 09:30,101,63,38,0,0,0
2021-10-01 09:45,121,78,43,0,0,0
2021-10-01 10:00,94,50,44,0,0,0
2021-10-01 10:15,97,55,42,0,0,0
2021-10-01 10:30,113,64,49,0,0,0
2021-10-01 10:45,115,63,52,0,0,0
2021-10-01 11:00,123,63,60,0,0,0
2021-10-01 11:15,116,58,58,0,0,0
2021-10-01 11:30,137,75,62,0,0,0
2021-10-01 11:45,149,73,76,0,0,0
2021-10-01 12:00,154,73,81,0,0,0
2021-10-01 12:15,137,59,78,0,0,0
2021-10-01 12:30,136,63,73,0,0,0
2021-10-01 12:45,133,60,73,0,0,0
2021-10-01 13:00,205,87,118,0,0,0
2021-10-01 13:15,177,64,113,0,0,0
2021-10-01 13:30,163,60,103,0,0,0
2021-10-01 13:45,181,87,94,0,0,0
2021-10-01 14:00,175,80,95,0,0,0
2021-10-01 14:15,172,73,99,0,0,0
2021-10-01 14:30,189,76,113,0,0,0
2021-10-01 14:45,190,87,103,0,0,0
2021-10-01 15:00,180,90,90,0,0,0
2021-10-01 15:15,188,89,99,0,0,0
2021-10-01 15:30,163,83,80,0,0,0
2021-10-01 15:45,166,73,93,0,0,0
2021-10-01 16:00,213,90,123,0,0,0
2021-10-01 16:15,179,77,102,0,0,0
2021-10-01 16:30,179,92,87,0,0,0
2021-10-01 16:45,198,89,109,0,0,0
2021-10-01 17:00,139,57,82,0,0,0
2021-10-01 17:15,167,78,89,0,0,0
2021-10-01 17:30,156,65,91,0,0,0
2021-10-01 17:45,156,69,87,0,0,0
2021-10-01 18:00,143,52,91,0,0,0
2021-10-01 18:15,149,57,92,0,0,0
2021-10-01 18:30,127,55,72,0,0,0
2021-10-01 18:45,148,59,89,0,0,0
2021-10-01 19:00,130,46,84,0,0,0
2021-10-01 19:15,110,49,61,0,0,0
2021-10-01 19:30,86,34,52,0,0,0
2021-10-01 19:45,77,33,44,0,0,0
2021-10-01 20:00,101,29,72,0,0,0
2021-10-01 20:15,84,37,47,0,0,0
2021-10-01 20:30,56,16,40,0,0,0
2021-10-01 20:45,52,29,23,0,0,0
2021-10-01 21:00,62,16,46,0,0,0
2021-10-01 21:15,49,28,21,0,0,0
2021-10-01 21:30,42,15,27,0,0,0
2021-10-01 21:45,32,14,18,0,0,0
2021-10-01 22:00,55,14,41,0,0,0
2021-10-01 22:15,50,17,33,0,0,0
2021-10-01 22:30,53,16,37,0,0,0
2021-10-01 22:45,49,23,26,0,0,0
2021-10-01 23:00,39,7,32,0,0,0
2021-10-01 23:15,42,17,25,0,0,0
2021-10-01 23:30,53,27,26,0,0,0
2021-10-01 23:45,62,27,35,0,0,0
2021-10-02 00:00,34,12,22,0,0,0
2021-10-02 00:15,14,7,7,0,0,0
2021-10-02 00:30,20,7,13,0,0,0
2021-10-02 00:45,22,9,13,0,0,0
2021-10-02 01:00,41,16,25,0,0,0
2021-10-02 01:15,18,4,14,0,0,0
2021-10-02 01:30,22,10,12,0,0,0
2021-10-02 01:45,9,4,5,0,0,0
2021-10-02 02:00,16,8,8,0,0,0
2021-10-02 02:15,8,3,5,0,0,0
2021-10-02 02:30,17,9,8,0,0,0
2021-10-02 02:45,10,0,10,0,0,0
2021-10-02 03:00,16,12,4,0,0,0
2021-10-02 03:15,14,6,8,0,0,0
2021-10-02 03:30,15,2,13,0,0,0
2021-10-02 03:45,5,0,5,0,0,0
2021-10-02 04:00,8,2,6,0,0,0
2021-10-02 04:15,3,0,3,0,0,0
2021-10-02 04:30,6,0,6,0,0,0
2021-10-02 04:45,8,3,5,0,0,0
2021-10-02 05:00,3,0,3,0,0,0
2021-10-02 05:15,5,4,1,0,0,0
2021-10-02 05:30,9,5,4,0,0,0
2021-10-02 05:45,12,8,4,0,0,0
2021-10-02 06:00,9,7,2,0,0,0
2021-10-02 06:15,8,7,1,0,0,0
2021-10-02 06:30,11,6,5,0,0,0
2021-10-02 06:45,13,9,4,0,0,0
2021-10-02 07:00,10,7,3,0,0,0
2021-10-02 07:15,13,9,4,0,0,0
2021-10-02 07:30,18,14,4,0,0,0
2021-10-02 07:45,28,15,13,0,0,0
2021-10-02 08:00,24,8,16,0,0,0
2021-10-02 08:15,23,11,12,0,0,0
2021-10-02 08:30,28,19,9,0,0,0
2021-10-02 08:45,51,33,18,0,0,0
2021-10-02 09:00,39,24,15,0,0,0
2021-10-02 09:15,58,42,16,0,0,0
2021-10-02 09:30,63,45,18,0,0,0
2021-10-02 09:45,98,73,25,0,0,0
2021-10-02 10:00,101,69,32,0,0,0
2021-10-02 10:15,133,79,54,0,0,0
2021-10-02 10:30,113,75,38,0,0,0
2021-10-02 10:45,135,97,38,0,0,0
2021-10-02 11:00,144,93,51,0,0,0
2021-10-02 11:15,114,70,44,0,0,0
2021-10-02 11:30,134,73,61,0,0,0
2021-10-02 11:45,169,93,76,0,0,0
2021-10-02 12:00,130,76,54,0,0,0
2021-10-02 12:15,150,88,62,0,0,0
2021-10-02 12:30,124,78,46,0,0,0
2021-10-02 12:45,155,77,78,0,0,0
2021-10-02 13:00,124,61,63,0,0,0
2021-10-02 13:15,171,83,88,0,0,0
2021-10-02 13:30,145,75,70,0,0,0
2021-10-02 13:45,162,74,88,0,0,0
2021-10-02 14:00,171,74,97,0,0,0
2021-10-02 14:15,191,82,109,0,0,0
2021-10-02 14:30,155,62,93,0,0,0
2021-10-02 14:45,163,62,101,0,0,0
2021-10-02 15:00,135,59,76,0,0,0
2021-10-02 15:15,151,62,89,0,0,0
2021-10-02 15:30,141,56,85,0,0,0
2021-10-02 15:45,106,49,57,0,0,0
2021-10-02 16:00,130,55,75,0,0,0
2021-10-02 16:15,130,54,76,0,0,0
2021-10-02 16:30,105,44,61,0,0,0
2021-10-02 16:45,115,42,73,0,0,0
2021-10-02 17:00,130,62,68,0,0,0
2021-10-02 17:15,126,42,84,0,0,0
2021-10-02 17:30,110,47,63,0,0,0
2021-10-02 17:45,126,50,76,0,0,0
2021-10-02 18:00,141,47,94,0,0,0
2021-10-02 18:15,97,33,64,0,0,0
2021-10-02 18:30,121,45,76,0,0,0
2021-10-02 18:45,123,51,72,0,0,0
2021-10-02 19:00,111,43,68,0,0,0
2021-10-02 19:15,87,33,54,0,0,0
2021-10-02 19:30,67,26,41,0,0,0
2021-10-02 19:45,79,36,43,0,0,0
2021-10-02 20:00,82,36,46,0,0,0
2021-10-02 20:15,57,24,33,0,0,0
2021-10-02 20:30,72,26,46,0,0,0
2021-10-02 20:45,59,28,31,0,0,0
2021-10-02 21:00,42,12,30,0,0,0
2021-10-02 21:15,42,14,28,0,0,0
2021-10-02 21:30,92,57,35,0,0,0
2021-10-02 21:45,86,60,26,0,0,0
2021-10-02 22:00,50,21,29,0,0,0
2021-10-02 22:15,41,17,24,0,0,0
2021-10-02 22:30,36,14,22,0,0,0
2021-10-02 22:45,35,14,21,0,0,0
2021-10-02 23:00,41,24,17,0,0,0
2021-10-02 23:15,21,8,13,0,0,0
2021-10-02 23:30,19,10,9,0,0,0
2021-10-02 23:45,44,21,23,0,0,0
2021-10-03 00:00,33,10,23,0,0,0
2021-10-03 00:15,44,13,31,0,0,0
2021-10-03 00:30,33,13,20,0,0,0
2021-10-03 00:45,26,12,14,0,0,0
2021-10-03 01:00,22,5,17,0,0,0
2021-10-03 01:15,20,4,16,0,0,0
2021-10-03 01:30,24,13,11,0,0,0
2021-10-03 01:45,19,14,5,0,0,0
2021-10-03 02:00,13,7,6,0,0,0
2021-10-03 02:15,10,2,8,0,0,0
2021-10-03 02:30,17,6,11,0,0,0
2021-10-03 02:45,15,4,11,0,0,0
2021-10-03 03:00,21,8,13,0,0,0
2021-10-03 03:15,15,4,11,0,0,0
2021-10-03 03:30,9,1,8,0,0,0
2021-10-03 03:45,12,2,10,0,0,0
2021-10-03 04:00,7,4,3,0,0,0
2021-10-03 04:15,3,0,3,0,0,0
2021-10-03 04:30,5,1,4,0,0,0
2021-10-03 04:45,6,0,6,0,0,0
2021-10-03 05:00,5,0,5,0,0,0
2021-10-03 05:15,8,3,5,0,0,0
2021-10-03 05:30,4,2,2,0,0,0
2021-10-03 05:45,6,3,3,0,0,0
2021-10-03 06:00,0,0,0,0,0,0
2021-10-03 06:15,5,3,2,0,0,0
2021-10-03 06:30,8,2,6,0,0,0
2021-10-03 06:45,3,1,2,0,0,0
2021-10-03 07:00,3,1,2,0,0,0
2021-10-03 07:15,7,4,3,0,0,0
2021-10-03 07:30,4,4,0,0,0,0
2021-10-03 07:45,7,5,2,0,0,0
2021-10-03 08:00,8,3,5,0,0,0
2021-10-03 08:15,4,4,0,0,0,0
2021-10-03 08:30,9,7,2,0,0,0
2021-10-03 08:45,16,13,3,0,0,0
2021-10-03 09:00,13,9,4,0,0,0
2021-10-03 09:15,14,6,8,0,0,0
2021-10-03 09:30,22,10,12,0,0,0
2021-10-03 09:45,32,17,15,0,0,0
2021-10-03 10:00,27,17,10,0,0,0
2021-10-03 10:15,18,8,10,0,0,0
2021-10-03 10:30,14,7,7,0,0,0
2021-10-03 10:45,28,14,14,0,0,0
2021-10-03 11:00,14,5,9,0,0,0
2021-10-03 11:15,16,2,14,0,0,0
2021-10-03 11:30,25,15,10,0,0,0
2021-10-03 11:45,23,13,10,0,0,0
2021-10-03 12:00,32,16,16,0,0,0
2021-10-03 12:15,29,16,13,0,0,0
2021-10-03 12:30,31,15,16,0,0,0
2021-10-03 12:45,36,23,13,0,0,0
2021-10-03 13:00,31,12,19,0,0,0
2021-10-03 13:15,30,18,12,0,0,0
2021-10-03 13:30,29,15,14,0,0,0
2021-10-03 13:45,37,19,18,0,0,0
2021-10-03 14:00,37,15,22,0,0,0
2021-10-03 14:15,32,12,20,0,0,0
2021-10-03 14:30,40,20,20,0,0,0
2021-10-03 14:45,41,21,20,0,0,0
2021-10-03 15:00,37,18,19,0,0,0
2021-10-03 15:15,39,15,24,0,0,0
2021-10-03 15:30,54,23,31,0,0,0
2021-10-03 15:45,45,25,20,0,0,0
2021-10-03 16:00,52,34,18,0,0,0
2021-10-03 16:15,55,29,26,0,0,0
2021-10-03 16:30,52,22,30,0,0,0
2021-10-03 16:45,44,17,27,0,0,0
2021-10-03 17:00,41,16,25,0,0,0
2021-10-03 17:15,47,24,23,0,0,0
2021-10-03 17:30,56,32,24,0,0,0
2021-10-03 17:45,84,39,45,0,0,0
2021-10-03 18:00,54,24,30,0,0,0
2021-10-03 18:15,34,13,21,0,0,0
2021-10-03 18:30,37,9,28,0,0,0
2021-10-03 18:45,38,22,16,0,0,0
2021-10-03 19:00,43,16,27,0,0,0
2021-10-03 19:15,37,20,17,0,0,0
2021-10-03 19:30,33,11,22,0,0,0
2021-10-03 19:45,41,21,20,0,0,0
2021-10-03 20:00,36,15,21,0,0,0
2021-10-03 20:15,32,10,22,0,0,0
2021-10-03 20:30,26,6,20,0,0,0
2021-10-03 20:45,25,11,14,0,0,0
2021-10-03 21:00,28,5,23,0,0,0
2021-10-03 21:15,25,6,19,0,0,0
2021-10-03 21:30,32,14,18,0,0,0
2021-10-03 21:45,24,10,14,0,0,0
2021-10-03 22:00,23,10,13,0,0,0
2021-10-03 22:15,16,7,9,0,0,0
2021-10-03 22:30,6,2,4,0,0,0
2021-10-03 22:45,15,6,9,0,0,0
2021-10-03 23:00,11,6,5,0,0,0
2021-10-03 23:15,16,6,10,0,0,0
2021-10-03 23:30,10,2,8,0,0,0
2021-10-03 23:45,12,4,8,0,0,0
2021-10-04 00:00,5,0,5,0,0,0
2021-10-04 00:15,5,1,4,0,0,0
2021-10-04 00:30,1,0,1,0,0,0
2021-10-04 00:45,6,2,4,0,0,0
2021-10-04 01:00,2,1,1,0,0,0
2021-10-04 01:15,6,0,6,0,0,0
2021-10-04 01:30,2,1,1,0,0,0
2021-10-04 01:45,0,0,0,0,0,0
2021-10-04 02:00,0,0,0,0,0,0
2021-10-04 02:15,0,0,0,0,0,0
2021-10-04 02:30,2,0,2,0,0,0
2021-10-04 02:45,0,0,0,0,0,0
2021-10-04 03:00,0,0,0,0,0,0
2021-10-04 03:15,2,2,0,0,0,0
2021-10-04 03:30,1,0,1,0,0,0
2021-10-04 03:45,3,0,3,0,0,0
2021-10-04 04:00,0,0,0,0,0,0
2021-10-04 04:15,2,1,1,0,0,0
2021-10-04 04:30,0,0,0,0,0,0
2021-10-04 04:45,5,5,0,0,0,0
2021-10-04 05:00,3,2,1,0,0,0
2021-10-04 05:15,11,9,2,0,0,0
2021-10-04 05:30,16,14,2,0,0,0
2021-10-04 05:45,28,22,6,0,0,0
2021-10-04 06:00,25,19,6,0,0,0
2021-10-04 06:15,32,22,10,0,0,0
2021-10-04 06:30,57,36,21,0,0,0
2021-10-04 06:45,63,36,27,0,0,0
2021-10-04 07:00,78,54,24,0,0,0
2021-10-04 07:15,94,67,27,0,0,0
2021-10-04 07:30,153,104,49,0,0,0
2021-10-04 07:45,203,131,72,0,0,0
2021-10-04 08:00,154,104,50,0,0,0
2021-10-04 08:15,127,78,49,0,0,0
2021-10-04 08:30,130,88,42,0,0,0
2021-10-04 08:45,114,75,39,0,0,0
2021-10-04 09:00,100,62,38,0,0,0
2021-10-04 09:15,113,80,33,0,0,0
2021-10-04 09:30,117,76,41,0,0,0
2021-10-04 09:45,130,88,42,0,0,0
2021-10-04 10:00,82,53,29,0,0,0
2021-10-04 10:15,112,64,48,0,0,0
2021-10-04 10:30,116,64,52,0,0,0
2021-10-04 10:45,101,62,39,0,0,0
2021-10-04 11:00,99,50,49,0,0,0
2021-10-04 11:15,93,53,40,0,0,0
2021-10-04 11:30,125,71,54,0,0,0
2021-10-04 11:45,143,77,66,0,0,0
2021-10-04 12:00,131,60,71,0,0,0
2021-10-04 12:15,127,60,67,0,0,0
2021-10-04 12:30,127,53,74,0,0,0
2021-10-04 12:45,154,71,83,0,0,0
2021-10-04 13:00,174,84,90,0,0,0
2021-10-04 13:15,121,55,66,0,0,0
2021-10-04 13:30,135,61,74,0,0,0
2021-10-04 13:45,150,74,76,0,0,0
2021-10-04 14:00,140,65,75,0,0,0
2021-10-04 14:15,171,80,91,0,0,0
2021-10-04 14:30,190,94,96,0,0,0
2021-10-04 14:45,181,78,103,0,0,0
2021-10-04 15:00,164,69,95,0,0,0
2021-10-04 15:15,186,90,96,0,0,0
2021-10-04 15:30,169,68,101,0,0,0
2021-10-04 15:45,182,56,126,0,0,0
2021-10-04 16:00,209,94,115,0,0,0
2021-10-04 16:15,210,83,127,0,0,0
2021-10-04 16:30,206,83,123,0,0,0
2021-10-04 16:45,211,85,126,0,0,0
2021-10-04 17:00,220,84,136,0,0,0
2021-10-04 17:15,202,80,122,0,0,0
2021-10-04 17:30,238,80,158,0,0,0
2021-10-04 17:45,212,73,139,0,0,0
2021-10-04 18:00,172,69,103,0,0,0
2021-10-04 18:15,191,82,109,0,0,0
2021-10-04 18:30,179,75,104,0,0,0
2021-10-04 18:45,170,71,99,0,0,0
2021-10-04 19:00,153,60,93,0,0,0
2021-10-04 19:15,124,37,87,0,0,0
2021-10-04 19:30,116,49,67,0,0,0
2021-10-04 19:45,99,39,60,0,0,0
2021-10-04 20:00,108,54,54,0,0,0
2021-10-04 20:15,79,30,49,0,0,0
2021-10-04 20:30,43,16,27,0,0,0
2021-10-04 20:45,38,12,26,0,0,0
2021-10-04 21:00,55,21,34,0,0,0
2021-10-04 21:15,54,19,35,0,0,0
2021-10-04 21:30,52,23,29,0,0,0
2021-10-04 21:45,59,22,37,0,0,0
2021-10-04 22:00,56,17,39,0,0,0
2021-10-04 22:15,45,13,32,0,0,0
2021-10-04 22:30,47,9,38,0,0,0
2021-10-04 22:45,32,8,24,0,0,0
2021-10-04 23:00,29,6,23,0,0,0
2021-10-04 23:15,25,17,8,0,0,0
2021-10-04 23:30,13,3,10,0,0,0
2021-10-04 23:45,23,6,17,0,0,0
2021-10-05 00:00,16,7,9,0,0,0
2021-10-05 00:15,22,11,11,0,0,0
2021-10-05 00:30,13,2,11,0,0,0
2021-10-05 00:45,12,1,11,0,0,0
2021-10-05 01:00,16,4,12,0,0,0
2021-10-05 01:15,8,0,8,0,0,0
2021-10-05 01:30,9,1,8,0,0,0
2021-10-05 01:45,6,0,6,0,0,0
2021-10-05 02:00,3,0,3,0,0,0
2021-10-05 02:15,6,0,6,0,0,0
2021-10-05 02:30,2,0,2,0,0,0
2021-10-05 02:45,1,0,1,0,0,0
2021-10-05 03:00,5,0,5,0,0,0
2021-10-05 03:15,1,1,0,0,0,0
2021-10-05 03:30,2,0,2,0,0,0
2021-10-05 03:45,5,0,5,0,0,0
2021-10-05 04:00,1,0,1,0,0,0
2021-10-05 04:15,1,1,0,0,0,0
2021-10-05 04:30,1,1,0,0,0,0
2021-10-05 04:45,2,1,1,0,0,0
2021-10-05 05:00,4,3,1,0,0,0
2021-10-05 05:15,5,4,1,0,0,0
2021-10-05 05:30,17,14,3,0,0,0
2021-10-05 05:45,35,26,9,0,0,0
2021-10-05 06:00,30,23,7,0,0,0
2021-10-05 06:15,24,18,6,0,0,0
2021-10-05 06:30,58,38,20,0,0,0
2021-10-05 06:45,60,41,19,0,0,0
2021-10-05 07:00,86,52,34,0,0,0
2021-10-05 07:15,102,71,31,0,0,0
2021-10-05 07:30,159,101,58,0,0,0
2021-10-05 07:45,203,128,75,0,0,0
2021-10-05 08:00,163,104,59,0,0,0
2021-10-05 08:15,145,84,61,0,0,0
2021-10-05 08:30,137,80,57,0,0,0
2021-10-05 08:45,142,89,53,0,0,0
2021-10-05 09:00,91,60,31,0,0,0
2021-10-05 09:15,105,72,33,0,0,0
2021-10-05 09:30,121,82,39,0,0,0
2021-10-05 09:45,122,73,49,0,0,0
2021-10-05 10:00,99,52,47,0,0,0
2021-10-05 10:15,109,65,44,0,0,0
2021-10-05 10:30,95,54,41,0,0,0
2021-10-05 10:45,135,80,55,0,0,0
2021-10-05 11:00,116,61,55,0,0,0
2021-10-05 11:15,132,63,69,0,0,0
2021-10-05 11:30,117,61,56,0,0,0
2021-10-05 11:45,137,59,78,0,0,0
2021-10-05 12:00,155,92,63,0,0,0
2021-10-05 12:15,135,59,76,0,0,0
2021-10-05 12:30,137,57,80,0,0,0
2021-10-05 12:45,162,76,86,0,0,0
2021-10-05 13:00,188,88,100,0,0,0
2021-10-05 13:15,127,43,84,0,0,0
2021-10-05 13:30,143,61,82,0,0,0
2021-10-05 13:45,155,74,81,0,0,0
2021-10-05 14:00,163,57,106,0,0,0
2021-10-05 14:15,132,57,75,0,0,0
2021-10-05 14:30,154,70,84,0,0,0
2021-10-05 14:45,169,85,84,0,0,0
2021-10-05 15:00,159,81,78,0,0,0
2021-10-05 15:15,190,99,91,0,0,0
2021-10-05 15:30,202,86,116,0,0,0
2021-10-05 15:45,179,62,117,0,0,0
2021-10-05 16:00,177,71,106,0,0,0
2021-10-05 16:15,191,93,98,0,0,0
2021-10-05 16:30,225,96,129,0,0,0
2021-10-05 16:45,232,101,131,0,0,0
2021-10-05 17:00,217,85,132,0,0,0
2021-10-05 17:15,223,96,127,0,0,0
2021-10-05 17:30,230,85,145,0,0,0
2021-10-05 17:45,198,78,120,0,0,0
2021-10-05 18:00,155,49,106,0,0,0
2021-10-05 18:15,139,60,79,0,0,0
2021-10-05 18:30,121,38,83,0,0,0
2021-10-05 18:45,127,48,79,0,0,0
2021-10-05 19:00,100,36,64,0,0,0
2021-10-05 19:15,105,44,61,0,0,0
2021-10-05 19:30,68,29,39,0,0,0
2021-10-05 19:45,84,35,49,0,0,0
2021-10-05 20:00,74,30,44,0,0,0
2021-10-05 20:15,57,20,37,0,0,0
2021-10-05 20:30,52,18,34,0,0,0
2021-10-05 20:45,56,21,35,0,0,0
2021-10-05 21:00,53,19,34,0,0,0
2021-10-05 21:15,52,12,40,0,0,0
2021-10-05 21:30,47,19,28,0,0,0
2021-10-05 21:45,42,15,27,0,0,0
2021-10-05 22:00,41,14,27,0,0,0
2021-10-05 22:15,38,17,21,0,0,0
2021-10-05 22:30,40,9,31,0,0,0
2021-10-05 22:45,37,10,27,0,0,0
2021-10-05 23:00,35,8,27,0,0,0
2021-10-05 23:15,37,17,20,0,0,0
2021-10-05 23:30,22,4,18,0,0,0
2021-10-05 23:45,21,6,15,0,0,0
2021-10-06 00:00,9,2,7,0,0,0
2021-10-06 00:15,9,1,8,0,0,0
2021-10-06 00:30,13,3,10,0,0,0
2021-10-06 00:45,11,1,10,0,0,0
2021-10-06 01:00,12,1,11,0,0,0
2021-10-06 01:15,10,0,10,0,0,0
2021-10-06 01:30,7,2,5,0,0,0
2021-10-06 01:45,10,2,8,0,0,0
2021-10-06 02:00,3,1,2,0,0,0
2021-10-06 02:15,11,4,7,0,0,0
2021-10-06 02:30,10,0,10,0,0,0
2021-10-06 02:45,14,0,14,0,0,0
2021-10-06 03:00,7,0,7,0,0,0
2021-10-06 03:15,4,0,4,0,0,0
2021-10-06 03:30,6,0,6,0,0,0
2021-10-06 03:45,4,1,3,0,0,0
2021-10-06 04:00,1,0,1,0,0,0
2021-10-06 04:15,2,0,2,0,0,0
2021-10-06 04:30,4,0,4,0,0,0
2021-10-06 04:45,5,1,4,0,0,0
2021-10-06 05:00,3,3,0,0,0,0
2021-10-06 05:15,9,9,0,0,0,0
2021-10-06 05:30,15,11,4,0,0,0
2021-10-06 05:45,21,15,6,0,0,0
2021-10-06 06:00,25,20,5,0,0,0
2021-10-06 06:15,22,18,4,0,0,0
2021-10-06 06:30,35,24,11,0,0,0
2021-10-06 06:45,43,29,14,0,0,0
2021-10-06 07:00,65,43,22,0,0,0
2021-10-06 07:15,103,67,36,0,0,0
2021-10-06 07:30,150,98,52,0,0,0
2021-10-06 07:45,165,108,57,0,0,0
2021-10-06 08:00,141,100,41,0,0,0
2021-10-06 08:15,132,91,41,0,0,0
2021-10-06 08:30,105,65,40,0,0,0
2021-10-06 08:45,117,75,42,0,0,0
2021-10-06 09:00,90,59,31,0,0,0
2021-10-06 09:15,80,58,22,0,0,0
2021-10-06 09:30,95,66,29,0,0,0
2021-10-06 09:45,100,69,31,0,0,0
2021-10-06 10:00,97,57,40,0,0,0
2021-10-06 10:15,80,35,45,0,0,0
2021-10-06 10:30,99,51,48,0,0,0
2021-10-06 10:45,100,61,39,0,0,0
2021-10-06 11:00,80,48,32,0,0,0
2021-10-06 11:15,98,51,47,0,0,0
2021-10-06 11:30,103,51,52,0,0,0
2021-10-06 11:45,101,47,54,0,0,0
2021-10-06 12:00,95,41,54,0,0,0
2021-10-06 12:15,100,52,48,0,0,0
2021-10-06 12:30,100,36,64,0,0,0
2021-10-06 12:45,92,44,48,0,0,0
2021-10-06 13:00,106,44,62,0,0,0
2021-10-06 13:15,109,37,72,0,0,0
2021-10-06 13:30,92,37,55,0,0,0
2021-10-06 13:45,114,45,69,0,0,0
2021-10-06 14:00,96,32,64,0,0,0
2021-10-06 14:15,91,44,47,0,0,0
2021-10-06 14:30,109,40,69,0,0,0
2021-10-06 14:45,153,66,87,0,0,0
2021-10-06 15:00,121,33,88,0,0,0
2021-10-06 15:15,134,52,82,0,0,0
2021-10-06 15:30,112,45,67,0,0,0
2021-10-06 15:45,113,49,64,0,0,0
2021-10-06 16:00,160,64,96,0,0,0
2021-10-06 16:15,151,56,95,0,0,0
2021-10-06 16:30,149,63,86,0,0,0
2021-10-06 16:45,133,60,73,0,0,0
2021-10-06 17:00,170,55,115,0,0,0
2021-10-06 17:15,142,63,79,0,0,0
2021-10-06 17:30,147,59,88,0,0,0
2021-10-06 17:45,156,65,91,0,0,0
2021-10-06 18:00,141,53,88,0,0,0
2021-10-06 18:15,137,50,87,0,0,0
2021-10-06 18:30,75,22,53,0,0,0
2021-10-06 18:45,109,42,67,0,0,0
2021-10-06 19:00,66,26,40,0,0,0
2021-10-06 19:15,59,20,39,0,0,0
2021-10-06 19:30,65,21,44,0,0,0
2021-10-06 19:45,90,34,56,0,0,0
2021-10-06 20:00,72,25,47,0,0,0
2021-10-06 20:15,58,25,33,0,0,0
2021-10-06 20:30,57,21,36,0,0,0
2021-10-06 20:45,50,27,23,0,0,0
2021-10-06 21:00,51,23,28,0,0,0
2021-10-06 21:15,46,29,17,0,0,0
2021-10-06 21:30,47,21,26,0,0,0
2021-10-06 21:45,49,15,34,0,0,0
2021-10-06 22:00,52,20,32,0,0,0
2021-10-06 22:15,22,10,12,0,0,0
2021-10-06 22:30,30,9,21,0,0,0
2021-10-06 22:45,40,19,21,0,0,0
2021-10-06 23:00,30,18,12,0,0,0
2021-10-06 23:15,16,3,13,0,0,0
2021-10-06 23:30,26,11,15,0,0,0
2021-10-06 23:45,21,11,10,0,0,0
2021-10-07 00:00,22,7,15,0,0,0
2021-10-07 00:15,14,8,6,0,0,0
2021-10-07 00:30,17,5,12,0,0,0
2021-10-07 00:45,7,0,7,0,0,0
2021-10-07 01:00,18,2,16,0,0,0
2021-10-07 01:15,11,5,6,0,0,0
2021-10-07 01:30,7,1,6,0,0,0
2021-10-07 01:45,14,2,12,0,0,0
2021-10-07 02:00,12,1,11,0,0,0
2021-10-07 02:15,11,0,11,0,0,0
2021-10-07 02:30,14,2,12,0,0,0
2021-10-07 02:45,8,1,7,0,0,0
2021-10-07 03:00,7,0,7,0,0,0
2021-10-07 03:15,10,1,9,0,0,0
2021-10-07 03:30,12,0,12,0,0,0
2021-10-07 03:45,8,1,7,0,0,0
2021-10-07 04:00,6,0,6,0,0,0
2021-10-07 04:15,6,0,6,0,0,0
2021-10-07 04:30,8,2,6,0,0,0
2021-10-07 04:45,2,0,2,0,0,0
2021-10-07 05:00,6,4,2,0,0,0
2021-10-07 05:15,12,6,6,0,0,0
2021-10-07 05:30,15,13,2,0,0,0
2021-10-07 05:45,25,20,5,0,0,0
2021-10-07 06:00,19,15,4,0,0,0
2021-10-07 06:15,28,19,9,0,0,0
2021-10-07 06:30,39,30,9,0,0,0
2021-10-07 06:45,48,33,15,0,0,0
2021-10-07 07:00,77,46,31,0,0,0
2021-10-07 07:15,95,71,24,0,0,0
2021-10-07 07:30,156,92,64,0,0,0
2021-10-07 07:45,193,130,63,0,0,0
2021-10-07 08:00,147,98,49,0,0,0
2021-10-07 08:15,132,85,47,0,0,0
2021-10-07 08:30,139,93,46,0,0,0
2021-10-07 08:45,150,80,70,0,0,0
2021-10-07 09:00,125,54,71,0,0,0
2021-10-07 09:15,105,59,46,0,0,0
2021-10-07 09:30,113,59,54,0,0,0
2021-10-07 09:45,136,86,50,0,0,0
2021-10-07 10:00,88,53,35,0,0,0
2021-10-07 10:15,100,60,40,0,0,0
2021-10-07 10:30,113,57,56,0,0,0
2021-10-07 10:45,107,57,50,0,0,0
2021-10-07 11:00,114,54,60,0,0,0
2021-10-07 11:15,133,71,62,0,0,0
2021-10-07 11:30,131,56,75,0,0,0
2021-10-07 11:45,155,74,81,0,0,0
2021-10-07 12:00,125,48,77,0,0,0
2021-10-07 12:15,117,63,54,0,0,0
2021-10-07 12:30,175,86,89,0,0,0
2021-10-07 12:45,256,160,96,0,0,0
2021-10-07 13:00,256,149,107,0,0,0
2021-10-07 13:15,221,132,89,0,0,0
2021-10-07 13:30,170,101,69,0,0,0
2021-10-07 13:45,166,87,79,0,0,0
2021-10-07 14:00,145,62,83,0,0,0
2021-10-07 14:15,171,80,91,0,0,0
2021-10-07 14:30,164,87,77,0,0,0
2021-10-07 14:45,177,90,87,0,0,0
2021-10-07 15:00,166,72,94,0,0,0
2021-10-07 15:15,147,60,87,0,0,0
2021-10-07 15:30,183,103,80,0,0,0
2021-10-07 15:45,217,116,101,0,0,0
2021-10-07 16:00,212,94,118,0,0,0
2021-10-07 16:15,211,94,117,0,0,0
2021-10-07 16:30,177,79,98,0,0,0
2021-10-07 16:45,217,96,121,0,0,0
2021-10-07 17:00,215,96,119,0,0,0
2021-10-07 17:15,242,98,144,0,0,0
2021-10-07 17:30,193,78,115,0,0,0
2021-10-07 17:45,226,94,132,0,0,0
2021-10-07 18:00,194,69,125,0,0,0
2021-10-07 18:15,204,65,139,0,0,0
2021-10-07 18:30,151,55,96,0,0,0
2021-10-07 18:45,177,79,98,0,0,0
2021-10-07 19:00,143,55,88,0,0,0
2021-10-07 19:15,140,55,85,0,0,0
2021-10-07 19:30,123,48,75,0,0,0
2021-10-07 19:45,126,52,74,0,0,0
2021-10-07 20:00,108,34,74,0,0,0
2021-10-07 20:15,71,34,37,0,0,0
2021-10-07 20:30,77,28,49,0,0,0
2021-10-07 20:45,57,21,36,0,0,0
2021-10-07 21:00,60,19,41,0,0,0
2021-10-07 21:15,44,22,22,0,0,0
2021-10-07 21:30,37,11,26,0,0,0
2021-10-07 21:45,63,22,41,0,0,0
2021-10-07 22:00,58,23,35,0,0,0
2021-10-07 22:15,46,20,26,0,0,0
2021-10-07 22:30,63,27,36,0,0,0
2021-10-07 22:45,43,14,29,0,0,0
2021-10-07 23:00,52,26,26,0,0,0
2021-10-07 23:15,44,12,32,0,0,0
2021-10-07 23:30,32,8,24,0,0,0
2021-10-07 23:45,21,5,16,0,0,0
2021-10-08 00:00,15,3,12,0,0,0
2021-10-08 00:15,26,15,11,0,0,0
2021-10-08 00:30,14,5,9,0,0,0
2021-10-08 00:45,15,3,12,0,0,0
2021-10-08 01:00,5,1,4,0,0,0
2021-10-08 01:15,9,0,9,0,0,0
2021-10-08 01:30,4,1,3,0,0,0
2021-10-08 01:45,6,1,5,0,0,0
2021-10-08 02:00,7,0,7,0,0,0
2021-10-08 02:15,7,0,7,0,0,0
2021-10-08 02:30,11,0,11,0,0,0
2021-10-08 02:45,10,2,8,0,0,0
2021-10-08 03:00,8,0,8,0,0,0
2021-10-08 03:15,7,0,7,0,0,0
2021-10-08 03:30,9,0,9,0,0,0
2021-10-08 03:45,7,2,5,0,0,0
2021-10-08 04:00,5,1,4,0,0,0
2021-10-08 04:15,1,1,0,0,0,0
2021-10-08 04:30,3,1,2,0,0,0
2021-10-08 04:45,6,1,5,0,0,0
2021-10-08 05:00,5,2,3,0,0,0
2021-10-08 05:15,10,6,4,0,0,0
2021-10-08 05:30,18,15,3,0,0,0
2021-10-08 05:45,24,18,6,0,0,0
2021-10-08 06:00,28,16,12,0,0,0
2021-10-08 06:15,24,18,6,0,0,0
2021-10-08 06:30,51,36,15,0,0,0
2021-10-08 06:45,54,26,28,0,0,0
2021-10-08 07:00,79,52,27,0,0,0
2021-10-08 07:15,107,65,42,0,0,0
2021-10-08 07:30,140,95,45,0,0,0
2021-10-08 07:45,178,104,74,0,0,0
2021-10-08 08:00,166,106,60,0,0,0
2021-10-08 08:15,133,78,55,0,0,0
2021-10-08 08:30,85,55,30,0,0,0
2021-10-08 08:45,127,79,48,0,0,0
2021-10-08 09:00,100,53,47,0,0,0
2021-10-08 09:15,121,68,53,0,0,0
2021-10-08 09:30,104,63,41,0,0,0
2021-10-08 09:45,115,72,43,0,0,0
2021-10-08 10:00,98,51,47,0,0,0
2021-10-08 10:15,105,60,45,0,0,0
2021-10-08 10:30,112,62,50,0,0,0
2021-10-08 10:45,141,70,71,0,0,0
2021-10-08 11:00,144,72,72,0,0,0
2021-10-08 11:15,162,76,86,0,0,0
2021-10-08 11:30,153,73,80,0,0,0
2021-10-08 11:45,176,70,106,0,0,0
2021-10-08 12:00,139,53,86,0,0,0
2021-10-08 12:15,151,62,89,0,0,0
2021-10-08 12:30,157,58,99,0,0,0
2021-10-08 12:45,151,71,80,0,0,0
2021-10-08 13:00,166,78,88,0,0,0
2021-10-08 13:15,172,84,88,0,0,0
2021-10-08 13:30,161,69,92,0,0,0
2021-10-08 13:45,200,79,121,0,0,0
2021-10-08 14:00,182,75,107,0,0,0
2021-10-08 14:15,183,95,88,0,0,0
2021-10-08 14:30,184,69,115,0,0,0
2021-10-08 14:45,220,87,133,0,0,0
2021-10-08 15:00,194,83,111,0,0,0
2021-10-08 15:15,200,95,105,0,0,0
2021-10-08 15:30,204,86,118,0,0,0
2021-10-08 15:45,210,116,94,0,0,0
2021-10-08 16:00,181,89,92,0,0,0
2021-10-08 16:15,212,95,117,0,0,0
2021-10-08 16:30,194,82,112,0,0,0
2021-10-08 16:45,189,75,114,0,0,0
2021-10-08 17:00,162,69,93,0,0,0
2021-10-08 17:15,175,64,111,0,0,0
2021-10-08 17:30,181,75,106,0,0,0
2021-10-08 17:45,167,80,87,0,0,0
2021-10-08 18:00,169,63,106,0,0,0
2021-10-08 18:15,178,78,100,0,0,0
2021-10-08 18:30,142,53,89,0,0,0
2021-10-08 18:45,169,86,83,0,0,0
2021-10-08 19:00,158,70,88,0,0,0
2021-10-08 19:15,148,71,77,0,0,0
2021-10-08 19:30,110,45,65,0,0,0
2021-10-08 19:45,132,67,65,0,0,0
2021-10-08 20:00,115,51,64,0,0,0
2021-10-08 20:15,105,49,56,0,0,0
2021-10-08 20:30,87,27,60,0,0,0
2021-10-08 20:45,67,38,29,0,0,0
2021-10-08 21:00,58,21,37,0,0,0
2021-10-08 21:15,62,26,36,0,0,0
2021-10-08 21:30,69,23,46,0,0,0
2021-10-08 21:45,75,26,49,0,0,0
2021-10-08 22:00,56,19,37,0,0,0
2021-10-08 22:15,55,14,41,0,0,0
2021-10-08 22:30,56,20,36,0,0,0
2021-10-08 22:45,45,25,20,0,0,0
2021-10-08 23:00,56,21,35,0,0,0
2021-10-08 23:15,43,10,33,0,0,0
2021-10-08 23:30,40,16,24,0,0,0
2021-10-08 23:45,43,11,32,0,0,0
2021-10-09 00:00,40,19,21,0,0,0
2021-10-09 00:15,41,12,29,0,0,0
2021-10-09 00:30,34,8,26,0,0,0
2021-10-09 00:45,41,10,31,0,0,0
2021-10-09 01:00,22,5,17,0,0,0
2021-10-09 01:15,24,9,15,0,0,0
2021-10-09 01:30,28,10,18,0,0,0
2021-10-09 01:45,26,5,21,0,0,0
2021-10-09 02:00,21,3,18,0,0,0
2021-10-09 02:15,19,4,15,0,0,0
2021-10-09 02:30,25,5,20,0,0,0
2021-10-09 02:45,17,2,15,0,0,0
2021-10-09 03:00,12,2,10,0,0,0
2021-10-09 03:15,8,0,8,0,0,0
2021-10-09 03:30,15,0,15,0,0,0
2021-10-09 03:45,9,3,6,0,0,0
2021-10-09 04:00,15,4,11,0,0,0
2021-10-09 04:15,15,1,14,0,0,0
2021-10-09 04:30,7,1,6,0,0,0
2021-10-09 04:45,3,2,1,0,0,0
2021-10-09 05:00,6,1,5,0,0,0
2021-10-09 05:15,8,2,6,0,0,0
2021-10-09 05:30,11,7,4,0,0,0
2021-10-09 05:45,13,8,5,0,0,0
2021-10-09 06:00,2,2,0,0,0,0
2021-10-09 06:15,5,3,2,0,0,0
2021-10-09 06:30,1,0,1,0,0,0
2021-10-09 06:45,3,0,3,0,0,0
2021-10-09 07:00,6,5,1,0,0,0
2021-10-09 07:15,15,11,4,0,0,0
2021-10-09 07:30,18,15,3,0,0,0
2021-10-09 07:45,25,11,14,0,0,0
2021-10-09 08:00,20,9,11,0,0,0
2021-10-09 08:15,29,17,12,0,0,0
2021-10-09 08:30,46,23,23,0,0,0
2021-10-09 08:45,70,47,23,0,0,0
2021-10-09 09:00,49,31,18,0,0,0
2021-10-09 09:15,86,56,30,0,0,0
2021-10-09 09:30,86,57,29,0,0,0
2021-10-09 09:45,123,78,45,0,0,0
2021-10-09 10:00,108,70,38,0,0,0
2021-10-09 10:15,119,74,45,0,0,0
2021-10-09 10:30,151,95,56,0,0,0
2021-10-09 10:45,149,84,65,0,0,0
2021-10-09 11:00,127,73,54,0,0,0
2021-10-09 11:15,147,78,69,0,0,0
2021-10-09 11:30,179,97,82,0,0,0
2021-10-09 11:45,201,112,89,0,0,0
2021-10-09 12:00,179,101,78,0,0,0
2021-10-09 12:15,212,106,106,0,0,0
2021-10-09 12:30,182,81,101,0,0,0
2021-10-09 12:45,216,102,114,0,0,0
2021-10-09 13:00,211,92,119,0,0,0
2021-10-09 13:15,237,99,138,0,0,0
2021-10-09 13:30,209,94,115,0,0,0
2021-10-09 13:45,210,111,99,0,0,0
2021-10-09 14:00,149,69,80,0,0,0
2021-10-09 14:15,159,93,66,0,0,0
2021-10-09 14:30,162,77,85,0,0,0
2021-10-09 14:45,188,78,110,0,0,0
2021-10-09 15:00,157,70,87,0,0,0
2021-10-09 15:15,149,62,87,0,0,0
2021-10-09 15:30,158,64,94,0,0,0
2021-10-09 15:45,155,66,89,0,0,0
2021-10-09 16:00,214,134,80,0,0,0
2021-10-09 16:15,214,122,92,0,0,0
2021-10-09 16:30,163,75,88,0,0,0
2021-10-09 16:45,128,56,72,0,0,0
2021-10-09 17:00,140,57,83,0,0,0
2021-10-09 17:15,132,41,91,0,0,0
2021-10-09 17:30,146,56,90,0,0,0
2021-10-09 17:45,142,45,97,0,0,0
2021-10-09 18:00,153,56,97,0,0,0
2021-10-09 18:15,149,56,93,0,0,0
2021-10-09 18:30,120,59,61,0,0,0
2021-10-09 18:45,152,68,84,0,0,0
2021-10-09 19:00,109,35,74,0,0,0
2021-10-09 19:15,127,63,64,0,0,0
2021-10-09 19:30,109,53,56,0,0,0
2021-10-09 19:45,86,45,41,0,0,0
2021-10-09 20:00,94,27,67,0,0,0
2021-10-09 20:15,69,36,33,0,0,0
2021-10-09 20:30,52,19,33,0,0,0
2021-10-09 20:45,42,28,14,0,0,0
2021-10-09 21:00,47,19,28,0,0,0
2021-10-09 21:15,59,36,23,0,0,0
2021-10-09 21:30,47,21,26,0,0,0
2021-10-09 21:45,37,15,22,0,0,0
2021-10-09 22:00,32,11,21,0,0,0
2021-10-09 22:15,56,20,36,0,0,0
2021-10-09 22:30,37,21,16,0,0,0
2021-10-09 22:45,45,24,21,0,0,0
2021-10-09 23:00,36,12,24,0,0,0
2021-10-09 23:15,34,4,30,0,0,0
2021-10-09 23:30,46,18,28,0,0,0
2021-10-09 23:45,37,13,24,0,0,0
2021-10-10 00:00,25,8,17,0,0,0
2021-10-10 00:15,32,5,27,0,0,0
2021-10-10 00:30,22,17,5,0,0,0
2021-10-10 00:45,22,9,13,0,0,0
2021-10-10 01:00,23,5,18,0,0,0
2021-10-10 01:15,17,5,12,0,0,0
2021-10-10 01:30,23,5,18,0,0,0
2021-10-10 01:45,17,7,10,0,0,0
2021-10-10 02:00,27,7,20,0,0,0
2021-10-10 02:15,20,7,13,0,0,0
2021-10-10 02:30,22,6,16,0,0,0
2021-10-10 02:45,22,5,17,0,0,0
2021-10-10 03:00,9,1,8,0,0,0
2021-10-10 03:15,7,3,4,0,0,0
2021-10-10 03:30,6,0,6,0,0,0
2021-10-10 03:45,8,0,8,0,0,0
2021-10-10 04:00,18,2,16,0,0,0
2021-10-10 04:15,6,0,6,0,0,0
2021-10-10 04:30,5,0,5,0,0,0
2021-10-10 04:45,7,0,7,0,0,0
2021-10-10 05:00,2,0,2,0,0,0
2021-10-10 05:15,5,2,3,0,0,0
2021-10-10 05:30,11,3,8,0,0,0
2021-10-10 05:45,5,3,2,0,0,0
2021-10-10 06:00,9,3,6,0,0,0
2021-10-10 06:15,1,0,1,0,0,0
2021-10-10 06:30,3,1,2,0,0,0
2021-10-10 06:45,3,3,0,0,0,0
2021-10-10 07:00,2,2,0,0,0,0
2021-10-10 07:15,3,2,1,0,0,0
2021-10-10 07:30,3,2,1,0,0,0
2021-10-10 07:45,8,6,2,0,0,0
2021-10-10 08:00,4,1,3,0,0,0
2021-10-10 08:15,6,3,3,0,0,0
2021-10-10 08:30,23,10,13,0,0,0
2021-10-10 08:45,16,10,6,0,0,0
2021-10-10 09:00,11,6,5,0,0,0
2021-10-10 09:15,13,9,4,0,0,0
2021-10-10 09:30,33,22,11,0,0,0
2021-10-10 09:45,57,29,28,0,0,0
2021-10-10 10:00,35,25,10,0,0,0
2021-10-10 10:15,39,21,18,0,0,0
2021-10-10 10:30,22,12,10,0,0,0
2021-10-10 10:45,27,18,9,0,0,0
2021-10-10 11:00,32,15,17,0,0,0
2021-10-10 11:15,38,24,14,0,0,0
2021-10-10 11:30,49,33,16,0,0,0
2021-10-10 11:45,42,24,18,0,0,0
2021-10-10 12:00,63,32,31,0,0,0
2021-10-10 12:15,42,25,17,0,0,0
2021-10-10 12:30,70,38,32,0,0,0
2021-10-10 12:45,58,25,33,0,0,0
2021-10-10 13:00,66,31,35,0,0,0
2021-10-10 13:15,59,31,28,0,0,0
2021-10-10 13:30,61,32,29,0,0,0
2021-10-10 13:45,109,47,62,0,0,0
2021-10-10 14:00,76,26,50,0,0,0
2021-10-10 14:15,82,40,42,0,0,0
2021-10-10 14:30,84,38,46,0,0,0
2021-10-10 14:45,88,45,43,0,0,0
2021-10-10 15:00,103,38,65,0,0,0
2021-10-10 15:15,111,34,77,0,0,0
2021-10-10 15:30,95,43,52,0,0,0
2021-10-10 15:45,107,43,64,0,0,0
2021-10-10 16:00,103,40,63,0,0,0
2021-10-10 16:15,86,44,42,0,0,0
2021-10-10 16:30,89,36,53,0,0,0
2021-10-10 16:45,85,40,45,0,0,0
2021-10-10 17:00,71,31,40,0,0,0
2021-10-10 17:15,77,28,49,0,0,0
2021-10-10 17:30,89,45,44,0,0,0
2021-10-10 17:45,112,47,65,0,0,0
2021-10-10 18:00,111,51,60,0,0,0
2021-10-10 18:15,142,91,51,0,0,0
2021-10-10 18:30,87,24,63,0,0,0
2021-10-10 18:45,68,30,38,0,0,0
2021-10-10 19:00,84,30,54,0,0,0
2021-10-10 19:15,69,36,33,0,0,0
2021-10-10 19:30,56,24,32,0,0,0
2021-10-10 19:45,58,27,31,0,0,0
2021-10-10 20:00,43,17,26,0,0,0
2021-10-10 20:15,56,26,30,0,0,0
2021-10-10 20:30,35,8,27,0,0,0
2021-10-10 20:45,46,12,34,0,0,0
2021-10-10 21:00,30,12,18,0,0,0
2021-10-10 21:15,39,13,26,0,0,0
2021-10-10 21:30,29,13,16,0,0,0
2021-10-10 21:45,13,6,7,0,0,0
2021-10-10 22:00,22,8,14,0,0,0
2021-10-10 22:15,17,2,15,0,0,0
2021-10-10 22:30,16,6,10,0,0,0
2021-10-10 22:45,23,1,22,0,0,0
2021-10-10 23:00,11,1,10,0,0,0
2021-10-10 23:15,16,5,11,0,0,0
2021-10-10 23:30,9,1,8,0,0,0
2021-10-10 23:45,17,3,14,0,0,0
2021-10-11 00:00,7,2,5,0,0,0
2021-10-11 00:15,0,0,0,0,0,0
2021-10-11 00:30,2,1,1,0,0,0
2021-10-11 00:45,6,0,6,0,0,0
2021-10-11 01:00,5,3,2,0,0,0
2021-10-11 01:15,4,1,3,0,0,0
2021-10-11 01:30,0,0,0,0,0,0
2021-10-11 01:45,3,0,3,0,0,0
2021-10-11 02:00,1,1,0,0,0,0
2021-10-11 02:15,0,0,0,0,0,0
2021-10-11 02:30,0,0,0,0,0,0
2021-10-11 02:45,0,0,0,0,0,0
2021-10-11 03:00,1,0,1,0,0,0
2021-10-11 03:15,4,2,2,0,0,0
2021-10-11 03:30,1,0,1,0,0,0
2021-10-11 03:45,1,0,1,0,0,0
2021-10-11 04:00,1,0,1,0,0,0
2021-10-11 04:15,0,0,0,0,0,0
2021-10-11 04:30,0,0,0,0,0,0
2021-10-11 04:45,6,3,3,0,0,0
2021-10-11 05:00,0,0,0,0,0,0
2021-10-11 05:15,12,8,4,0,0,0
2021-10-11 05:30,14,12,2,0,0,0
2021-10-11 05:45,23,19,4,0,0,0
2021-10-11 06:00,22,14,8,0,0,0
2021-10-11 06:15,26,19,7,0,0,0
2021-10-11 06:30,39,26,13,0,0,0
2021-10-11 06:45,53,34,19,0,0,0
2021-10-11 07:00,70,39,31,0,0,0
2021-10-11 07:15,95,64,31,0,0,0
2021-10-11 07:30,112,68,44,0,0,0
2021-10-11 07:45,140,92,48,0,0,0
2021-10-11 08:00,110,71,39,0,0,0
2021-10-11 08:15,111,70,41,0,0,0
2021-10-11 08:30,100,68,32,0,0,0
2021-10-11 08:45,112,74,38,0,0,0
2021-10-11 09:00,99,65,34,0,0,0
2021-10-11 09:15,75,51,24,0,0,0
2021-10-11 09:30,112,76,36,0,0,0
2021-10-11 09:45,129,82,47,0,0,0
2021-10-11 10:00,86,57,29,0,0,0
2021-10-11 10:15,103,57,46,0,0,0
2021-10-11 10:30,106,53,53,0,0,0
2021-10-11 10:45,109,56,53,0,0,0
2021-10-11 11:00,115,62,53,0,0,0
2021-10-11 11:15,125,69,56,0,0,0
2021-10-11 11:30,94,45,49,0,0,0
2021-10-11 11:45,123,69,54,0,0,0
2021-10-11 12:00,136,54,82,0,0,0
2021-10-11 12:15,135,56,79,0,0,0
2021-10-11 12:30,128,64,64,0,0,0
2021-10-11 12:45,125,56,69,0,0,0
2021-10-11 13:00,119,51,68,0,0,0
2021-10-11 13:15,133,61,72,0,0,0
2021-10-11 13:30,119,69,50,0,0,0
2021-10-11 13:45,135,61,74,0,0,0
2021-10-11 14:00,145,59,86,0,0,0
2021-10-11 14:15,111,47,64,0,0,0
2021-10-11 14:30,131,60,71,0,0,0
2021-10-11 14:45,148,68,80,0,0,0
2021-10-11 15:00,138,66,72,0,0,0
2021-10-11 15:15,126,57,69,0,0,0
2021-10-11 15:30,173,81,92,0,0,0
2021-10-11 15:45,162,80,82,0,0,0
2021-10-11 16:00,183,69,114,0,0,0
2021-10-11 16:15,170,53,117,0,0,0
2021-10-11 16:30,155,51,104,0,0,0
2021-10-11 16:45,171,62,109,0,0,0
2021-10-11 17:00,169,66,103,0,0,0
2021-10-11 17:15,172,65,107,0,0,0
2021-10-11 17:30,170,72,98,0,0,0
2021-10-11 17:45,169,59,110,0,0,0
2021-10-11 18:00,170,56,114,0,0,0
2021-10-11 18:15,143,66,77,0,0,0
2021-10-11 18:30,127,34,93,0,0,0
2021-10-11 18:45,136,60,76,0,0,0
2021-10-11 19:00,126,33,93,0,0,0
2021-10-11 19:15,82,33,49,0,0,0
2021-10-11 19:30,82,35,47,0,0,0
2021-10-11 19:45,73,30,43,0,0,0
2021-10-11 20:00,82,35,47,0,0,0
2021-10-11 20:15,41,18,23,0,0,0
2021-10-11 20:30,30,5,25,0,0,0
2021-10-11 20:45,32,9,23,0,0,0
2021-10-11 21:00,43,17,26,0,0,0
2021-10-11 21:15,44,7,37,0,0,0
2021-10-11 21:30,41,13,28,0,0,0
2021-10-11 21:45,34,14,20,0,0,0
2021-10-11 22:00,39,9,30,0,0,0
2021-10-11 22:15,30,10,20,0,0,0
2021-10-11 22:30,54,20,34,0,0,0
2021-10-11 22:45,41,10,31,0,0,0
2021-10-11 23:00,37,10,27,0,0,0
2021-10-11 23:15,28,13,15,0,0,0
2021-10-11 23:30,31,13,18,0,0,0
2021-10-11 23:45,11,5,6,0,0,0
2021-10-12 00:00,3,1,2,0,0,0
2021-10-12 00:15,19,5,14,0,0,0
2021-10-12 00:30,5,1,4,0,0,0
2021-10-12 00:45,7,2,5,0,0,0
2021-10-12 01:00,4,0,4,0,0,0
2021-10-12 01:15,2,2,0,0,0,0
2021-10-12 01:30,2,0,2,0,0,0
2021-10-12 01:45,2,1,1,0,0,0
2021-10-12 02:00,3,0,3,0,0,0
2021-10-12 02:15,3,0,3,0,0,0
2021-10-12 02:30,0,0,0,0,0,0
2021-10-12 02:45,0,0,0,0,0,0
2021-10-12 03:00,3,2,1,0,0,0
2021-10-12 03:15,1,1,0,0,0,0
2021-10-12 03:30,4,0,4,0,0,0
2021-10-12 03:45,0,0,0,0,0,0
2021-10-12 04:00,1,1,0,0,0,0
2021-10-12 04:15,3,1,2,0,0,0
2021-10-12 04:30,3,0,3,0,0,0
2021-10-12 04:45,2,1,1,0,0,0
2021-10-12 05:00,3,3,0,0,0,0
2021-10-12 05:15,6,3,3,0,0,0
2021-10-12 05:30,25,18,7,0,0,0
2021-10-12 05:45,20,15,5,0,0,0
2021-10-12 06:00,18,14,4,0,0,0
2021-10-12 06:15,29,20,9,0,0,0
2021-10-12 06:30,37,25,12,0,0,0
2021-10-12 06:45,51,35,16,0,0,0
2021-10-12 07:00,65,39,26,0,0,0
2021-10-12 07:15,73,42,31,0,0,0
2021-10-12 07:30,121,79,42,0,0,0
2021-10-12 07:45,146,104,42,0,0,0
2021-10-12 08:00,99,69,30,0,0,0
2021-10-12 08:15,119,81,38,0,0,0
2021-10-12 08:30,84,48,36,0,0,0
2021-10-12 08:45,87,57,30,0,0,0
2021-10-12 09:00,47,31,16,0,0,0
2021-10-12 09:15,64,45,19,0,0,0
2021-10-12 09:30,79,55,24,0,0,0
2021-10-12 09:45,104,58,46,0,0,0
2021-10-12 10:00,67,35,32,0,0,0
2021-10-12 10:15,71,36,35,0,0,0
2021-10-12 10:30,62,35,27,0,0,0
2021-10-12 10:45,71,45,26,0,0,0
2021-10-12 11:00,90,35,55,0,0,0
2021-10-12 11:15,78,36,42,0,0,0
2021-10-12 11:30,82,30,52,0,0,0
2021-10-12 11:45,80,37,43,0,0,0
2021-10-12 12:00,87,29,58,0,0,0
2021-10-12 12:15,72,24,48,0,0,0
2021-10-12 12:30,79,28,51,0,0,0
2021-10-12 12:45,120,55,65,0,0,0
2021-10-12 13:00,77,37,40,0,0,0
2021-10-12 13:15,94,31,63,0,0,0
2021-10-12 13:30,82,35,47,0,0,0
2021-10-12 13:45,109,55,54,0,0,0
2021-10-12 14:00,113,40,73,0,0,0
2021-10-12 14:15,123,53,70,0,0,0
2021-10-12 14:30,127,58,69,0,0,0
2021-10-12 14:45,152,63,89,0,0,0
2021-10-12 15:00,116,43,73,0,0,0
2021-10-12 15:15,150,64,86,0,0,0
2021-10-12 15:30,151,70,81,0,0,0
2021-10-12 15:45,162,73,89,0,0,0
2021-10-12 16:00,189,68,121,0,0,0
2021-10-12 16:15,173,69,104,0,0,0
2021-10-12 16:30,168,70,98,0,0,0
2021-10-12 16:45,218,93,125,0,0,0
2021-10-12 17:00,174,58,116,0,0,0
2021-10-12 17:15,221,85,136,0,0,0
2021-10-12 17:30,162,51,111,0,0,0
2021-10-12 17:45,190,60,130,0,0,0
2021-10-12 18:00,171,50,121,0,0,0
2021-10-12 18:15,161,50,111,0,0,0
2021-10-12 18:30,147,49,98,0,0,0
2021-10-12 18:45,135,48,87,0,0,0
2021-10-12 19:00,112,34,78,0,0,0
2021-10-12 19:15,127,38,89,0,0,0
2021-10-12 19:30,75,23,52,0,0,0
2021-10-12 19:45,87,32,55,0,0,0
2021-10-12 20:00,65,17,48,0,0,0
2021-10-12 20:15,62,26,36,0,0,0
2021-10-12 20:30,47,11,36,0,0,0
2021-10-12 20:45,43,17,26,0,0,0
2021-10-12 21:00,53,12,41,0,0,0
2021-10-12 21:15,39,16,23,0,0,0
2021-10-12 21:30,35,7,28,0,0,0
2021-10-12 21:45,30,8,22,0,0,0
2021-10-12 22:00,46,13,33,0,0,0
2021-10-12 22:15,49,18,31,0,0,0
2021-10-12 22:30,40,11,29,0,0,0
2021-10-12 22:45,35,17,18,0,0,0
2021-10-12 23:00,32,10,22,0,0,0
2021-10-12 23:15,44,24,20,0,0,0
2021-10-12 23:30,27,3,24,0,0,0
2021-10-12 23:45,24,15,9,0,0,0
2021-10-13 00:00,18,9,9,0,0,0
2021-10-13 00:15,7,2,5,0,0,0
2021-10-13 00:30,8,2,6,0,0,0
2021-10-13 00:45,3,1,2,0,0,0
2021-10-13 01:00,2,1,1,0,0,0
2021-10-13 01:15,3,1,2,0,0,0
2021-10-13 01:30,2,0,2,0,0,0
2021-10-13 01:45,4,3,1,0,0,0
2021-10-13 02:00,9,1,8,0,0,0
2021-10-13 02:15,6,1,5,0,0,0
2021-10-13 02:30,2,0,2,0,0,0
2021-10-13 02:45,2,1,1,0,0,0
2021-10-13 03:00,3,0,3,0,0,0
2021-10-13 03:15,2,0,2,0,0,0
2021-10-13 03:30,0,0,0,0,0,0
2021-10-13 03:45,0,0,0,0,0,0
2021-10-13 04:00,0,0,0,0,0,0
2021-10-13 04:15,4,0,4,0,0,0
2021-10-13 04:30,2,2,0,0,0,0
2021-10-13 04:45,2,1,1,0,0,0
2021-10-13 05:00,5,4,1,0,0,0
2021-10-13 05:15,8,5,3,0,0,0
2021-10-13 05:30,21,15,6,0,0,0
2021-10-13 05:45,35,24,11,0,0,0
2021-10-13 06:00,17,12,5,0,0,0
2021-10-13 06:15,32,25,7,0,0,0
2021-10-13 06:30,44,30,14,0,0,0
2021-10-13 06:45,65,41,24,0,0,0
2021-10-13 07:00,71,45,26,0,0,0
2021-10-13 07:15,104,56,48,0,0,0
2021-10-13 07:30,104,76,28,0,0,0
2021-10-13 07:45,141,98,43,0,0,0
2021-10-13 08:00,100,67,33,0,0,0
2021-10-13 08:15,116,74,42,0,0,0
2021-10-13 08:30,107,73,34,0,0,0
2021-10-13 08:45,137,96,41,0,0,0
2021-10-13 09:00,96,56,40,0,0,0
2021-10-13 09:15,103,65,38,0,0,0
2021-10-13 09:30,121,91,30,0,0,0
2021-10-13 09:45,134,88,46,0,0,0
2021-10-13 10:00,98,49,49,0,0,0
2021-10-13 10:15,89,50,39,0,0,0
2021-10-13 10:30,93,62,31,0,0,0
2021-10-13 10:45,113,58,55,0,0,0
2021-10-13 11:00,104,53,51,0,0,0
2021-10-13 11:15,133,66,67,0,0,0
2021-10-13 11:30,159,66,93,0,0,0
2021-10-13 11:45,177,91,86,0,0,0
2021-10-13 12:00,174,76,98,0,0,0
2021-10-13 12:15,125,65,60,0,0,0
2021-10-13 12:30,150,55,95,0,0,0
2021-10-13 12:45,147,66,81,0,0,0
2021-10-13 13:00,138,62,76,0,0,0
2021-10-13 13:15,161,61,100,0,0,0
2021-10-13 13:30,160,73,87,0,0,0
2021-10-13 13:45,187,70,117,0,0,0
2021-10-13 14:00,149,64,85,0,0,0
2021-10-13 14:15,161,69,92,0,0,0
2021-10-13 14:30,144,56,88,0,0,0
2021-10-13 14:45,128,51,77,0,0,0
2021-10-13 15:00,124,47,77,0,0,0
2021-10-13 15:15,119,51,68,0,0,0
2021-10-13 15:30,139,58,81,0,0,0
2021-10-13 15:45,186,72,114,0,0,0
2021-10-13 16:00,178,72,106,0,0,0
2021-10-13 16:15,151,58,93,0,0,0
2021-10-13 16:30,168,77,91,0,0,0
2021-10-13 16:45,161,71,90,0,0,0
2021-10-13 17:00,187,60,127,0,0,0
2021-10-13 17:15,173,77,96,0,0,0
2021-10-13 17:30,179,65,114,0,0,0
2021-10-13 17:45,160,56,104,0,0,0
2021-10-13 18:00,150,52,98,0,0,0
2021-10-13 18:15,165,49,116,0,0,0
2021-10-13 18:30,126,46,80,0,0,0
2021-10-13 18:45,125,58,67,0,0,0
2021-10-13 19:00,130,47,83,0,0,0
2021-10-13 19:15,103,37,66,0,0,0
2021-10-13 19:30,84,37,47,0,0,0
2021-10-13 19:45,74,31,43,0,0,0
2021-10-13 20:00,76,33,43,0,0,0
2021-10-13 20:15,60,27,33,0,0,0
2021-10-13 20:30,66,25,41,0,0,0
2021-10-13 20:45,48,23,25,0,0,0
2021-10-13 21:00,53,17,36,0,0,0
2021-10-13 21:15,42,22,20,0,0,0
2021-10-13 21:30,56,14,42,0,0,0
2021-10-13 21:45,42,15,27,0,0,0
2021-10-13 22:00,50,18,32,0,0,0
2021-10-13 22:15,50,13,37,0,0,0
2021-10-13 22:30,46,20,26,0,0,0
2021-10-13 22:45,43,16,27,0,0,0
2021-10-13 23:00,35,15,20,0,0,0
2021-10-13 23:15,26,4,22,0,0,0
2021-10-13 23:30,8,3,5,0,0,0
2021-10-13 23:45,33,9,24,0,0,0
2021-10-14 00:00,30,4,26,0,0,0
2021-10-14 00:15,26,9,17,0,0,0
2021-10-14 00:30,20,4,16,0,0,0
2021-10-14 00:45,17,3,14,0,0,0
2021-10-14 01:00,15,2,13,0,0,0
2021-10-14 01:15,9,2,7,0,0,0
2021-10-14 01:30,10,0,10,0,0,0
2021-10-14 01:45,12,2,10,0,0,0
2021-10-14 02:00,6,0,6,0,0,0
2021-10-14 02:15,2,1,1,0,0,0
2021-10-14 02:30,6,0,6,0,0,0
2021-10-14 02:45,4,1,3,0,0,0
2021-10-14 03:00,8,0,8,0,0,0
2021-10-14 03:15,9,0,9,0,0,0
2021-10-14 03:30,5,0,5,0,0,0
2021-10-14 03:45,3,0,3,0,0,0
2021-10-14 04:00,3,0,3,0,0,0
2021-10-14 04:15,5,2,3,0,0,0
2021-10-14 04:30,0,0,0,0,0,0
2021-10-14 04:45,3,3,0,0,0,0
2021-10-14 05:00,4,4,0,0,0,0
2021-10-14 05:15,6,2,4,0,0,0
2021-10-14 05:30,18,16,2,0,0,0
2021-10-14 05:45,25,17,8,0,0,0
2021-10-14 06:00,20,15,5,0,0,0
2021-10-14 06:15,26,17,9,0,0,0
2021-10-14 06:30,48,27,21,0,0,0
2021-10-14 06:45,42,30,12,0,0,0
2021-10-14 07:00,56,33,23,0,0,0
2021-10-14 07:15,88,55,33,0,0,0
2021-10-14 07:30,101,66,35,0,0,0
2021-10-14 07:45,125,95,30,0,0,0
2021-10-14 08:00,99,64,35,0,0,0
2021-10-14 08:15,126,79,47,0,0,0
2021-10-14 08:30,93,68,25,0,0,0
2021-10-14 08:45,92,63,29,0,0,0
2021-10-14 09:00,67,38,29,0,0,0
2021-10-14 09:15,72,46,26,0,0,0
2021-10-14 09:30,93,57,36,0,0,0
2021-10-14 09:45,122,87,35,0,0,0
2021-10-14 10:00,81,53,28,0,0,0
2021-10-14 10:15,58,32,26,0,0,0
2021-10-14 10:30,75,40,35,0,0,0
2021-10-14 10:45,91,40,51,0,0,0
2021-10-14 11:00,70,33,37,0,0,0
2021-10-14 11:15,78,31,47,0,0,0
2021-10-14 11:30,96,42,54,0,0,0
2021-10-14 11:45,96,60,36,0,0,0
2021-10-14 12:00,117,51,66,0,0,0
2021-10-14 12:15,97,40,57,0,0,0
2021-10-14 12:30,88,40,48,0,0,0
2021-10-14 12:45,113,60,53,0,0,0
2021-10-14 13:00,93,32,61,0,0,0
2021-10-14 13:15,117,46,71,0,0,0
2021-10-14 13:30,109,53,56,0,0,0
2021-10-14 13:45,145,71,74,0,0,0
2021-10-14 14:00,116,37,79,0,0,0
2021-10-14 14:15,130,58,72,0,0,0
2021-10-14 14:30,115,44,71,0,0,0
2021-10-14 14:45,148,57,91,0,0,0
2021-10-14 15:00,141,58,83,0,0,0
2021-10-14 15:15,147,60,87,0,0,0
2021-10-14 15:30,148,69,79,0,0,0
2021-10-14 15:45,197,89,108,0,0,0
2021-10-14 16:00,142,78,64,0,0,0
2021-10-14 16:15,170,62,108,0,0,0
2021-10-14 16:30,172,63,109,0,0,0
2021-10-14 16:45,164,57,107,0,0,0
2021-10-14 17:00,174,64,110,0,0,0
2021-10-14 17:15,162,75,87,0,0,0
2021-10-14 17:30,171,58,113,0,0,0
2021-10-14 17:45,182,73,109,0,0,0
2021-10-14 18:00,178,67,111,0,0,0
2021-10-14 18:15,139,48,91,0,0,0
2021-10-14 18:30,121,43,78,0,0,0
2021-10-14 18:45,118,54,64,0,0,0
2021-10-14 19:00,87,26,61,0,0,0
2021-10-14 19:15,97,42,55,0,0,0
2021-10-14 19:30,91,25,66,0,0,0
2021-10-14 19:45,84,42,42,0,0,0
2021-10-14 20:00,63,17,46,0,0,0
2021-10-14 20:15,75,28,47,0,0,0
2021-10-14 20:30,38,15,23,0,0,0
2021-10-14 20:45,44,22,22,0,0,0
2021-10-14 21:00,52,24,28,0,0,0
2021-10-14 21:15,24,10,14,0,0,0
2021-10-14 21:30,41,16,25,0,0,0
2021-10-14 21:45,35,8,27,0,0,0
2021-10-14 22:00,38,8,30,0,0,0
2021-10-14 22:15,41,12,29,0,0,0
2021-10-14 22:30,45,15,30,0,0,0
2021-10-14 22:45,25,9,16,0,0,0
2021-10-14 23:00,24,4,20,0,0,0
2021-10-14 23:15,24,11,13,0,0,0
2021-10-14 23:30,27,6,21,0,0,0
2021-10-14 23:45,26,4,22,0,0,0
2021-10-15 00:00,20,7,13,0,0,0
2021-10-15 00:15,19,7,12,0,0,0
2021-10-15 00:30,9,5,4,0,0,0
2021-10-15 00:45,6,2,4,0,0,0
2021-10-15 01:00,4,1,3,0,0,0
2021-10-15 01:15,13,2,11,0,0,0
2021-10-15 01:30,7,1,6,0,0,0
2021-10-15 01:45,3,0,3,0,0,0
2021-10-15 02:00,3,1,2,0,0,0
2021-10-15 02:15,4,1,3,0,0,0
2021-10-15 02:30,3,0,3,0,0,0
2021-10-15 02:45,0,0,0,0,0,0
2021-10-15 03:00,2,1,1,0,0,0
2021-10-15 03:15,2,0,2,0,0,0
2021-10-15 03:30,2,0,2,0,0,0
2021-10-15 03:45,3,0,3,0,0,0
2021-10-15 04:00,0,0,0,0,0,0
2021-10-15 04:15,3,2,1,0,0,0
2021-10-15 04:30,4,2,2,0,0,0
2021-10-15 04:45,2,1,1,0,0,0
2021-10-15 05:00,5,5,0,0,0,0
2021-10-15 05:15,9,6,3,0,0,0
2021-10-15 05:30,19,16,3,0,0,0
2021-10-15 05:45,17,12,5,0,0,0
2021-10-15 06:00,22,18,4,0,0,0
2021-10-15 06:15,21,16,5,0,0,0
2021-10-15 06:30,42,27,15,0,0,0
2021-10-15 06:45,41,25,16,0,0,0
2021-10-15 07:00,51,29,22,0,0,0
2021-10-15 07:15,79,52,27,0,0,0
2021-10-15 07:30,88,55,33,0,0,0
2021-10-15 07:45,126,83,43,0,0,0
2021-10-15 08:00,90,59,31,0,0,0
2021-10-15 08:15,85,62,23,0,0,0
2021-10-15 08:30,99,63,36,0,0,0
2021-10-15 08:45,105,62,43,0,0,0
2021-10-15 09:00,86,53,33,0,0,0
2021-10-15 09:15,72,42,30,0,0,0
2021-10-15 09:30,86,56,30,0,0,0
2021-10-15 09:45,107,72,35,0,0,0
2021-10-15 10:00,65,25,40,0,0,0
2021-10-15 10:15,52,26,26,0,0,0
2021-10-15 10:30,55,27,28,0,0,0
2021-10-15 10:45,78,42,36,0,0,0
2021-10-15 11:00,69,40,29,0,0,0
2021-10-15 11:15,83,40,43,0,0,0
2021-10-15 11:30,79,37,42,0,0,0
2021-10-15 11:45,98,46,52,0,0,0
2021-10-15 12:00,110,45,65,0,0,0
2021-10-15 12:15,110,45,65,0,0,0
2021-10-15 12:30,98,41,57,0,0,0
2021-10-15 12:45,132,57,75,0,0,0
2021-10-15 13:00,101,49,52,0,0,0
2021-10-15 13:15,144,59,85,0,0,0
2021-10-15 13:30,123,59,64,0,0,0
2021-10-15 13:45,144,64,80,0,0,0
2021-10-15 14:00,144,75,69,0,0,0
2021-10-15 14:15,152,58,94,0,0,0
2021-10-15 14:30,164,68,96,0,0,0
2021-10-15 14:45,158,70,88,0,0,0
2021-10-15 15:00,141,42,99,0,0,0
2021-10-15 15:15,134,73,61,0,0,0
2021-10-15 15:30,145,68,77,0,0,0
2021-10-15 15:45,178,63,115,0,0,0
2021-10-15 16:00,166,72,94,0,0,0
2021-10-15 16:15,162,71,91,0,0,0
2021-10-15 16:30,167,75,92,0,0,0
2021-10-15 16:45,143,63,80,0,0,0
2021-10-15 17:00,156,67,89,0,0,0
2021-10-15 17:15,136,53,83,0,0,0
2021-10-15 17:30,142,41,101,0,0,0
2021-10-15 17:45,157,63,94,0,0,0
2021-10-15 18:00,114,48,66,0,0,0
2021-10-15 18:15,144,56,88,0,0,0
2021-10-15 18:30,113,42,71,0,0,0
2021-10-15 18:45,104,45,59,0,0,0
2021-10-15 19:00,121,53,68,0,0,0
2021-10-15 19:15,134,66,68,0,0,0
2021-10-15 19:30,87,35,52,0,0,0
2021-10-15 19:45,100,48,52,0,0,0
2021-10-15 20:00,89,48,41,0,0,0
2021-10-15 20:15,73,31,42,0,0,0
2021-10-15 20:30,67,30,37,0,0,0
2021-10-15 20:45,56,32,24,0,0,0
2021-10-15 21:00,49,19,30,0,0,0
2021-10-15 21:15,35,16,19,0,0,0
2021-10-15 21:30,46,18,28,0,0,0
2021-10-15 21:45,27,7,20,0,0,0
2021-10-15 22:00,44,9,35,0,0,0
2021-10-15 22:15,44,16,28,0,0,0
2021-10-15 22:30,64,18,46,0,0,0
2021-10-15 22:45,35,4,31,0,0,0
2021-10-15 23:00,40,19,21,0,0,0
2021-10-15 23:15,28,5,23,0,0,0
2021-10-15 23:30,49,17,32,0,0,0
2021-10-15 23:45,33,8,25,0,0,0
2021-10-16 00:00,34,15,19,0,0,0
2021-10-16 00:15,17,4,13,0,0,0
2021-10-16 00:30,31,17,14,0,0,0
2021-10-16 00:45,25,14,11,0,0,0
2021-10-16 01:00,13,1,12,0,0,0
2021-10-16 01:15,17,4,13,0,0,0
2021-10-16 01:30,17,8,9,0,0,0
2021-10-16 01:45,25,11,14,0,0,0
2021-10-16 02:00,21,6,15,0,0,0
2021-10-16 02:15,21,1,20,0,0,0
2021-10-16 02:30,23,4,19,0,0,0
2021-10-16 02:45,19,4,15,0,0,0
2021-10-16 03:00,10,3,7,0,0,0
2021-10-16 03:15,19,2,17,0,0,0
2021-10-16 03:30,10,2,8,0,0,0
2021-10-16 03:45,9,1,8,0,0,0
2021-10-16 04:00,4,1,3,0,0,0
2021-10-16 04:15,4,0,4,0,0,0
2021-10-16 04:30,10,1,9,0,0,0
2021-10-16 04:45,3,1,2,0,0,0
2021-10-16 05:00,4,1,3,0,0,0
2021-10-16 05:15,8,4,4,0,0,0
2021-10-16 05:30,8,4,4,0,0,0
2021-10-16 05:45,15,9,6,0,0,0
2021-10-16 06:00,3,2,1,0,0,0
2021-10-16 06:15,6,5,1,0,0,0
2021-10-16 06:30,9,5,4,0,0,0
2021-10-16 06:45,8,4,4,0,0,0
2021-10-16 07:00,10,5,5,0,0,0
2021-10-16 07:15,7,3,4,0,0,0
2021-10-16 07:30,21,9,12,0,0,0
2021-10-16 07:45,21,14,7,0,0,0
2021-10-16 08:00,19,11,8,0,0,0
2021-10-16 08:15,18,9,9,0,0,0
2021-10-16 08:30,33,19,14,0,0,0
2021-10-16 08:45,53,36,17,0,0,0
2021-10-16 09:00,53,28,25,0,0,0
2021-10-16 09:15,61,39,22,0,0,0
2021-10-16 09:30,78,54,24,0,0,0
2021-10-16 09:45,108,71,37,0,0,0
2021-10-16 10:00,78,51,27,0,0,0
2021-10-16 10:15,86,62,24,0,0,0
2021-10-16 10:30,113,65,48,0,0,0
2021-10-16 10:45,122,68,54,0,0,0
2021-10-16 11:00,128,73,55,0,0,0
2021-10-16 11:15,124,66,58,0,0,0
2021-10-16 11:30,132,77,55,0,0,0
2021-10-16 11:45,188,102,86,0,0,0
2021-10-16 12:00,188,110,78,0,0,0
2021-10-16 12:15,130,73,57,0,0,0
2021-10-16 12:30,155,73,82,0,0,0
2021-10-16 12:45,151,82,69,0,0,0
2021-10-16 13:00,152,69,83,0,0,0
2021-10-16 13:15,143,57,86,0,0,0
2021-10-16 13:30,162,76,86,0,0,0
2021-10-16 13:45,152,70,82,0,0,0
2021-10-16 14:00,167,56,111,0,0,0
2021-10-16 14:15,135,51,84,0,0,0
2021-10-16 14:30,162,59,103,0,0,0
2021-10-16 14:45,156,64,92,0,0,0
2021-10-16 15:00,128,57,71,0,0,0
2021-10-16 15:15,120,52,68,0,0,0
2021-10-16 15:30,111,38,73,0,0,0
2021-10-16 15:45,138,58,80,0,0,0
2021-10-16 16:00,110,45,65,0,0,0
2021-10-16 16:15,106,28,78,0,0,0
2021-10-16 16:30,129,60,69,0,0,0
2021-10-16 16:45,132,56,76,0,0,0
2021-10-16 17:00,102,33,69,0,0,0
2021-10-16 17:15,108,34,74,0,0,0
2021-10-16 17:30,101,43,58,0,0,0
2021-10-16 17:45,107,43,64,0,0,0
2021-10-16 18:00,101,40,61,0,0,0
2021-10-16 18:15,105,34,71,0,0,0
2021-10-16 18:30,113,40,73,0,0,0
2021-10-16 18:45,122,48,74,0,0,0
2021-10-16 19:00,109,47,62,0,0,0
2021-10-16 19:15,57,24,33,0,0,0
2021-10-16 19:30,69,34,35,0,0,0
2021-10-16 19:45,81,42,39,0,0,0
2021-10-16 20:00,60,15,45,0,0,0
2021-10-16 20:15,58,26,32,0,0,0
2021-10-16 20:30,67,10,57,0,0,0
2021-10-16 20:45,55,23,32,0,0,0
2021-10-16 21:00,47,14,33,0,0,0
2021-10-16 21:15,42,16,26,0,0,0
2021-10-16 21:30,36,10,26,0,0,0
2021-10-16 21:45,30,14,16,0,0,0
2021-10-16 22:00,26,5,21,0,0,0
2021-10-16 22:15,36,7,29,0,0,0
2021-10-16 22:30,26,5,21,0,0,0
2021-10-16 22:45,23,13,10,0,0,0
2021-10-16 23:00,20,7,13,0,0,0
2021-10-16 23:15,32,9,23,0,0,0
2021-10-16 23:30,35,10,25,0,0,0
2021-10-16 23:45,37,14,23,0,0,0
2021-10-17 00:00,35,7,28,0,0,0
2021-10-17 00:15,37,11,26,0,0,0
2021-10-17 00:30,37,13,24,0,0,0
2021-10-17 00:45,27,7,20,0,0,0
2021-10-17 01:00,21,4,17,0,0,0
2021-10-17 01:15,31,6,25,0,0,0
2021-10-17 01:30,18,10,8,0,0,0
2021-10-17 01:45,24,6,18,0,0,0
2021-10-17 02:00,22,6,16,0,0,0
2021-10-17 02:15,24,7,17,0,0,0
2021-10-17 02:30,42,14,28,0,0,0
2021-10-17 02:45,13,5,8,0,0,0
2021-10-17 03:00,20,5,15,0,0,0
2021-10-17 03:15,12,1,11,0,0,0
2021-10-17 03:30,7,3,4,0,0,0
2021-10-17 03:45,6,1,5,0,0,0
2021-10-17 04:00,7,1,6,0,0,0
2021-10-17 04:15,8,0,8,0,0,0
2021-10-17 04:30,5,1,4,0,0,0
2021-10-17 04:45,4,1,3,0,0,0
2021-10-17 05:00,5,2,3,0,0,0
2021-10-17 05:15,8,2,6,0,0,0
2021-10-17 05:30,12,6,6,0,0,0
2021-10-17 05:45,1,1,0,0,0,0
2021-10-17 06:00,1,0,1,0,0,0
2021-10-17 06:15,5,3,2,0,0,0
2021-10-17 06:30,2,1,1,0,0,0
2021-10-17 06:45,7,5,2,0,0,0
2021-10-17 07:00,3,2,1,0,0,0
2021-10-17 07:15,1,0,1,0,0,0
2021-10-17 07:30,7,5,2,0,0,0
2021-10-17 07:45,12,7,5,0,0,0
2021-10-17 08:00,6,5,1,0,0,0
2021-10-17 08:15,10,4,6,0,0,0
2021-10-17 08:30,14,11,3,0,0,0
2021-10-17 08:45,11,3,8,0,0,0
2021-10-17 09:00,4,2,2,0,0,0
2021-10-17 09:15,15,9,6,0,0,0
2021-10-17 09:30,18,12,6,0,0,0
2021-10-17 09:45,42,20,22,0,0,0
2021-10-17 10:00,33,14,19,0,0,0
2021-10-17 10:15,25,15,10,0,0,0
2021-10-17 10:30,35,21,14,0,0,0
2021-10-17 10:45,38,19,19,0,0,0
2021-10-17 11:00,42,23,19,0,0,0
2021-10-17 11:15,28,15,13,0,0,0
2021-10-17 11:30,26,17,9,0,0,0
2021-10-17 11:45,54,25,29,0,0,0
2021-10-17 12:00,60,31,29,0,0,0
2021-10-17 12:15,56,24,32,0,0,0
2021-10-17 12:30,49,27,22,0,0,0
2021-10-17 12:45,53,43,10,0,0,0
2021-10-17 13:00,35,14,21,0,0,0
2021-10-17 13:15,50,23,27,0,0,0
2021-10-17 13:30,50,18,32,0,0,0
2021-10-17 13:45,85,46,39,0,0,0
2021-10-17 14:00,63,27,36,0,0,0
2021-10-17 14:15,58,31,27,0,0,0
2021-10-17 14:30,61,22,39,0,0,0
2021-10-17 14:45,83,42,41,0,0,0
2021-10-17 15:00,84,45,39,0,0,0
2021-10-17 15:15,71,28,43,0,0,0
2021-10-17 15:30,75,36,39,0,0,0
2021-10-17 15:45,66,40,26,0,0,0
2021-10-17 16:00,66,26,40,0,0,0
2021-10-17 16:15,74,41,33,0,0,0
2021-10-17 16:30,67,27,40,0,0,0
2021-10-17 16:45,73,26,47,0,0,0
2021-10-17 17:00,87,31,56,0,0,0
2021-10-17 17:15,71,26,45,0,0,0
2021-10-17 17:30,86,37,49,0,0,0
2021-10-17 17:45,96,40,56,0,0,0
2021-10-17 18:00,81,32,49,0,0,0
2021-10-17 18:15,69,37,32,0,0,0
2021-10-17 18:30,76,23,53,0,0,0
2021-10-17 18:45,53,21,32,0,0,0
2021-10-17 19:00,62,32,30,0,0,0
2021-10-17 19:15,48,23,25,0,0,0
2021-10-17 19:30,51,17,34,0,0,0
2021-10-17 19:45,49,20,29,0,0,0
2021-10-17 20:00,41,10,31,0,0,0
2021-10-17 20:15,41,17,24,0,0,0
2021-10-17 20:30,32,10,22,0,0,0
2021-10-17 20:45,33,10,23,0,0,0
2021-10-17 21:00,34,9,25,0,0,0
2021-10-17 21:15,20,5,15,0,0,0
2021-10-17 21:30,26,6,20,0,0,0
2021-10-17 21:45,35,10,25,0,0,0
2021-10-17 22:00,29,10,19,0,0,0
2021-10-17 22:15,16,4,12,0,0,0
2021-10-17 22:30,18,8,10,0,0,0
2021-10-17 22:45,17,6,11,0,0,0
2021-10-17 23:00,15,8,7,0,0,0
2021-10-17 23:15,12,3,9,0,0,0
2021-10-17 23:30,5,4,1,0,0,0
2021-10-17 23:45,11,1,10,0,0,0
2021-10-18 00:00,12,3,9,0,0,0
2021-10-18 00:15,2,0,2,0,0,0
2021-10-18 00:30,5,1,4,0,0,0
2021-10-18 00:45,4,0,4,0,0,0
2021-10-18 01:00,5,0,5,0,0,0
2021-10-18 01:15,0,0,0,0,0,0
2021-10-18 01:30,5,0,5,0,0,0
2021-10-18 01:45,3,2,1,0,0,0
2021-10-18 02:00,3,1,2,0,0,0
2021-10-18 02:15,1,1,0,0,0,0
2021-10-18 02:30,0,0,0,0,0,0
2021-10-18 02:45,2,0,2,0,0,0
2021-10-18 03:00,1,0,1,0,0,0
2021-10-18 03:15,0,0,0,0,0,0
2021-10-18 03:30,2,0,2,0,0,0
2021-10-18 03:45,0,0,0,0,0,0
2021-10-18 04:00,1,1,0,0,0,0
2021-10-18 04:15,2,0,2,0,0,0
2021-10-18 04:30,3,2,1,0,0,0
2021-10-18 04:45,2,2,0,0,0,0
2021-10-18 05:00,3,2,1,0,0,0
2021-10-18 05:15,10,6,4,0,0,0
2021-10-18 05:30,14,12,2,0,0,0
2021-10-18 05:45,25,18,7,0,0,0
2021-10-18 06:00,16,11,5,0,0,0
2021-10-18 06:15,30,25,5,0,0,0
2021-10-18 06:30,43,25,18,0,0,0
2021-10-18 06:45,45,28,17,0,0,0
2021-10-18 07:00,71,41,30,0,0,0
2021-10-18 07:15,92,61,31,0,0,0
2021-10-18 07:30,130,81,49,0,0,0
2021-10-18 07:45,165,107,58,0,0,0
2021-10-18 08:00,118,74,44,0,0,0
2021-10-18 08:15,109,79,30,0,0,0
2021-10-18 08:30,104,54,50,0,0,0
2021-10-18 08:45,109,69,40,0,0,0
2021-10-18 09:00,73,42,31,0,0,0
2021-10-18 09:15,66,48,18,0,0,0
2021-10-18 09:30,124,79,45,0,0,0
2021-10-18 09:45,124,87,37,0,0,0
2021-10-18 10:00,81,58,23,0,0,0
2021-10-18 10:15,95,58,37,0,0,0
2021-10-18 10:30,99,53,46,0,0,0
2021-10-18 10:45,123,76,47,0,0,0
2021-10-18 11:00,103,57,46,0,0,0
2021-10-18 11:15,99,55,44,0,0,0
2021-10-18 11:30,130,64,66,0,0,0
2021-10-18 11:45,138,74,64,0,0,0
2021-10-18 12:00,149,71,78,0,0,0
2021-10-18 12:15,140,55,85,0,0,0
2021-10-18 12:30,129,50,79,0,0,0
2021-10-18 12:45,148,57,91,0,0,0
2021-10-18 13:00,143,60,83,0,0,0
2021-10-18 13:15,126,43,83,0,0,0
2021-10-18 13:30,126,61,65,0,0,0
2021-10-18 13:45,181,83,98,0,0,0
2021-10-18 14:00,158,71,87,0,0,0
2021-10-18 14:15,149,63,86,0,0,0
2021-10-18 14:30,122,36,86,0,0,0
2021-10-18 14:45,164,72,92,0,0,0
2021-10-18 15:00,156,67,89,0,0,0
2021-10-18 15:15,166,70,96,0,0,0
2021-10-18 15:30,166,77,89,0,0,0
2021-10-18 15:45,200,91,109,0,0,0
2021-10-18 16:00,206,75,131,0,0,0
2021-10-18 16:15,210,75,135,0,0,0
2021-10-18 16:30,171,66,105,0,0,0
2021-10-18 16:45,183,61,122,0,0,0
2021-10-18 17:00,187,68,119,0,0,0
2021-10-18 17:15,192,77,115,0,0,0
2021-10-18 17:30,214,73,141,0,0,0
2021-10-18 17:45,220,67,153,0,0,0
2021-10-18 18:00,185,63,122,0,0,0
2021-10-18 18:15,187,63,124,0,0,0
2021-10-18 18:30,136,41,95,0,0,0
2021-10-18 18:45,141,39,102,0,0,0
2021-10-18 19:00,134,30,104,0,0,0
2021-10-18 19:15,122,36,86,0,0,0
2021-10-18 19:30,97,29,68,0,0,0
2021-10-18 19:45,102,35,67,0,0,0
2021-10-18 20:00,109,35,74,0,0,0
2021-10-18 20:15,60,15,45,0,0,0
2021-10-18 20:30,49,24,25,0,0,0
2021-10-18 20:45,52,10,42,0,0,0
2021-10-18 21:00,39,22,17,0,0,0
2021-10-18 21:15,46,11,35,0,0,0
2021-10-18 21:30,48,15,33,0,0,0
2021-10-18 21:45,39,12,27,0,0,0
2021-10-18 22:00,47,16,31,0,0,0
2021-10-18 22:15,45,15,30,0,0,0
2021-10-18 22:30,39,10,29,0,0,0
2021-10-18 22:45,34,7,27,0,0,0
2021-10-18 23:00,24,8,16,0,0,0
2021-10-18 23:15,31,12,19,0,0,0
2021-10-18 23:30,10,3,7,0,0,0
2021-10-18 23:45,16,5,11,0,0,0
2021-10-19 00:00,10,5,5,0,0,0
2021-10-19 00:15,10,5,5,0,0,0
2021-10-19 00:30,6,2,4,0,0,0
2021-10-19 00:45,2,1,1,0,0,0
2021-10-19 01:00,7,0,7,0,0,0
2021-10-19 01:15,8,7,1,0,0,0
2021-10-19 01:30,2,0,2,0,0,0
2021-10-19 01:45,4,1,3,0,0,0
2021-10-19 02:00,0,0,0,0,0,0
2021-10-19 02:15,4,0,4,0,0,0
2021-10-19 02:30,1,1,0,0,0,0
2021-10-19 02:45,0,0,0,0,0,0
2021-10-19 03:00,3,2,1,0,0,0
2021-10-19 03:15,1,0,1,0,0,0
2021-10-19 03:30,3,0,3,0,0,0
2021-10-19 03:45,1,0,1,0,0,0
2021-10-19 04:00,0,0,0,0,0,0
2021-10-19 04:15,3,2,1,0,0,0
2021-10-19 04:30,0,0,0,0,0,0
2021-10-19 04:45,2,2,0,0,0,0
2021-10-19 05:00,8,7,1,0,0,0
2021-10-19 05:15,9,3,6,0,0,0
2021-10-19 05:30,15,10,5,0,0,0
2021-10-19 05:45,22,16,6,0,0,0
2021-10-19 06:00,25,16,9,0,0,0
2021-10-19 06:15,34,26,8,0,0,0
2021-10-19 06:30,43,26,17,0,0,0
2021-10-19 06:45,57,38,19,0,0,0
2021-10-19 07:00,58,34,24,0,0,0
2021-10-19 07:15,86,56,30,0,0,0
2021-10-19 07:30,134,84,50,0,0,0
2021-10-19 07:45,172,125,47,0,0,0
2021-10-19 08:00,121,85,36,0,0,0
2021-10-19 08:15,130,82,48,0,0,0
2021-10-19 08:30,95,61,34,0,0,0
2021-10-19 08:45,120,76,44,0,0,0
2021-10-19 09:00,70,45,25,0,0,0
2021-10-19 09:15,69,41,28,0,0,0
2021-10-19 09:30,91,63,28,0,0,0
2021-10-19 09:45,137,100,37,0,0,0
2021-10-19 10:00,97,55,42,0,0,0
2021-10-19 10:15,98,53,45,0,0,0
2021-10-19 10:30,82,48,34,0,0,0
2021-10-19 10:45,113,66,47,0,0,0
2021-10-19 11:00,98,55,43,0,0,0
2021-10-19 11:15,95,56,39,0,0,0
2021-10-19 11:30,98,32,66,0,0,0
2021-10-19 11:45,167,83,84,0,0,0
2021-10-19 12:00,134,59,75,0,0,0
2021-10-19 12:15,117,52,65,0,0,0
2021-10-19 12:30,108,47,61,0,0,0
2021-10-19 12:45,116,51,65,0,0,0
2021-10-19 13:00,111,40,71,0,0,0
2021-10-19 13:15,81,29,52,0,0,0
2021-10-19 13:30,86,34,52,0,0,0
2021-10-19 13:45,102,41,61,0,0,0
2021-10-19 14:00,107,34,73,0,0,0
2021-10-19 14:15,111,42,69,0,0,0
2021-10-19 14:30,90,28,62,0,0,0
2021-10-19 14:45,111,49,62,0,0,0
2021-10-19 15:00,111,32,79,0,0,0
2021-10-19 15:15,90,47,43,0,0,0
2021-10-19 15:30,121,47,74,0,0,0
2021-10-19 15:45,162,73,89,0,0,0
2021-10-19 16:00,129,35,94,0,0,0
2021-10-19 16:15,154,59,95,0,0,0
2021-10-19 16:30,144,46,98,0,0,0
2021-10-19 16:45,158,62,96,0,0,0
2021-10-19 17:00,180,65,115,0,0,0
2021-10-19 17:15,147,54,93,0,0,0
2021-10-19 17:30,165,55,110,0,0,0
2021-10-19 17:45,147,53,94,0,0,0
2021-10-19 18:00,166,57,109,0,0,0
2021-10-19 18:15,156,62,94,0,0,0
2021-10-19 18:30,91,26,65,0,0,0
2021-10-19 18:45,109,40,69,0,0,0
2021-10-19 19:00,109,36,73,0,0,0
2021-10-19 19:15,85,40,45,0,0,0
2021-10-19 19:30,98,30,68,0,0,0
2021-10-19 19:45,90,29,61,0,0,0
2021-10-19 20:00,64,15,49,0,0,0
2021-10-19 20:15,54,25,29,0,0,0
2021-10-19 20:30,73,22,51,0,0,0
2021-10-19 20:45,36,11,25,0,0,0
2021-10-19 21:00,53,21,32,0,0,0
2021-10-19 21:15,43,15,28,0,0,0
2021-10-19 21:30,30,7,23,0,0,0
2021-10-19 21:45,31,10,21,0,0,0
2021-10-19 22:00,36,12,24,0,0,0
2021-10-19 22:15,36,16,20,0,0,0
2021-10-19 22:30,35,8,27,0,0,0
2021-10-19 22:45,36,17,19,0,0,0
2021-10-19 23:00,31,6,25,0,0,0
2021-10-19 23:15,33,7,26,0,0,0
2021-10-19 23:30,21,6,15,0,0,0
2021-10-19 23:45,17,4,13,0,0,0
2021-10-20 00:00,18,6,12,0,0,0
2021-10-20 00:15,13,2,11,0,0,0
2021-10-20 00:30,13,3,10,0,0,0
2021-10-20 00:45,5,1,4,0,0,0
2021-10-20 01:00,6,0,6,0,0,0
2021-10-20 01:15,4,1,3,0,0,0
2021-10-20 01:30,4,1,3,0,0,0
2021-10-20 01:45,3,2,1,0,0,0
2021-10-20 02:00,3,1,2,0,0,0
2021-10-20 02:15,1,0,1,0,0,0
2021-10-20 02:30,3,1,2,0,0,0
2021-10-20 02:45,3,0,3,0,0,0
2021-10-20 03:00,0,0,0,0,0,0
2021-10-20 03:15,0,0,0,0,0,0
2021-10-20 03:30,1,0,1,0,0,0
2021-10-20 03:45,1,0,1,0,0,0
2021-10-20 04:00,2,1,1,0,0,0
2021-10-20 04:15,2,1,1,0,0,0
2021-10-20 04:30,6,1,5,0,0,0
2021-10-20 04:45,2,1,1,0,0,0
2021-10-20 05:00,6,4,2,0,0,0
2021-10-20 05:15,12,7,5,0,0,0
2021-10-20 05:30,15,12,3,0,0,0
2021-10-20 05:45,23,19,4,0,0,0
2021-10-20 06:00,26,18,8,0,0,0
2021-10-20 06:15,25,17,8,0,0,0
2021-10-20 06:30,42,26,16,0,0,0
2021-10-20 06:45,50,36,14,0,0,0
2021-10-20 07:00,72,50,22,0,0,0
2021-10-20 07:15,90,59,31,0,0,0
2021-10-20 07:30,123,80,43,0,0,0
2021-10-20 07:45,168,113,55,0,0,0
2021-10-20 08:00,133,84,49,0,0,0
2021-10-20 08:15,134,82,52,0,0,0
2021-10-20 08:30,99,61,38,0,0,0
2021-10-20 08:45,137,83,54,0,0,0
2021-10-20 09:00,89,63,26,0,0,0
2021-10-20 09:15,69,39,30,0,0,0
2021-10-20 09:30,101,70,31,0,0,0
2021-10-20 09:45,132,90,42,0,0,0
2021-10-20 10:00,122,65,57,0,0,0
2021-10-20 10:15,106,59,47,0,0,0
2021-10-20 10:30,102,64,38,0,0,0
2021-10-20 10:45,133,64,69,0,0,0
2021-10-20 11:00,152,68,84,0,0,0
2021-10-20 11:15,111,62,49,0,0,0
2021-10-20 11:30,147,76,71,0,0,0
2021-10-20 11:45,166,91,75,0,0,0
2021-10-20 12:00,138,62,76,0,0,0
2021-10-20 12:15,140,77,63,0,0,0
2021-10-20 12:30,114,43,71,0,0,0
2021-10-20 12:45,133,59,74,0,0,0
2021-10-20 13:00,110,54,56,0,0,0
2021-10-20 13:15,122,50,72,0,0,0
2021-10-20 13:30,123,64,59,0,0,0
2021-10-20 13:45,150,77,73,0,0,0
2021-10-20 14:00,142,54,88,0,0,0
2021-10-20 14:15,116,42,74,0,0,0
2021-10-20 14:30,115,41,74,0,0,0
2021-10-20 14:45,147,56,91,0,0,0
2021-10-20 15:00,134,48,86,0,0,0
2021-10-20 15:15,127,53,74,0,0,0
2021-10-20 15:30,119,47,72,0,0,0
2021-10-20 15:45,139,58,81,0,0,0
2021-10-20 16:00,149,56,93,0,0,0
2021-10-20 16:15,146,58,88,0,0,0
2021-10-20 16:30,124,41,83,0,0,0
2021-10-20 16:45,153,63,90,0,0,0
2021-10-20 17:00,173,60,113,0,0,0
2021-10-20 17:15,147,51,96,0,0,0
2021-10-20 17:30,169,65,104,0,0,0
2021-10-20 17:45,169,72,97,0,0,0
2021-10-20 18:00,179,58,121,0,0,0
2021-10-20 18:15,137,51,86,0,0,0
2021-10-20 18:30,124,44,80,0,0,0
2021-10-20 18:45,130,51,79,0,0,0
2021-10-20 19:00,107,32,75,0,0,0
2021-10-20 19:15,113,56,57,0,0,0
2021-10-20 19:30,74,24,50,0,0,0
2021-10-20 19:45,92,34,58,0,0,0
2021-10-20 20:00,105,49,56,0,0,0
2021-10-20 20:15,47,22,25,0,0,0
2021-10-20 20:30,36,13,23,0,0,0
2021-10-20 20:45,61,20,41,0,0,0
2021-10-20 21:00,60,20,40,0,0,0
2021-10-20 21:15,37,12,25,0,0,0
2021-10-20 21:30,46,18,28,0,0,0
2021-10-20 21:45,52,20,32,0,0,0
2021-10-20 22:00,48,20,28,0,0,0
2021-10-20 22:15,53,19,34,0,0,0
2021-10-20 22:30,36,15,21,0,0,0
2021-10-20 22:45,42,17,25,0,0,0
2021-10-20 23:00,35,17,18,0,0,0
2021-10-20 23:15,29,7,22,0,0,0
2021-10-20 23:30,34,10,24,0,0,0
2021-10-20 23:45,36,13,23,0,0,0
2021-10-21 00:00,21,10,11,0,0,0
2021-10-21 00:15,13,7,6,0,0,0
2021-10-21 00:30,12,2,10,0,0,0
2021-10-21 00:45,24,11,13,0,0,0
2021-10-21 01:00,21,8,13,0,0,0
2021-10-21 01:15,9,1,8,0,0,0
2021-10-21 01:30,3,0,3,0,0,0
2021-10-21 01:45,11,2,9,0,0,0
2021-10-21 02:00,15,0,15,0,0,0
2021-10-21 02:15,8,2,6,0,0,0
2021-10-21 02:30,8,1,7,0,0,0
2021-10-21 02:45,5,2,3,0,0,0
2021-10-21 03:00,6,2,4,0,0,0
2021-10-21 03:15,10,3,7,0,0,0
2021-10-21 03:30,11,0,11,0,0,0
2021-10-21 03:45,8,1,7,0,0,0
2021-10-21 04:00,5,1,4,0,0,0
2021-10-21 04:15,6,3,3,0,0,0
2021-10-21 04:30,2,2,0,0,0,0
2021-10-21 04:45,2,2,0,0,0,0
2021-10-21 05:00,8,6,2,0,0,0
2021-10-21 05:15,3,2,1,0,0,0
2021-10-21 05:30,13,9,4,0,0,0
2021-10-21 05:45,15,12,3,0,0,0
2021-10-21 06:00,13,10,3,0,0,0
2021-10-21 06:15,22,13,9,0,0,0
2021-10-21 06:30,21,15,6,0,0,0
2021-10-21 06:45,43,24,19,0,0,0
2021-10-21 07:00,50,32,18,0,0,0
2021-10-21 07:15,60,41,19,0,0,0
2021-10-21 07:30,83,52,31,0,0,0
2021-10-21 07:45,108,81,27,0,0,0
2021-10-21 08:00,85,62,23,0,0,0
2021-10-21 08:15,84,62,22,0,0,0
2021-10-21 08:30,86,62,24,0,0,0
2021-10-21 08:45,70,49,21,0,0,0
2021-10-21 09:00,52,33,19,0,0,0
2021-10-21 09:15,39,28,11,0,0,0
2021-10-21 09:30,49,30,19,0,0,0
2021-10-21 09:45,64,47,17,0,0,0
2021-10-21 10:00,68,37,31,0,0,0
2021-10-21 10:15,53,29,24,0,0,0
2021-10-21 10:30,60,28,32,0,0,0
2021-10-21 10:45,77,45,32,0,0,0
2021-10-21 11:00,49,30,19,0,0,0
2021-10-21 11:15,56,27,29,0,0,0
2021-10-21 11:30,49,21,28,0,0,0
2021-10-21 11:45,73,39,34,0,0,0
2021-10-21 12:00,76,34,42,0,0,0
2021-10-21 12:15,67,31,36,0,0,0
2021-10-21 12:30,65,24,41,0,0,0
2021-10-21 12:45,62,28,34,0,0,0
2021-10-21 13:00,57,21,36,0,0,0
2021-10-21 13:15,65,26,39,0,0,0
2021-10-21 13:30,60,29,31,0,0,0
2021-10-21 13:45,66,32,34,0,0,0
2021-10-21 14:00,77,29,48,0,0,0
2021-10-21 14:15,74,44,30,0,0,0
2021-10-21 14:30,76,37,39,0,0,0
2021-10-21 14:45,106,49,57,0,0,0
2021-10-21 15:00,74,34,40,0,0,0
2021-10-21 15:15,89,24,65,0,0,0
2021-10-21 15:30,76,28,48,0,0,0
2021-10-21 15:45,78,37,41,0,0,0
2021-10-21 16:00,84,27,57,0,0,0
2021-10-21 16:15,82,21,61,0,0,0
2021-10-21 16:30,103,30,73,0,0,0
2021-10-21 16:45,105,37,68,0,0,0
2021-10-21 17:00,109,33,76,0,0,0
2021-10-21 17:15,124,43,81,0,0,0
2021-10-21 17:30,103,38,65,0,0,0
2021-10-21 17:45,90,31,59,0,0,0
2021-10-21 18:00,110,34,76,0,0,0
2021-10-21 18:15,112,40,72,0,0,0
2021-10-21 18:30,85,32,53,0,0,0
2021-10-21 18:45,111,46,65,0,0,0
2021-10-21 19:00,72,26,46,0,0,0
2021-10-21 19:15,95,31,64,0,0,0
2021-10-21 19:30,91,24,67,0,0,0
2021-10-21 19:45,73,25,48,0,0,0
2021-10-21 20:00,73,23,50,0,0,0
2021-10-21 20:15,56,23,33,0,0,0
2021-10-21 20:30,41,13,28,0,0,0
2021-10-21 20:45,44,13,31,0,0,0
2021-10-21 21:00,34,12,22,0,0,0
2021-10-21 21:15,38,13,25,0,0,0
2021-10-21 21:30,23,4,19,0,0,0
2021-10-21 21:45,39,8,31,0,0,0
2021-10-21 22:00,46,16,30,0,0,0
2021-10-21 22:15,52,13,39,0,0,0
2021-10-21 22:30,48,16,32,0,0,0
2021-10-21 22:45,41,13,28,0,0,0
2021-10-21 23:00,40,9,31,0,0,0
2021-10-21 23:15,24,9,15,0,0,0
2021-10-21 23:30,36,4,32,0,0,0
2021-10-21 23:45,14,5,9,0,0,0
2021-10-22 00:00,13,7,6,0,0,0
2021-10-22 00:15,14,7,7,0,0,0
2021-10-22 00:30,17,2,15,0,0,0
2021-10-22 00:45,6,4,2,0,0,0
2021-10-22 01:00,9,3,6,0,0,0
2021-10-22 01:15,15,1,14,0,0,0
2021-10-22 01:30,7,2,5,0,0,0
2021-10-22 01:45,13,0,13,0,0,0
2021-10-22 02:00,4,0,4,0,0,0
2021-10-22 02:15,4,1,3,0,0,0
2021-10-22 02:30,5,1,4,0,0,0
2021-10-22 02:45,1,0,1,0,0,0
2021-10-22 03:00,0,0,0,0,0,0
2021-10-22 03:15,2,0,2,0,0,0
2021-10-22 03:30,1,0,1,0,0,0
2021-10-22 03:45,5,0,5,0,0,0
2021-10-22 04:00,1,1,0,0,0,0
2021-10-22 04:15,6,4,2,0,0,0
2021-10-22 04:30,2,1,1,0,0,0
2021-10-22 04:45,4,1,3,0,0,0
2021-10-22 05:00,7,6,1,0,0,0
2021-10-22 05:15,7,5,2,0,0,0
2021-10-22 05:30,17,15,2,0,0,0
2021-10-22 05:45,15,13,2,0,0,0
2021-10-22 06:00,19,12,7,0,0,0
2021-10-22 06:15,22,16,6,0,0,0
2021-10-22 06:30,36,24,12,0,0,0
2021-10-22 06:45,44,31,13,0,0,0
2021-10-22 07:00,46,28,18,0,0,0
2021-10-22 07:15,60,40,20,0,0,0
2021-10-22 07:30,100,68,32,0,0,0
2021-10-22 07:45,113,80,33,0,0,0
2021-10-22 08:00,112,73,39,0,0,0
2021-10-22 08:15,101,66,35,0,0,0
2021-10-22 08:30,98,64,34,0,0,0
2021-10-22 08:45,96,58,38,0,0,0
2021-10-22 09:00,61,42,19,0,0,0
2021-10-22 09:15,71,50,21,0,0,0
2021-10-22 09:30,95,64,31,0,0,0
2021-10-22 09:45,113,69,44,0,0,0
2021-10-22 10:00,97,57,40,0,0,0
2021-10-22 10:15,76,53,23,0,0,0
2021-10-22 10:30,110,64,46,0,0,0
2021-10-22 10:45,93,47,46,0,0,0
2021-10-22 11:00,94,50,44,0,0,0
2021-10-22 11:15,87,45,42,0,0,0
2021-10-22 11:30,112,59,53,0,0,0
2021-10-22 11:45,162,85,77,0,0,0
2021-10-22 12:00,120,56,64,0,0,0
2021-10-22 12:15,138,59,79,0,0,0
2021-10-22 12:30,120,44,76,0,0,0
2021-10-22 12:45,143,55,88,0,0,0
2021-10-22 13:00,125,45,80,0,0,0
2021-10-22 13:15,128,50,78,0,0,0
2021-10-22 13:30,123,47,76,0,0,0
2021-10-22 13:45,119,47,72,0,0,0
2021-10-22 14:00,157,63,94,0,0,0
2021-10-22 14:15,158,62,96,0,0,0
2021-10-22 14:30,143,58,85,0,0,0
2021-10-22 14:45,165,62,103,0,0,0
2021-10-22 15:00,129,47,82,0,0,0
2021-10-22 15:15,98,26,72,0,0,0
2021-10-22 15:30,99,27,72,0,0,0
2021-10-22 15:45,127,41,86,0,0,0
2021-10-22 16:00,121,38,83,0,0,0
2021-10-22 16:15,99,42,57,0,0,0
2021-10-22 16:30,127,37,90,0,0,0
2021-10-22 16:45,105,31,74,0,0,0
2021-10-22 17:00,83,31,52,0,0,0
2021-10-22 17:15,98,37,61,0,0,0
2021-10-22 17:30,103,35,68,0,0,0
2021-10-22 17:45,117,39,78,0,0,0
2021-10-22 18:00,106,40,66,0,0,0
2021-10-22 18:15,124,43,81,0,0,0
2021-10-22 18:30,88,39,49,0,0,0
2021-10-22 18:45,110,47,63,0,0,0
2021-10-22 19:00,101,45,56,0,0,0
2021-10-22 19:15,83,45,38,0,0,0
2021-10-22 19:30,81,38,43,0,0,0
2021-10-22 19:45,80,30,50,0,0,0
2021-10-22 20:00,83,24,59,0,0,0
2021-10-22 20:15,84,38,46,0,0,0
2021-10-22 20:30,54,31,23,0,0,0
2021-10-22 20:45,48,21,27,0,0,0
2021-10-22 21:00,38,14,24,0,0,0
2021-10-22 21:15,31,13,18,0,0,0
2021-10-22 21:30,41,20,21,0,0,0
2021-10-22 21:45,48,16,32,0,0,0
2021-10-22 22:00,31,12,19,0,0,0
2021-10-22 22:15,50,17,33,0,0,0
2021-10-22 22:30,33,12,21,0,0,0
2021-10-22 22:45,45,11,34,0,0,0
2021-10-22 23:00,30,11,19,0,0,0
2021-10-22 23:15,24,10,14,0,0,0
2021-10-22 23:30,29,10,19,0,0,0
2021-10-22 23:45,30,9,21,0,0,0
2021-10-23 00:00,31,8,23,0,0,0
2021-10-23 00:15,14,3,11,0,0,0
2021-10-23 00:30,21,8,13,0,0,0
2021-10-23 00:45,34,13,21,0,0,0
2021-10-23 01:00,27,5,22,0,0,0
2021-10-23 01:15,14,8,6,0,0,0
2021-10-23 01:30,13,5,8,0,0,0
2021-10-23 01:45,27,8,19,0,0,0
2021-10-23 02:00,16,9,7,0,0,0
2021-10-23 02:15,22,7,15,0,0,0
2021-10-23 02:30,22,6,16,0,0,0
2021-10-23 02:45,17,2,15,0,0,0
2021-10-23 03:00,10,4,6,0,0,0
2021-10-23 03:15,19,2,17,0,0,0
2021-10-23 03:30,18,5,13,0,0,0
2021-10-23 03:45,5,0,5,0,0,0
2021-10-23 04:00,10,3,7,0,0,0
2021-10-23 04:15,10,4,6,0,0,0
2021-10-23 04:30,3,0,3,0,0,0
2021-10-23 04:45,5,3,2,0,0,0
2021-10-23 05:00,6,6,0,0,0,0
2021-10-23 05:15,5,2,3,0,0,0
2021-10-23 05:30,8,6,2,0,0,0
2021-10-23 05:45,9,5,4,0,0,0
2021-10-23 06:00,5,4,1,0,0,0
2021-10-23 06:15,5,2,3,0,0,0
2021-10-23 06:30,9,4,5,0,0,0
2021-10-23 06:45,7,5,2,0,0,0
2021-10-23 07:00,3,2,1,0,0,0
2021-10-23 07:15,16,12,4,0,0,0
2021-10-23 07:30,17,13,4,0,0,0
2021-10-23 07:45,29,19,10,0,0,0
2021-10-23 08:00,21,13,8,0,0,0
2021-10-23 08:15,23,17,6,0,0,0
2021-10-23 08:30,17,12,5,0,0,0
2021-10-23 08:45,47,33,14,0,0,0
2021-10-23 09:00,50,31,19,0,0,0
2021-10-23 09:15,59,39,20,0,0,0
2021-10-23 09:30,82,55,27,0,0,0
2021-10-23 09:45,104,63,41,0,0,0
2021-10-23 10:00,84,52,32,0,0,0
2021-10-23 10:15,98,63,35,0,0,0
2021-10-23 10:30,121,75,46,0,0,0
2021-10-23 10:45,119,77,42,0,0,0
2021-10-23 11:00,139,79,60,0,0,0
2021-10-23 11:15,118,75,43,0,0,0
2021-10-23 11:30,138,79,59,0,0,0
2021-10-23 11:45,163,109,54,0,0,0
2021-10-23 12:00,141,76,65,0,0,0
2021-10-23 12:15,163,79,84,0,0,0
2021-10-23 12:30,133,62,71,0,0,0
2021-10-23 12:45,163,88,75,0,0,0
2021-10-23 13:00,167,89,78,0,0,0
2021-10-23 13:15,163,96,67,0,0,0
2021-10-23 13:30,171,88,83,0,0,0
2021-10-23 13:45,197,76,121,0,0,0
2021-10-23 14:00,164,79,85,0,0,0
2021-10-23 14:15,155,71,84,0,0,0
2021-10-23 14:30,172,73,99,0,0,0
2021-10-23 14:45,158,59,99,0,0,0
2021-10-23 15:00,158,68,90,0,0,0
2021-10-23 15:15,164,83,81,0,0,0
2021-10-23 15:30,144,72,72,0,0,0
2021-10-23 15:45,147,67,80,0,0,0
2021-10-23 16:00,118,49,69,0,0,0
2021-10-23 16:15,145,62,83,0,0,0
2021-10-23 16:30,133,61,72,0,0,0
2021-10-23 16:45,122,41,81,0,0,0
2021-10-23 17:00,125,50,75,0,0,0
2021-10-23 17:15,83,37,46,0,0,0
2021-10-23 17:30,118,41,77,0,0,0
2021-10-23 17:45,139,64,75,0,0,0
2021-10-23 18:00,120,38,82,0,0,0
2021-10-23 18:15,134,46,88,0,0,0
2021-10-23 18:30,136,51,85,0,0,0
2021-10-23 18:45,121,60,61,0,0,0
2021-10-23 19:00,116,44,72,0,0,0
2021-10-23 19:15,98,42,56,0,0,0
2021-10-23 19:30,95,37,58,0,0,0
2021-10-23 19:45,83,38,45,0,0,0
2021-10-23 20:00,98,43,55,0,0,0
2021-10-23 20:15,63,20,43,0,0,0
2021-10-23 20:30,54,20,34,0,0,0
2021-10-23 20:45,35,14,21,0,0,0
2021-10-23 21:00,76,27,49,0,0,0
2021-10-23 21:15,32,19,13,0,0,0
2021-10-23 21:30,51,16,35,0,0,0
2021-10-23 21:45,56,29,27,0,0,0
2021-10-23 22:00,48,16,32,0,0,0
2021-10-23 22:15,40,13,27,0,0,0
2021-10-23 22:30,36,13,23,0,0,0
2021-10-23 22:45,52,15,37,0,0,0
2021-10-23 23:00,50,30,20,0,0,0
2021-10-23 23:15,64,21,43,0,0,0
2021-10-23 23:30,35,12,23,0,0,0
2021-10-23 23:45,41,15,26,0,0,0
2021-10-24 00:00,16,9,7,0,0,0
2021-10-24 00:15,40,16,24,0,0,0
2021-10-24 00:30,25,8,17,0,0,0
2021-10-24 00:45,37,12,25,0,0,0
2021-10-24 01:00,34,11,23,0,0,0
2021-10-24 01:15,42,6,36,0,0,0
2021-10-24 01:30,25,10,15,0,0,0
2021-10-24 01:45,24,18,6,0,0,0
2021-10-24 02:00,25,10,15,0,0,0
2021-10-24 02:15,14,6,8,0,0,0
2021-10-24 02:30,24,5,19,0,0,0
2021-10-24 02:45,8,1,7,0,0,0
2021-10-24 03:00,15,5,10,0,0,0
2021-10-24 03:15,15,1,14,0,0,0
2021-10-24 03:30,16,2,14,0,0,0
2021-10-24 03:45,11,3,8,0,0,0
2021-10-24 04:00,11,2,9,0,0,0
2021-10-24 04:15,5,2,3,0,0,0
2021-10-24 04:30,8,1,7,0,0,0
2021-10-24 04:45,1,1,0,0,0,0
2021-10-24 05:00,8,2,6,0,0,0
2021-10-24 05:15,7,3,4,0,0,0
2021-10-24 05:30,10,3,7,0,0,0
2021-10-24 05:45,7,5,2,0,0,0
2021-10-24 06:00,0,0,0,0,0,0
2021-10-24 06:15,1,0,1,0,0,0
2021-10-24 06:30,5,0,5,0,0,0
2021-10-24 06:45,4,3,1,0,0,0
2021-10-24 07:00,6,1,5,0,0,0
2021-10-24 07:15,7,5,2,0,0,0
2021-10-24 07:30,4,2,2,0,0,0
2021-10-24 07:45,8,4,4,0,0,0
2021-10-24 08:00,10,7,3,0,0,0
2021-10-24 08:15,4,2,2,0,0,0
2021-10-24 08:30,13,7,6,0,0,0
2021-10-24 08:45,15,11,4,0,0,0
2021-10-24 09:00,10,7,3,0,0,0
2021-10-24 09:15,28,16,12,0,0,0
2021-10-24 09:30,17,8,9,0,0,0
2021-10-24 09:45,42,27,15,0,0,0
2021-10-24 10:00,45,22,23,0,0,0
2021-10-24 10:15,31,14,17,0,0,0
2021-10-24 10:30,39,13,26,0,0,0
2021-10-24 10:45,40,24,16,0,0,0
2021-10-24 11:00,34,18,16,0,0,0
2021-10-24 11:15,37,19,18,0,0,0
2021-10-24 11:30,55,32,23,0,0,0
2021-10-24 11:45,46,20,26,0,0,0
2021-10-24 12:00,53,30,23,0,0,0
2021-10-24 12:15,41,20,21,0,0,0
2021-10-24 12:30,55,32,23,0,0,0
2021-10-24 12:45,63,47,16,0,0,0
2021-10-24 13:00,77,23,54,0,0,0
2021-10-24 13:15,79,41,38,0,0,0
2021-10-24 13:30,69,33,36,0,0,0
2021-10-24 13:45,71,48,23,0,0,0
2021-10-24 14:00,92,42,50,0,0,0
2021-10-24 14:15,96,34,62,0,0,0
2021-10-24 14:30,121,52,69,0,0,0
2021-10-24 14:45,134,57,77,0,0,0
2021-10-24 15:00,125,48,77,0,0,0
2021-10-24 15:15,151,45,106,0,0,0
2021-10-24 15:30,108,45,63,0,0,0
2021-10-24 15:45,130,61,69,0,0,0
2021-10-24 16:00,102,41,61,0,0,0
2021-10-24 16:15,76,29,47,0,0,0
2021-10-24 16:30,105,48,57,0,0,0
2021-10-24 16:45,114,52,62,0,0,0
2021-10-24 17:00,66,20,46,0,0,0
2021-10-24 17:15,91,37,54,0,0,0
2021-10-24 17:30,73,29,44,0,0,0
2021-10-24 17:45,102,52,50,0,0,0
2021-10-24 18:00,127,65,62,0,0,0
2021-10-24 18:15,191,119,72,0,0,0
2021-10-24 18:30,78,40,38,0,0,0
2021-10-24 18:45,96,38,58,0,0,0
2021-10-24 19:00,65,27,38,0,0,0
2021-10-24 19:15,59,26,33,0,0,0
2021-10-24 19:30,46,24,22,0,0,0
2021-10-24 19:45,54,19,35,0,0,0
2021-10-24 20:00,51,15,36,0,0,0
2021-10-24 20:15,42,8,34,0,0,0
2021-10-24 20:30,39,9,30,0,0,0
2021-10-24 20:45,26,12,14,0,0,0
2021-10-24 21:00,29,11,18,0,0,0
2021-10-24 21:15,29,6,23,0,0,0
2021-10-24 21:30,26,4,22,0,0,0
2021-10-24 21:45,27,7,20,0,0,0
2021-10-24 22:00,24,9,15,0,0,0
2021-10-24 22:15,25,10,15,0,0,0
2021-10-24 22:30,26,8,18,0,0,0
2021-10-24 22:45,16,3,13,0,0,0
2021-10-24 23:00,9,5,4,0,0,0
2021-10-24 23:15,12,4,8,0,0,0
2021-10-24 23:30,11,1,10,0,0,0
2021-10-24 23:45,9,1,8,0,0,0
2021-10-25 00:00,6,2,4,0,0,0
2021-10-25 00:15,5,2,3,0,0,0
2021-10-25 00:30,5,1,4,0,0,0
2021-10-25 00:45,1,0,1,0,0,0
2021-10-25 01:00,3,1,2,0,0,0
2021-10-25 01:15,3,1,2,0,0,0
2021-10-25 01:30,2,2,0,0,0,0
2021-10-25 01:45,1,1,0,0,0,0
2021-10-25 02:00,0,0,0,0,0,0
2021-10-25 02:15,2,0,2,0,0,0
2021-10-25 02:30,0,0,0,0,0,0
2021-10-25 02:45,0,0,0,0,0,0
2021-10-25 03:00,1,0,1,0,0,0
2021-10-25 03:15,1,0,1,0,0,0
2021-10-25 03:30,0,0,0,0,0,0
2021-10-25 03:45,4,1,3,0,0,0
2021-10-25 04:00,0,0,0,0,0,0
2021-10-25 04:15,0,0,0,0,0,0
2021-10-25 04:30,1,1,0,0,0,0
2021-10-25 04:45,6,3,3,0,0,0
2021-10-25 05:00,4,3,1,0,0,0
2021-10-25 05:15,9,7,2,0,0,0
2021-10-25 05:30,19,14,5,0,0,0
2021-10-25 05:45,25,20,5,0,0,0
2021-10-25 06:00,20,11,9,0,0,0
2021-10-25 06:15,27,20,7,0,0,0
2021-10-25 06:30,43,24,19,0,0,0
2021-10-25 06:45,52,41,11,0,0,0
2021-10-25 07:00,75,43,32,0,0,0
2021-10-25 07:15,90,64,26,0,0,0
2021-10-25 07:30,156,102,54,0,0,0
2021-10-25 07:45,172,119,53,0,0,0
2021-10-25 08:00,144,97,47,0,0,0
2021-10-25 08:15,133,81,52,0,0,0
2021-10-25 08:30,110,76,34,0,0,0
2021-10-25 08:45,110,80,30,0,0,0
2021-10-25 09:00,92,53,39,0,0,0
2021-10-25 09:15,94,73,21,0,0,0
2021-10-25 09:30,102,65,37,0,0,0
2021-10-25 09:45,118,82,36,0,0,0
2021-10-25 10:00,95,65,30,0,0,0
2021-10-25 10:15,104,60,44,0,0,0
2021-10-25 10:30,83,48,35,0,0,0
2021-10-25 10:45,126,48,78,0,0,0
2021-10-25 11:00,97,53,44,0,0,0
2021-10-25 11:15,142,62,80,0,0,0
2021-10-25 11:30,128,59,69,0,0,0
2021-10-25 11:45,137,77,60,0,0,0
2021-10-25 12:00,140,53,87,0,0,0
2021-10-25 12:15,134,52,82,0,0,0
2021-10-25 12:30,112,40,72,0,0,0
2021-10-25 12:45,125,53,72,0,0,0
2021-10-25 13:00,136,50,86,0,0,0
2021-10-25 13:15,140,57,83,0,0,0
2021-10-25 13:30,137,55,82,0,0,0
2021-10-25 13:45,169,85,84,0,0,0
2021-10-25 14:00,160,73,87,0,0,0
2021-10-25 14:15,156,53,103,0,0,0
2021-10-25 14:30,146,64,82,0,0,0
2021-10-25 14:45,157,64,93,0,0,0
2021-10-25 15:00,151,57,94,0,0,0
2021-10-25 15:15,166,71,95,0,0,0
2021-10-25 15:30,175,84,91,0,0,0
2021-10-25 15:45,207,90,117,0,0,0
2021-10-25 16:00,232,90,142,0,0,0
2021-10-25 16:15,189,77,112,0,0,0
2021-10-25 16:30,191,83,108,0,0,0
2021-10-25 16:45,208,90,118,0,0,0
2021-10-25 17:00,198,64,134,0,0,0
2021-10-25 17:15,202,71,131,0,0,0
2021-10-25 17:30,214,78,136,0,0,0
2021-10-25 17:45,217,74,143,0,0,0
2021-10-25 18:00,197,56,141,0,0,0
2021-10-25 18:15,205,68,137,0,0,0
2021-10-25 18:30,156,62,94,0,0,0
2021-10-25 18:45,164,63,101,0,0,0
2021-10-25 19:00,136,51,85,0,0,0
2021-10-25 19:15,119,50,69,0,0,0
2021-10-25 19:30,96,38,58,0,0,0
2021-10-25 19:45,119,40,79,0,0,0
2021-10-25 20:00,96,48,48,0,0,0
2021-10-25 20:15,66,24,42,0,0,0
2021-10-25 20:30,52,16,36,0,0,0
2021-10-25 20:45,55,13,42,0,0,0
2021-10-25 21:00,45,13,32,0,0,0
2021-10-25 21:15,63,17,46,0,0,0
2021-10-25 21:30,43,17,26,0,0,0
2021-10-25 21:45,41,11,30,0,0,0
2021-10-25 22:00,55,12,43,0,0,0
2021-10-25 22:15,47,16,31,0,0,0
2021-10-25 22:30,64,15,49,0,0,0
2021-10-25 22:45,34,4,30,0,0,0
2021-10-25 23:00,33,6,27,0,0,0
2021-10-25 23:15,15,0,15,0,0,0
2021-10-25 23:30,19,4,15,0,0,0
2021-10-25 23:45,4,2,2,0,0,0
2021-10-26 00:00,7,0,7,0,0,0
2021-10-26 00:15,12,3,9,0,0,0
2021-10-26 00:30,6,0,6,0,0,0
2021-10-26 00:45,8,3,5,0,0,0
2021-10-26 01:00,4,3,1,0,0,0
2021-10-26 01:15,3,1,2,0,0,0
2021-10-26 01:30,2,0,2,0,0,0
2021-10-26 01:45,1,0,1,0,0,0
2021-10-26 02:00,0,0,0,0,0,0
2021-10-26 02:15,4,0,4,0,0,0
2021-10-26 02:30,1,0,1,0,0,0
2021-10-26 02:45,2,0,2,0,0,0
2021-10-26 03:00,0,0,0,0,0,0
2021-10-26 03:15,0,0,0,0,0,0
2021-10-26 03:30,2,0,2,0,0,0
2021-10-26 03:45,1,0,1,0,0,0
2021-10-26 04:00,1,1,0,0,0,0
2021-10-26 04:15,2,1,1,0,0,0
2021-10-26 04:30,3,1,2,0,0,0
2021-10-26 04:45,2,2,0,0,0,0
2021-10-26 05:00,6,6,0,0,0,0
2021-10-26 05:15,8,3,5,0,0,0
2021-10-26 05:30,22,18,4,0,0,0
2021-10-26 05:45,19,17,2,0,0,0
2021-10-26 06:00,20,13,7,0,0,0
2021-10-26 06:15,39,30,9,0,0,0
2021-10-26 06:30,42,27,15,0,0,0
2021-10-26 06:45,44,29,15,0,0,0
2021-10-26 07:00,106,66,40,0,0,0
2021-10-26 07:15,110,72,38,0,0,0
2021-10-26 07:30,176,117,59,0,0,0
2021-10-26 07:45,232,162,70,0,0,0
2021-10-26 08:00,207,125,82,0,0,0
2021-10-26 08:15,152,104,48,0,0,0
2021-10-26 08:30,138,91,47,0,0,0
2021-10-26 08:45,137,92,45,0,0,0
2021-10-26 09:00,82,55,27,0,0,0
2021-10-26 09:15,81,52,29,0,0,0
2021-10-26 09:30,106,69,37,0,0,0
2021-10-26 09:45,134,94,40,0,0,0
2021-10-26 10:00,106,71,35,0,0,0
2021-10-26 10:15,98,60,38,0,0,0
2021-10-26 10:30,112,60,52,0,0,0
2021-10-26 10:45,106,67,39,0,0,0
2021-10-26 11:00,115,61,54,0,0,0
2021-10-26 11:15,109,33,76,0,0,0
2021-10-26 11:30,119,57,62,0,0,0
2021-10-26 11:45,158,82,76,0,0,0
2021-10-26 12:00,134,60,74,0,0,0
2021-10-26 12:15,126,52,74,0,0,0
2021-10-26 12:30,135,53,82,0,0,0
2021-10-26 12:45,148,66,82,0,0,0
2021-10-26 13:00,141,50,91,0,0,0
2021-10-26 13:15,131,50,81,0,0,0
2021-10-26 13:30,139,55,84,0,0,0
2021-10-26 13:45,176,79,97,0,0,0
2021-10-26 14:00,148,63,85,0,0,0
2021-10-26 14:15,157,58,99,0,0,0
2021-10-26 14:30,123,61,62,0,0,0
2021-10-26 14:45,174,88,86,0,0,0
2021-10-26 15:00,147,64,83,0,0,0
2021-10-26 15:15,169,75,94,0,0,0
2021-10-26 15:30,164,75,89,0,0,0
2021-10-26 15:45,214,99,115,0,0,0
2021-10-26 16:00,237,76,161,0,0,0
2021-10-26 16:15,247,84,163,0,0,0
2021-10-26 16:30,242,73,169,0,0,0
2021-10-26 16:45,270,68,202,0,0,0
2021-10-26 17:00,298,77,221,0,0,0
2021-10-26 17:15,307,79,228,0,0,0
2021-10-26 17:30,289,80,209,0,0,0
2021-10-26 17:45,282,82,200,0,0,0
2021-10-26 18:00,223,58,165,0,0,0
2021-10-26 18:15,175,54,121,0,0,0
2021-10-26 18:30,135,50,85,0,0,0
2021-10-26 18:45,129,53,76,0,0,0
2021-10-26 19:00,137,48,89,0,0,0
2021-10-26 19:15,112,42,70,0,0,0
2021-10-26 19:30,89,28,61,0,0,0
2021-10-26 19:45,96,35,61,0,0,0
2021-10-26 20:00,88,29,59,0,0,0
2021-10-26 20:15,93,45,48,0,0,0
2021-10-26 20:30,134,91,43,0,0,0
2021-10-26 20:45,203,170,33,0,0,0
2021-10-26 21:00,160,130,30,0,0,0
2021-10-26 21:15,100,69,31,0,0,0
2021-10-26 21:30,98,49,49,0,0,0
2021-10-26 21:45,84,46,38,0,0,0
2021-10-26 22:00,76,39,37,0,0,0
2021-10-26 22:15,53,30,23,0,0,0
2021-10-26 22:30,77,24,53,0,0,0
2021-10-26 22:45,48,27,21,0,0,0
2021-10-26 23:00,46,23,23,0,0,0
2021-10-26 23:15,38,13,25,0,0,0
2021-10-26 23:30,22,8,14,0,0,0
2021-10-26 23:45,17,6,11,0,0,0
2021-10-27 00:00,20,7,13,0,0,0
2021-10-27 00:15,18,8,10,0,0,0
2021-10-27 00:30,9,4,5,0,0,0
2021-10-27 00:45,9,3,6,0,0,0
2021-10-27 01:00,7,1,6,0,0,0
2021-10-27 01:15,2,0,2,0,0,0
2021-10-27 01:30,6,4,2,0,0,0
2021-10-27 01:45,7,1,6,0,0,0
2021-10-27 02:00,3,1,2,0,0,0
2021-10-27 02:15,0,0,0,0,0,0
2021-10-27 02:30,0,0,0,0,0,0
2021-10-27 02:45,2,2,0,0,0,0
2021-10-27 03:00,2,0,2,0,0,0
2021-10-27 03:15,1,0,1,0,0,0
2021-10-27 03:30,0,0,0,0,0,0
2021-10-27 03:45,1,1,0,0,0,0
2021-10-27 04:00,0,0,0,0,0,0
2021-10-27 04:15,5,1,4,0,0,0
2021-10-27 04:30,3,2,1,0,0,0
2021-10-27 04:45,2,2,0,0,0,0
2021-10-27 05:00,11,8,3,0,0,0
2021-10-27 05:15,8,6,2,0,0,0
2021-10-27 05:30,19,13,6,0,0,0
2021-10-27 05:45,29,23,6,0,0,0
2021-10-27 06:00,18,12,6,0,0,0
2021-10-27 06:15,43,33,10,0,0,0
2021-10-27 06:30,48,38,10,0,0,0
2021-10-27 06:45,62,38,24,0,0,0
2021-10-27 07:00,79,47,32,0,0,0
2021-10-27 07:15,109,71,38,0,0,0
2021-10-27 07:30,179,112,67,0,0,0
2021-10-27 07:45,205,139,66,0,0,0
2021-10-27 08:00,189,125,64,0,0,0
2021-10-27 08:15,173,109,64,0,0,0
2021-10-27 08:30,109,78,31,0,0,0
2021-10-27 08:45,141,87,54,0,0,0
2021-10-27 09:00,110,66,44,0,0,0
2021-10-27 09:15,94,66,28,0,0,0
2021-10-27 09:30,108,63,45,0,0,0
2021-10-27 09:45,145,91,54,0,0,0
2021-10-27 10:00,107,57,50,0,0,0
2021-10-27 10:15,106,58,48,0,0,0
2021-10-27 10:30,98,55,43,0,0,0
2021-10-27 10:45,119,55,64,0,0,0
2021-10-27 11:00,118,71,47,0,0,0
2021-10-27 11:15,132,60,72,0,0,0
2021-10-27 11:30,141,56,85,0,0,0
2021-10-27 11:45,195,88,107,0,0,0
2021-10-27 12:00,131,60,71,0,0,0
2021-10-27 12:15,168,68,100,0,0,0
2021-10-27 12:30,137,67,70,0,0,0
2021-10-27 12:45,166,72,94,0,0,0
2021-10-27 13:00,157,61,96,0,0,0
2021-10-27 13:15,158,64,94,0,0,0
2021-10-27 13:30,141,64,77,0,0,0
2021-10-27 13:45,198,103,95,0,0,0
2021-10-27 14:00,179,72,107,0,0,0
2021-10-27 14:15,153,57,96,0,0,0
2021-10-27 14:30,162,64,98,0,0,0
2021-10-27 14:45,186,83,103,0,0,0
2021-10-27 15:00,167,68,99,0,0,0
2021-10-27 15:15,178,82,96,0,0,0
2021-10-27 15:30,188,76,112,0,0,0
2021-10-27 15:45,201,85,116,0,0,0
2021-10-27 16:00,198,84,114,0,0,0
2021-10-27 16:15,195,93,102,0,0,0
2021-10-27 16:30,178,65,113,0,0,0
2021-10-27 16:45,198,77,121,0,0,0
2021-10-27 17:00,184,74,110,0,0,0
2021-10-27 17:15,142,66,76,0,0,0
2021-10-27 17:30,176,65,111,0,0,0
2021-10-27 17:45,212,79,133,0,0,0
2021-10-27 18:00,198,68,130,0,0,0
2021-10-27 18:15,196,69,127,0,0,0
2021-10-27 18:30,136,55,81,0,0,0
2021-10-27 18:45,149,81,68,0,0,0
2021-10-27 19:00,141,50,91,0,0,0
2021-10-27 19:15,110,49,61,0,0,0
2021-10-27 19:30,98,29,69,0,0,0
2021-10-27 19:45,111,42,69,0,0,0
2021-10-27 20:00,86,40,46,0,0,0
2021-10-27 20:15,90,43,47,0,0,0
2021-10-27 20:30,55,19,36,0,0,0
2021-10-27 20:45,46,20,26,0,0,0
2021-10-27 21:00,54,12,42,0,0,0
2021-10-27 21:15,44,20,24,0,0,0
2021-10-27 21:30,72,17,55,0,0,0
2021-10-27 21:45,81,25,56,0,0,0
2021-10-27 22:00,64,15,49,0,0,0
2021-10-27 22:15,46,10,36,0,0,0
2021-10-27 22:30,60,15,45,0,0,0
2021-10-27 22:45,33,6,27,0,0,0
2021-10-27 23:00,33,9,24,0,0,0
2021-10-27 23:15,24,8,16,0,0,0
2021-10-27 23:30,19,5,14,0,0,0
2021-10-27 23:45,21,3,18,0,0,0
2021-10-28 00:00,15,10,5,0,0,0
2021-10-28 00:15,18,7,11,0,0,0
2021-10-28 00:30,16,5,11,0,0,0
2021-10-28 00:45,7,1,6,0,0,0
2021-10-28 01:00,12,6,6,0,0,0
2021-10-28 01:15,15,1,14,0,0,0
2021-10-28 01:30,11,1,10,0,0,0
2021-10-28 01:45,7,4,3,0,0,0
2021-10-28 02:00,4,0,4,0,0,0
2021-10-28 02:15,6,2,4,0,0,0
2021-10-28 02:30,2,1,1,0,0,0
2021-10-28 02:45,4,3,1,0,0,0
2021-10-28 03:00,1,0,1,0,0,0
2021-10-28 03:15,2,1,1,0,0,0
2021-10-28 03:30,3,0,3,0,0,0
2021-10-28 03:45,6,2,4,0,0,0
2021-10-28 04:00,3,2,1,0,0,0
2021-10-28 04:15,2,1,1,0,0,0
2021-10-28 04:30,1,1,0,0,0,0
2021-10-28 04:45,2,1,1,0,0,0
2021-10-28 05:00,6,4,2,0,0,0
2021-10-28 05:15,17,10,7,0,0,0
2021-10-28 05:30,19,14,5,0,0,0
2021-10-28 05:45,22,14,8,0,0,0
2021-10-28 06:00,21,13,8,0,0,0
2021-10-28 06:15,35,21,14,0,0,0
2021-10-28 06:30,41,28,13,0,0,0
2021-10-28 06:45,58,40,18,0,0,0
2021-10-28 07:00,68,45,23,0,0,0
2021-10-28 07:15,110,74,36,0,0,0
2021-10-28 07:30,148,95,53,0,0,0
2021-10-28 07:45,218,152,66,0,0,0
2021-10-28 08:00,181,128,53,0,0,0
2021-10-28 08:15,163,102,61,0,0,0
2021-10-28 08:30,130,95,35,0,0,0
2021-10-28 08:45,136,83,53,0,0,0
2021-10-28 09:00,89,52,37,0,0,0
2021-10-28 09:15,100,56,44,0,0,0
2021-10-28 09:30,122,82,40,0,0,0
2021-10-28 09:45,166,107,59,0,0,0
2021-10-28 10:00,124,82,42,0,0,0
2021-10-28 10:15,105,64,41,0,0,0
2021-10-28 10:30,108,58,50,0,0,0
2021-10-28 10:45,129,66,63,0,0,0
2021-10-28 11:00,117,60,57,0,0,0
2021-10-28 11:15,120,61,59,0,0,0
2021-10-28 11:30,112,52,60,0,0,0
2021-10-28 11:45,143,70,73,0,0,0
2021-10-28 12:00,154,71,83,0,0,0
2021-10-28 12:15,142,53,89,0,0,0
2021-10-28 12:30,123,45,78,0,0,0
2021-10-28 12:45,164,60,104,0,0,0
2021-10-28 13:00,179,65,114,0,0,0
2021-10-28 13:15,155,72,83,0,0,0
2021-10-28 13:30,140,73,67,0,0,0
2021-10-28 13:45,173,87,86,0,0,0
2021-10-28 14:00,173,83,90,0,0,0
2021-10-28 14:15,179,89,90,0,0,0
2021-10-28 14:30,140,59,81,0,0,0
2021-10-28 14:45,195,99,96,0,0,0
2021-10-28 15:00,183,87,96,0,0,0
2021-10-28 15:15,175,72,103,0,0,0
2021-10-28 15:30,198,88,110,0,0,0
2021-10-28 15:45,204,87,117,0,0,0
2021-10-28 16:00,216,93,123,0,0,0
2021-10-28 16:15,176,73,103,0,0,0
2021-10-28 16:30,188,84,104,0,0,0
2021-10-28 16:45,204,88,116,0,0,0
2021-10-28 17:00,221,93,128,0,0,0
2021-10-28 17:15,228,108,120,0,0,0
2021-10-28 17:30,239,94,145,0,0,0
2021-10-28 17:45,243,101,142,0,0,0
2021-10-28 18:00,221,72,149,0,0,0
2021-10-28 18:15,178,68,110,0,0,0
2021-10-28 18:30,174,72,102,0,0,0
2021-10-28 18:45,173,68,105,0,0,0
2021-10-28 19:00,142,39,103,0,0,0
2021-10-28 19:15,130,47,83,0,0,0
2021-10-28 19:30,118,36,82,0,0,0
2021-10-28 19:45,109,39,70,0,0,0
2021-10-28 20:00,111,33,78,0,0,0
2021-10-28 20:15,78,31,47,0,0,0
2021-10-28 20:30,56,22,34,0,0,0
2021-10-28 20:45,63,14,49,0,0,0
2021-10-28 21:00,60,25,35,0,0,0
2021-10-28 21:15,64,21,43,0,0,0
2021-10-28 21:30,51,18,33,0,0,0
2021-10-28 21:45,55,17,38,0,0,0
2021-10-28 22:00,69,25,44,0,0,0
2021-10-28 22:15,71,29,42,0,0,0
2021-10-28 22:30,58,15,43,0,0,0
2021-10-28 22:45,53,11,42,0,0,0
2021-10-28 23:00,48,22,26,0,0,0
2021-10-28 23:15,36,5,31,0,0,0
2021-10-28 23:30,28,6,22,0,0,0
2021-10-28 23:45,22,7,15,0,0,0
2021-10-29 00:00,21,5,16,0,0,0
2021-10-29 00:15,16,5,11,0,0,0
2021-10-29 00:30,12,4,8,0,0,0
2021-10-29 00:45,9,1,8,0,0,0
2021-10-29 01:00,12,1,11,0,0,0
2021-10-29 01:15,10,5,5,0,0,0
2021-10-29 01:30,5,0,5,0,0,0
2021-10-29 01:45,7,1,6,0,0,0
2021-10-29 02:00,6,4,2,0,0,0
2021-10-29 02:15,1,0,1,0,0,0
2021-10-29 02:30,1,1,0,0,0,0
2021-10-29 02:45,5,0,5,0,0,0
2021-10-29 03:00,4,0,4,0,0,0
2021-10-29 03:15,1,0,1,0,0,0
2021-10-29 03:30,0,0,0,0,0,0
2021-10-29 03:45,2,0,2,0,0,0
2021-10-29 04:00,0,0,0,0,0,0
2021-10-29 04:15,4,2,2,0,0,0
2021-10-29 04:30,1,0,1,0,0,0
2021-10-29 04:45,0,0,0,0,0,0
2021-10-29 05:00,8,6,2,0,0,0
2021-10-29 05:15,8,5,3,0,0,0
2021-10-29 05:30,23,15,8,0,0,0
2021-10-29 05:45,18,14,4,0,0,0
2021-10-29 06:00,20,16,4,0,0,0
2021-10-29 06:15,30,23,7,0,0,0
2021-10-29 06:30,36,28,8,0,0,0
2021-10-29 06:45,44,30,14,0,0,0
2021-10-29 07:00,62,37,25,0,0,0
2021-10-29 07:15,107,73,34,0,0,0
2021-10-29 07:30,140,94,46,0,0,0
2021-10-29 07:45,155,106,49,0,0,0
2021-10-29 08:00,149,95,54,0,0,0
2021-10-29 08:15,118,76,42,0,0,0
2021-10-29 08:30,103,71,32,0,0,0
2021-10-29 08:45,142,84,58,0,0,0
2021-10-29 09:00,103,59,44,0,0,0
2021-10-29 09:15,106,65,41,0,0,0
2021-10-29 09:30,112,66,46,0,0,0
2021-10-29 09:45,113,76,37,0,0,0
2021-10-29 10:00,107,64,43,0,0,0
2021-10-29 10:15,97,65,32,0,0,0
2021-10-29 10:30,94,53,41,0,0,0
2021-10-29 10:45,127,62,65,0,0,0
2021-10-29 11:00,112,61,51,0,0,0
2021-10-29 11:15,127,59,68,0,0,0
2021-10-29 11:30,126,57,69,0,0,0
2021-10-29 11:45,158,70,88,0,0,0
2021-10-29 12:00,185,76,109,0,0,0
2021-10-29 12:15,169,72,97,0,0,0
2021-10-29 12:30,134,62,72,0,0,0
2021-10-29 12:45,165,70,95,0,0,0
2021-10-29 13:00,189,67,122,0,0,0
2021-10-29 13:15,163,69,94,0,0,0
2021-10-29 13:30,187,78,109,0,0,0
2021-10-29 13:45,213,107,106,0,0,0
2021-10-29 14:00,180,77,103,0,0,0
2021-10-29 14:15,229,110,119,0,0,0
2021-10-29 14:30,195,85,110,0,0,0
2021-10-29 14:45,201,107,94,0,0,0
2021-10-29 15:00,224,94,130,0,0,0
2021-10-29 15:15,210,104,106,0,0,0
2021-10-29 15:30,181,64,117,0,0,0
2021-10-29 15:45,231,96,135,0,0,0
2021-10-29 16:00,216,94,122,0,0,0
2021-10-29 16:15,206,89,117,0,0,0
2021-10-29 16:30,183,75,108,0,0,0
2021-10-29 16:45,181,75,106,0,0,0
2021-10-29 17:00,185,55,130,0,0,0
2021-10-29 17:15,179,55,124,0,0,0
2021-10-29 17:30,207,60,147,0,0,0
2021-10-29 17:45,201,71,130,0,0,0
2021-10-29 18:00,212,60,152,0,0,0
2021-10-29 18:15,196,70,126,0,0,0
2021-10-29 18:30,168,55,113,0,0,0
2021-10-29 18:45,191,81,110,0,0,0
2021-10-29 19:00,114,49,65,0,0,0
2021-10-29 19:15,124,56,68,0,0,0
2021-10-29 19:30,118,47,71,0,0,0
2021-10-29 19:45,107,59,48,0,0,0
2021-10-29 20:00,91,51,40,0,0,0
2021-10-29 20:15,89,39,50,0,0,0
2021-10-29 20:30,65,29,36,0,0,0
2021-10-29 20:45,81,30,51,0,0,0
2021-10-29 21:00,107,79,28,0,0,0
2021-10-29 21:15,162,118,44,0,0,0
2021-10-29 21:30,104,50,54,0,0,0
2021-10-29 21:45,53,23,30,0,0,0
2021-10-29 22:00,78,52,26,0,0,0
2021-10-29 22:15,63,25,38,0,0,0
2021-10-29 22:30,56,28,28,0,0,0
2021-10-29 22:45,63,18,45,0,0,0
2021-10-29 23:00,62,23,39,0,0,0
2021-10-29 23:15,45,28,17,0,0,0
2021-10-29 23:30,54,21,33,0,0,0
2021-10-29 23:45,48,20,28,0,0,0
2021-10-30 00:00,35,18,17,0,0,0
2021-10-30 00:15,39,9,30,0,0,0
2021-10-30 00:30,41,17,24,0,0,0
2021-10-30 00:45,37,17,20,0,0,0
2021-10-30 01:00,44,18,26,0,0,0
2021-10-30 01:15,22,4,18,0,0,0
2021-10-30 01:30,12,5,7,0,0,0
2021-10-30 01:45,15,6,9,0,0,0
2021-10-30 02:00,16,3,13,0,0,0
2021-10-30 02:15,21,8,13,0,0,0
2021-10-30 02:30,30,11,19,0,0,0
2021-10-30 02:45,13,5,8,0,0,0
2021-10-30 03:00,18,5,13,0,0,0
2021-10-30 03:15,19,4,15,0,0,0
2021-10-30 03:30,17,5,12,0,0,0
2021-10-30 03:45,21,8,13,0,0,0
2021-10-30 04:00,14,5,9,0,0,0
2021-10-30 04:15,7,2,5,0,0,0
2021-10-30 04:30,8,0,8,0,0,0
2021-10-30 04:45,5,1,4,0,0,0
2021-10-30 05:00,5,1,4,0,0,0
2021-10-30 05:15,11,7,4,0,0,0
2021-10-30 05:30,6,3,3,0,0,0
2021-10-30 05:45,10,5,5,0,0,0
2021-10-30 06:00,9,5,4,0,0,0
2021-10-30 06:15,8,4,4,0,0,0
2021-10-30 06:30,10,8,2,0,0,0
2021-10-30 06:45,10,5,5,0,0,0
2021-10-30 07:00,13,6,7,0,0,0
2021-10-30 07:15,18,14,4,0,0,0
2021-10-30 07:30,18,15,3,0,0,0
2021-10-30 07:45,16,8,8,0,0,0
2021-10-30 08:00,16,9,7,0,0,0
2021-10-30 08:15,31,13,18,0,0,0
2021-10-30 08:30,31,19,12,0,0,0
2021-10-30 08:45,44,32,12,0,0,0
2021-10-30 09:00,33,20,13,0,0,0
2021-10-30 09:15,34,28,6,0,0,0
2021-10-30 09:30,60,34,26,0,0,0
2021-10-30 09:45,66,48,18,0,0,0
2021-10-30 10:00,67,38,29,0,0,0
2021-10-30 10:15,59,39,20,0,0,0
2021-10-30 10:30,58,37,21,0,0,0
2021-10-30 10:45,90,49,41,0,0,0
2021-10-30 11:00,82,52,30,0,0,0
2021-10-30 11:15,107,59,48,0,0,0
2021-10-30 11:30,97,57,40,0,0,0
2021-10-30 11:45,115,71,44,0,0,0
2021-10-30 12:00,93,44,49,0,0,0
2021-10-30 12:15,130,76,54,0,0,0
2021-10-30 12:30,122,68,54,0,0,0
2021-10-30 12:45,129,75,54,0,0,0
2021-10-30 13:00,113,53,60,0,0,0
2021-10-30 13:15,139,59,80,0,0,0
2021-10-30 13:30,103,60,43,0,0,0
2021-10-30 13:45,116,56,60,0,0,0
2021-10-30 14:00,126,68,58,0,0,0
2021-10-30 14:15,131,53,78,0,0,0
2021-10-30 14:30,109,51,58,0,0,0
2021-10-30 14:45,144,47,97,0,0,0
2021-10-30 15:00,86,41,45,0,0,0
2021-10-30 15:15,93,40,53,0,0,0
2021-10-30 15:30,101,28,73,0,0,0
2021-10-30 15:45,101,48,53,0,0,0
2021-10-30 16:00,93,36,57,0,0,0
2021-10-30 16:15,103,42,61,0,0,0
2021-10-30 16:30,75,34,41,0,0,0
2021-10-30 16:45,126,50,76,0,0,0
2021-10-30 17:00,80,34,46,0,0,0
2021-10-30 17:15,100,46,54,0,0,0
2021-10-30 17:30,109,56,53,0,0,0
2021-10-30 17:45,149,54,95,0,0,0
2021-10-30 18:00,104,38,66,0,0,0
2021-10-30 18:15,100,46,54,0,0,0
2021-10-30 18:30,106,46,60,0,0,0
2021-10-30 18:45,92,43,49,0,0,0
2021-10-30 19:00,104,38,66,0,0,0
2021-10-30 19:15,77,32,45,0,0,0
2021-10-30 19:30,74,37,37,0,0,0
2021-10-30 19:45,79,25,54,0,0,0
2021-10-30 20:00,69,33,36,0,0,0
2021-10-30 20:15,54,23,31,0,0,0
2021-10-30 20:30,33,20,13,0,0,0
2021-10-30 20:45,40,17,23,0,0,0
2021-10-30 21:00,49,21,28,0,0,0
2021-10-30 21:15,33,16,17,0,0,0
2021-10-30 21:30,47,14,33,0,0,0
2021-10-30 21:45,39,11,28,0,0,0
2021-10-30 22:00,40,20,20,0,0,0
2021-10-30 22:15,47,18,29,0,0,0
2021-10-30 22:30,41,18,23,0,0,0
2021-10-30 22:45,38,11,27,0,0,0
2021-10-30 23:00,24,6,18,0,0,0
2021-10-30 23:15,24,5,19,0,0,0
2021-10-30 23:30,19,9,10,0,0,0
2021-10-30 23:45,33,11,22,0,0,0
