Datetime,100034980 (Hammer Straße),101034980 (Hammer Straße stadteinwärts),102034980 (Hammer Straße stadtauswärts),100034980-status,101034980-status,102034980-status
2022-05-01 00:00,43,13,30,0,0,0
2022-05-01 00:15,29,11,18,0,0,0
2022-05-01 00:30,36,19,17,0,0,0
2022-05-01 00:45,32,6,26,0,0,0
2022-05-01 01:00,19,3,16,0,0,0
2022-05-01 01:15,27,11,16,0,0,0
2022-05-01 01:30,18,2,16,0,0,0
2022-05-01 01:45,13,4,9,0,0,0
2022-05-01 02:00,20,6,14,0,0,0
2022-05-01 02:15,22,10,12,0,0,0
2022-05-01 02:30,16,6,10,0,0,0
2022-05-01 02:45,13,0,13,0,0,0
2022-05-01 03:00,22,13,9,0,0,0
2022-05-01 03:15,9,1,8,0,0,0
2022-05-01 03:30,11,1,10,0,0,0
2022-05-01 03:45,14,9,5,0,0,0
2022-05-01 04:00,6,0,6,0,0,0
2022-05-01 04:15,15,4,11,0,0,0
2022-05-01 04:30,8,1,7,0,0,0
2022-05-01 04:45,7,0,7,0,0,0
2022-05-01 05:00,3,2,1,0,0,0
2022-05-01 05:15,4,1,3,0,0,0
2022-05-01 05:30,4,4,0,0,0,0
2022-05-01 05:45,9,5,4,0,0,0
2022-05-01 06:00,4,3,1,0,0,0
2022-05-01 06:15,7,4,3,0,0,0
2022-05-01 06:30,5,2,3,0,0,0
2022-05-01 06:45,5,3,2,0,0,0
2022-05-01 07:00,7,6,1,0,0,0
2022-05-01 07:15,4,1,3,0,0,0
2022-05-01 07:30,10,4,6,0,0,0
2022-05-01 07:45,7,4,3,0,0,0
2022-05-01 08:00,10,9,1,0,0,0
2022-05-01 08:15,4,3,1,0,0,0
2022-05-01 08:30,11,7,4,0,0,0
2022-05-01 08:45,11,7,4,0,0,0
2022-05-01 09:00,23,14,9,0,0,0
2022-05-01 09:15,20,16,4,0,0,0
2022-05-01 09:30,31,17,14,0,0,0
2022-05-01 09:45,35,19,16,0,0,0
2022-05-01 10:00,42,27,15,0,0,0
2022-05-01 10:15,41,19,22,0,0,0
2022-05-01 10:30,60,25,35,0,0,0
2022-05-01 10:45,49,30,19,0,0,0
2022-05-01 11:00,52,32,20,0,0,0
2022-05-01 11:15,77,50,27,0,0,0
2022-05-01 11:30,64,31,33,0,0,0
2022-05-01 11:45,61,38,23,0,0,0
2022-05-01 12:00,105,66,39,0,0,0
2022-05-01 12:15,77,42,35,0,0,0
2022-05-01 12:30,61,32,29,0,0,0
2022-05-01 12:45,66,30,36,0,0,0
2022-05-01 13:00,84,39,45,0,0,0
2022-05-01 13:15,92,50,42,0,0,0
2022-05-01 13:30,76,37,39,0,0,0
2022-05-01 13:45,107,44,63,0,0,0
2022-05-01 14:00,93,45,48,0,0,0
2022-05-01 14:15,67,36,31,0,0,0
2022-05-01 14:30,86,48,38,0,0,0
2022-05-01 14:45,96,56,40,0,0,0
2022-05-01 15:00,136,81,55,0,0,0
2022-05-01 15:15,105,52,53,0,0,0
2022-05-01 15:30,115,51,64,0,0,0
2022-05-01 15:45,115,65,50,0,0,0
2022-05-01 16:00,99,48,51,0,0,0
2022-05-01 16:15,104,38,66,0,0,0
2022-05-01 16:30,121,51,70,0,0,0
2022-05-01 16:45,109,46,63,0,0,0
2022-05-01 17:00,102,41,61,0,0,0
2022-05-01 17:15,112,42,70,0,0,0
2022-05-01 17:30,125,52,73,0,0,0
2022-05-01 17:45,89,28,61,0,0,0
2022-05-01 18:00,120,49,71,0,0,0
2022-05-01 18:15,91,33,58,0,0,0
2022-05-01 18:30,88,45,43,0,0,0
2022-05-01 18:45,77,37,40,0,0,0
2022-05-01 19:00,76,28,48,0,0,0
2022-05-01 19:15,72,30,42,0,0,0
2022-05-01 19:30,71,30,41,0,0,0
2022-05-01 19:45,42,20,22,0,0,0
2022-05-01 20:00,62,28,34,0,0,0
2022-05-01 20:15,54,21,33,0,0,0
2022-05-01 20:30,50,18,32,0,0,0
2022-05-01 20:45,60,18,42,0,0,0
2022-05-01 21:00,48,24,24,0,0,0
2022-05-01 21:15,47,6,41,0,0,0
2022-05-01 21:30,53,18,35,0,0,0
2022-05-01 21:45,52,20,32,0,0,0
2022-05-01 22:00,39,14,25,0,0,0
2022-05-01 22:15,34,11,23,0,0,0
2022-05-01 22:30,20,9,11,0,0,0
2022-05-01 22:45,19,5,14,0,0,0
2022-05-01 23:00,14,6,8,0,0,0
2022-05-01 23:15,11,2,9,0,0,0
2022-05-01 23:30,18,11,7,0,0,0
2022-05-01 23:45,8,4,4,0,0,0
2022-05-02 00:00,2,0,2,0,0,0
2022-05-02 00:15,7,3,4,0,0,0
2022-05-02 00:30,11,2,9,0,0,0
2022-05-02 00:45,3,0,3,0,0,0
2022-05-02 01:00,2,2,0,0,0,0
2022-05-02 01:15,3,1,2,0,0,0
2022-05-02 01:30,0,0,0,0,0,0
2022-05-02 01:45,3,2,1,0,0,0
2022-05-02 02:00,0,0,0,0,0,0
2022-05-02 02:15,2,2,0,0,0,0
2022-05-02 02:30,1,1,0,0,0,0
2022-05-02 02:45,2,1,1,0,0,0
2022-05-02 03:00,2,0,2,0,0,0
2022-05-02 03:15,0,0,0,0,0,0
2022-05-02 03:30,1,0,1,0,0,0
2022-05-02 03:45,1,1,0,0,0,0
2022-05-02 04:00,2,2,0,0,0,0
2022-05-02 04:15,3,2,1,0,0,0
2022-05-02 04:30,2,0,2,0,0,0
2022-05-02 04:45,5,5,0,0,0,0
2022-05-02 05:00,2,2,0,0,0,0
2022-05-02 05:15,8,5,3,0,0,0
2022-05-02 05:30,19,13,6,0,0,0
2022-05-02 05:45,20,16,4,0,0,0
2022-05-02 06:00,22,17,5,0,0,0
2022-05-02 06:15,32,23,9,0,0,0
2022-05-02 06:30,50,35,15,0,0,0
2022-05-02 06:45,64,45,19,0,0,0
2022-05-02 07:00,95,59,36,0,0,0
2022-05-02 07:15,129,84,45,0,0,0
2022-05-02 07:30,209,124,85,0,0,0
2022-05-02 07:45,188,130,58,0,0,0
2022-05-02 08:00,158,106,52,0,0,0
2022-05-02 08:15,156,85,71,0,0,0
2022-05-02 08:30,148,104,44,0,0,0
2022-05-02 08:45,177,133,44,0,0,0
2022-05-02 09:00,127,88,39,0,0,0
2022-05-02 09:15,104,64,40,0,0,0
2022-05-02 09:30,104,69,35,0,0,0
2022-05-02 09:45,144,104,40,0,0,0
2022-05-02 10:00,117,75,42,0,0,0
2022-05-02 10:15,109,51,58,0,0,0
2022-05-02 10:30,107,65,42,0,0,0
2022-05-02 10:45,107,65,42,0,0,0
2022-05-02 11:00,117,49,68,0,0,0
2022-05-02 11:15,124,56,68,0,0,0
2022-05-02 11:30,140,71,69,0,0,0
2022-05-02 11:45,158,88,70,0,0,0
2022-05-02 12:00,148,67,81,0,0,0
2022-05-02 12:15,149,58,91,0,0,0
2022-05-02 12:30,151,66,85,0,0,0
2022-05-02 12:45,174,83,91,0,0,0
2022-05-02 13:00,138,54,84,0,0,0
2022-05-02 13:15,157,66,91,0,0,0
2022-05-02 13:30,179,83,96,0,0,0
2022-05-02 13:45,180,92,88,0,0,0
2022-05-02 14:00,127,59,68,0,0,0
2022-05-02 14:15,152,68,84,0,0,0
2022-05-02 14:30,144,74,70,0,0,0
2022-05-02 14:45,211,96,115,0,0,0
2022-05-02 15:00,187,58,129,0,0,0
2022-05-02 15:15,164,64,100,0,0,0
2022-05-02 15:30,170,68,102,0,0,0
2022-05-02 15:45,245,94,151,0,0,0
2022-05-02 16:00,197,85,112,0,0,0
2022-05-02 16:15,208,95,113,0,0,0
2022-05-02 16:30,207,81,126,0,0,0
2022-05-02 16:45,225,110,115,0,0,0
2022-05-02 17:00,257,109,148,0,0,0
2022-05-02 17:15,216,92,124,0,0,0
2022-05-02 17:30,271,102,169,0,0,0
2022-05-02 17:45,244,105,139,0,0,0
2022-05-02 18:00,197,64,133,0,0,0
2022-05-02 18:15,193,60,133,0,0,0
2022-05-02 18:30,171,51,120,0,0,0
2022-05-02 18:45,176,64,112,0,0,0
2022-05-02 19:00,151,57,94,0,0,0
2022-05-02 19:15,127,53,74,0,0,0
2022-05-02 19:30,153,63,90,0,0,0
2022-05-02 19:45,150,49,101,0,0,0
2022-05-02 20:00,129,45,84,0,0,0
2022-05-02 20:15,88,29,59,0,0,0
2022-05-02 20:30,74,28,46,0,0,0
2022-05-02 20:45,61,22,39,0,0,0
2022-05-02 21:00,56,25,31,0,0,0
2022-05-02 21:15,66,19,47,0,0,0
2022-05-02 21:30,48,14,34,0,0,0
2022-05-02 21:45,62,28,34,0,0,0
2022-05-02 22:00,47,12,35,0,0,0
2022-05-02 22:15,56,16,40,0,0,0
2022-05-02 22:30,34,12,22,0,0,0
2022-05-02 22:45,39,6,33,0,0,0
2022-05-02 23:00,30,8,22,0,0,0
2022-05-02 23:15,15,3,12,0,0,0
2022-05-02 23:30,19,10,9,0,0,0
2022-05-02 23:45,14,2,12,0,0,0
2022-05-03 00:00,13,2,11,0,0,0
2022-05-03 00:15,9,3,6,0,0,0
2022-05-03 00:30,9,1,8,0,0,0
2022-05-03 00:45,6,4,2,0,0,0
2022-05-03 01:00,2,0,2,0,0,0
2022-05-03 01:15,6,1,5,0,0,0
2022-05-03 01:30,3,3,0,0,0,0
2022-05-03 01:45,4,2,2,0,0,0
2022-05-03 02:00,1,1,0,0,0,0
2022-05-03 02:15,3,2,1,0,0,0
2022-05-03 02:30,1,0,1,0,0,0
2022-05-03 02:45,0,0,0,0,0,0
2022-05-03 03:00,1,0,1,0,0,0
2022-05-03 03:15,2,0,2,0,0,0
2022-05-03 03:30,0,0,0,0,0,0
2022-05-03 03:45,1,1,0,0,0,0
2022-05-03 04:00,1,1,0,0,0,0
2022-05-03 04:15,2,2,0,0,0,0
2022-05-03 04:30,4,3,1,0,0,0
2022-05-03 04:45,3,3,0,0,0,0
2022-05-03 05:00,5,3,2,0,0,0
2022-05-03 05:15,9,6,3,0,0,0
2022-05-03 05:30,21,13,8,0,0,0
2022-05-03 05:45,21,19,2,0,0,0
2022-05-03 06:00,32,22,10,0,0,0
2022-05-03 06:15,39,29,10,0,0,0
2022-05-03 06:30,59,37,22,0,0,0
2022-05-03 06:45,61,35,26,0,0,0
2022-05-03 07:00,106,76,30,0,0,0
2022-05-03 07:15,141,90,51,0,0,0
2022-05-03 07:30,218,136,82,0,0,0
2022-05-03 07:45,211,146,65,0,0,0
2022-05-03 08:00,194,126,68,0,0,0
2022-05-03 08:15,181,114,67,0,0,0
2022-05-03 08:30,159,108,51,0,0,0
2022-05-03 08:45,181,130,51,0,0,0
2022-05-03 09:00,124,76,48,0,0,0
2022-05-03 09:15,107,67,40,0,0,0
2022-05-03 09:30,118,74,44,0,0,0
2022-05-03 09:45,150,101,49,0,0,0
2022-05-03 10:00,151,98,53,0,0,0
2022-05-03 10:15,93,40,53,0,0,0
2022-05-03 10:30,104,57,47,0,0,0
2022-05-03 10:45,114,63,51,0,0,0
2022-05-03 11:00,143,65,78,0,0,0
2022-05-03 11:15,98,50,48,0,0,0
2022-05-03 11:30,134,69,65,0,0,0
2022-05-03 11:45,150,73,77,0,0,0
2022-05-03 12:00,183,87,96,0,0,0
2022-05-03 12:15,135,54,81,0,0,0
2022-05-03 12:30,133,50,83,0,0,0
2022-05-03 12:45,196,78,118,0,0,0
2022-05-03 13:00,168,65,103,0,0,0
2022-05-03 13:15,168,62,106,0,0,0
2022-05-03 13:30,137,57,80,0,0,0
2022-05-03 13:45,188,76,112,0,0,0
2022-05-03 14:00,163,78,85,0,0,0
2022-05-03 14:15,166,73,93,0,0,0
2022-05-03 14:30,153,72,81,0,0,0
2022-05-03 14:45,189,75,114,0,0,0
2022-05-03 15:00,182,60,122,0,0,0
2022-05-03 15:15,183,81,102,0,0,0
2022-05-03 15:30,202,71,131,0,0,0
2022-05-03 15:45,244,109,135,0,0,0
2022-05-03 16:00,258,103,155,0,0,0
2022-05-03 16:15,237,88,149,0,0,0
2022-05-03 16:30,234,103,131,0,0,0
2022-05-03 16:45,241,112,129,0,0,0
2022-05-03 17:00,219,85,134,0,0,0
2022-05-03 17:15,236,83,153,0,0,0
2022-05-03 17:30,245,107,138,0,0,0
2022-05-03 17:45,251,118,133,0,0,0
2022-05-03 18:00,231,81,150,0,0,0
2022-05-03 18:15,227,92,135,0,0,0
2022-05-03 18:30,212,68,144,0,0,0
2022-05-03 18:45,170,64,106,0,0,0
2022-05-03 19:00,126,36,90,0,0,0
2022-05-03 19:15,174,72,102,0,0,0
2022-05-03 19:30,142,35,107,0,0,0
2022-05-03 19:45,134,49,85,0,0,0
2022-05-03 20:00,116,36,80,0,0,0
2022-05-03 20:15,100,38,62,0,0,0
2022-05-03 20:30,58,16,42,0,0,0
2022-05-03 20:45,76,27,49,0,0,0
2022-05-03 21:00,66,24,42,0,0,0
2022-05-03 21:15,79,20,59,0,0,0
2022-05-03 21:30,54,19,35,0,0,0
2022-05-03 21:45,68,24,44,0,0,0
2022-05-03 22:00,51,14,37,0,0,0
2022-05-03 22:15,75,23,52,0,0,0
2022-05-03 22:30,45,9,36,0,0,0
2022-05-03 22:45,49,19,30,0,0,0
2022-05-03 23:00,68,29,39,0,0,0
2022-05-03 23:15,24,10,14,0,0,0
2022-05-03 23:30,29,12,17,0,0,0
2022-05-03 23:45,13,5,8,0,0,0
2022-05-04 00:00,12,3,9,0,0,0
2022-05-04 00:15,6,1,5,0,0,0
2022-05-04 00:30,5,1,4,0,0,0
2022-05-04 00:45,2,0,2,0,0,0
2022-05-04 01:00,8,6,2,0,0,0
2022-05-04 01:15,3,1,2,0,0,0
2022-05-04 01:30,2,1,1,0,0,0
2022-05-04 01:45,1,0,1,0,0,0
2022-05-04 02:00,2,1,1,0,0,0
2022-05-04 02:15,0,0,0,0,0,0
2022-05-04 02:30,2,2,0,0,0,0
2022-05-04 02:45,1,0,1,0,0,0
2022-05-04 03:00,0,0,0,0,0,0
2022-05-04 03:15,1,1,0,0,0,0
2022-05-04 03:30,0,0,0,0,0,0
2022-05-04 03:45,0,0,0,0,0,0
2022-05-04 04:00,2,1,1,0,0,0
2022-05-04 04:15,4,2,2,0,0,0
2022-05-04 04:30,1,1,0,0,0,0
2022-05-04 04:45,3,3,0,0,0,0
2022-05-04 05:00,4,4,0,0,0,0
2022-05-04 05:15,8,4,4,0,0,0
2022-05-04 05:30,17,10,7,0,0,0
2022-05-04 05:45,17,16,1,0,0,0
2022-05-04 06:00,31,25,6,0,0,0
2022-05-04 06:15,43,33,10,0,0,0
2022-05-04 06:30,59,36,23,0,0,0
2022-05-04 06:45,72,46,26,0,0,0
2022-05-04 07:00,109,73,36,0,0,0
2022-05-04 07:15,167,102,65,0,0,0
2022-05-04 07:30,203,108,95,0,0,0
2022-05-04 07:45,205,136,69,0,0,0
2022-05-04 08:00,172,123,49,0,0,0
2022-05-04 08:15,171,110,61,0,0,0
2022-05-04 08:30,149,105,44,0,0,0
2022-05-04 08:45,163,108,55,0,0,0
2022-05-04 09:00,146,95,51,0,0,0
2022-05-04 09:15,116,79,37,0,0,0
2022-05-04 09:30,127,86,41,0,0,0
2022-05-04 09:45,142,92,50,0,0,0
2022-05-04 10:00,130,73,57,0,0,0
2022-05-04 10:15,128,76,52,0,0,0
2022-05-04 10:30,103,55,48,0,0,0
2022-05-04 10:45,148,83,65,0,0,0
2022-05-04 11:00,127,60,67,0,0,0
2022-05-04 11:15,123,59,64,0,0,0
2022-05-04 11:30,131,64,67,0,0,0
2022-05-04 11:45,169,84,85,0,0,0
2022-05-04 12:00,178,78,100,0,0,0
2022-05-04 12:15,196,80,116,0,0,0
2022-05-04 12:30,180,76,104,0,0,0
2022-05-04 12:45,172,66,106,0,0,0
2022-05-04 13:00,168,63,105,0,0,0
2022-05-04 13:15,184,85,99,0,0,0
2022-05-04 13:30,169,72,97,0,0,0
2022-05-04 13:45,174,78,96,0,0,0
2022-05-04 14:00,184,64,120,0,0,0
2022-05-04 14:15,173,75,98,0,0,0
2022-05-04 14:30,161,61,100,0,0,0
2022-05-04 14:45,204,96,108,0,0,0
2022-05-04 15:00,150,58,92,0,0,0
2022-05-04 15:15,182,84,98,0,0,0
2022-05-04 15:30,189,85,104,0,0,0
2022-05-04 15:45,231,114,117,0,0,0
2022-05-04 16:00,205,89,116,0,0,0
2022-05-04 16:15,209,97,112,0,0,0
2022-05-04 16:30,233,94,139,0,0,0
2022-05-04 16:45,212,86,126,0,0,0
2022-05-04 17:00,245,107,138,0,0,0
2022-05-04 17:15,210,86,124,0,0,0
2022-05-04 17:30,228,97,131,0,0,0
2022-05-04 17:45,218,90,128,0,0,0
2022-05-04 18:00,211,72,139,0,0,0
2022-05-04 18:15,202,76,126,0,0,0
2022-05-04 18:30,163,68,95,0,0,0
2022-05-04 18:45,166,70,96,0,0,0
2022-05-04 19:00,160,62,98,0,0,0
2022-05-04 19:15,151,60,91,0,0,0
2022-05-04 19:30,117,55,62,0,0,0
2022-05-04 19:45,109,42,67,0,0,0
2022-05-04 20:00,130,51,79,0,0,0
2022-05-04 20:15,110,34,76,0,0,0
2022-05-04 20:30,73,28,45,0,0,0
2022-05-04 20:45,89,24,65,0,0,0
2022-05-04 21:00,82,34,48,0,0,0
2022-05-04 21:15,57,19,38,0,0,0
2022-05-04 21:30,92,23,69,0,0,0
2022-05-04 21:45,85,32,53,0,0,0
2022-05-04 22:00,61,18,43,0,0,0
2022-05-04 22:15,62,21,41,0,0,0
2022-05-04 22:30,70,32,38,0,0,0
2022-05-04 22:45,44,18,26,0,0,0
2022-05-04 23:00,34,7,27,0,0,0
2022-05-04 23:15,41,13,28,0,0,0
2022-05-04 23:30,32,18,14,0,0,0
2022-05-04 23:45,50,29,21,0,0,0
2022-05-05 00:00,34,15,19,0,0,0
2022-05-05 00:15,30,13,17,0,0,0
2022-05-05 00:30,15,4,11,0,0,0
2022-05-05 00:45,18,3,15,0,0,0
2022-05-05 01:00,15,3,12,0,0,0
2022-05-05 01:15,11,4,7,0,0,0
2022-05-05 01:30,3,1,2,0,0,0
2022-05-05 01:45,6,3,3,0,0,0
2022-05-05 02:00,2,1,1,0,0,0
2022-05-05 02:15,9,0,9,0,0,0
2022-05-05 02:30,2,0,2,0,0,0
2022-05-05 02:45,9,0,9,0,0,0
2022-05-05 03:00,5,1,4,0,0,0
2022-05-05 03:15,9,0,9,0,0,0
2022-05-05 03:30,4,0,4,0,0,0
2022-05-05 03:45,6,1,5,0,0,0
2022-05-05 04:00,3,1,2,0,0,0
2022-05-05 04:15,5,2,3,0,0,0
2022-05-05 04:30,6,1,5,0,0,0
2022-05-05 04:45,8,4,4,0,0,0
2022-05-05 05:00,8,3,5,0,0,0
2022-05-05 05:15,17,6,11,0,0,0
2022-05-05 05:30,22,13,9,0,0,0
2022-05-05 05:45,20,14,6,0,0,0
2022-05-05 06:00,27,18,9,0,0,0
2022-05-05 06:15,36,29,7,0,0,0
2022-05-05 06:30,53,23,30,0,0,0
2022-05-05 06:45,63,37,26,0,0,0
2022-05-05 07:00,89,48,41,0,0,0
2022-05-05 07:15,116,79,37,0,0,0
2022-05-05 07:30,188,109,79,0,0,0
2022-05-05 07:45,172,125,47,0,0,0
2022-05-05 08:00,153,100,53,0,0,0
2022-05-05 08:15,159,92,67,0,0,0
2022-05-05 08:30,146,87,59,0,0,0
2022-05-05 08:45,156,116,40,0,0,0
2022-05-05 09:00,106,65,41,0,0,0
2022-05-05 09:15,78,56,22,0,0,0
2022-05-05 09:30,113,71,42,0,0,0
2022-05-05 09:45,146,95,51,0,0,0
2022-05-05 10:00,109,69,40,0,0,0
2022-05-05 10:15,80,46,34,0,0,0
2022-05-05 10:30,106,57,49,0,0,0
2022-05-05 10:45,120,57,63,0,0,0
2022-05-05 11:00,109,58,51,0,0,0
2022-05-05 11:15,117,67,50,0,0,0
2022-05-05 11:30,156,80,76,0,0,0
2022-05-05 11:45,141,78,63,0,0,0
2022-05-05 12:00,134,63,71,0,0,0
2022-05-05 12:15,139,61,78,0,0,0
2022-05-05 12:30,134,50,84,0,0,0
2022-05-05 12:45,158,66,92,0,0,0
2022-05-05 13:00,163,58,105,0,0,0
2022-05-05 13:15,148,71,77,0,0,0
2022-05-05 13:30,177,88,89,0,0,0
2022-05-05 13:45,208,92,116,0,0,0
2022-05-05 14:00,163,78,85,0,0,0
2022-05-05 14:15,158,66,92,0,0,0
2022-05-05 14:30,163,70,93,0,0,0
2022-05-05 14:45,179,98,81,0,0,0
2022-05-05 15:00,183,85,98,0,0,0
2022-05-05 15:15,196,87,109,0,0,0
2022-05-05 15:30,211,105,106,0,0,0
2022-05-05 15:45,215,88,127,0,0,0
2022-05-05 16:00,210,86,124,0,0,0
2022-05-05 16:15,206,77,129,0,0,0
2022-05-05 16:30,206,70,136,0,0,0
2022-05-05 16:45,217,86,131,0,0,0
2022-05-05 17:00,213,84,129,0,0,0
2022-05-05 17:15,230,86,144,0,0,0
2022-05-05 17:30,202,86,116,0,0,0
2022-05-05 17:45,249,107,142,0,0,0
2022-05-05 18:00,223,84,139,0,0,0
2022-05-05 18:15,214,91,123,0,0,0
2022-05-05 18:30,176,75,101,0,0,0
2022-05-05 18:45,176,70,106,0,0,0
2022-05-05 19:00,138,56,82,0,0,0
2022-05-05 19:15,165,67,98,0,0,0
2022-05-05 19:30,100,41,59,0,0,0
2022-05-05 19:45,120,44,76,0,0,0
2022-05-05 20:00,122,43,79,0,0,0
2022-05-05 20:15,91,40,51,0,0,0
2022-05-05 20:30,76,23,53,0,0,0
2022-05-05 20:45,75,34,41,0,0,0
2022-05-05 21:00,61,18,43,0,0,0
2022-05-05 21:15,59,21,38,0,0,0
2022-05-05 21:30,54,16,38,0,0,0
2022-05-05 21:45,57,23,34,0,0,0
2022-05-05 22:00,53,14,39,0,0,0
2022-05-05 22:15,49,16,33,0,0,0
2022-05-05 22:30,55,16,39,0,0,0
2022-05-05 22:45,27,9,18,0,0,0
2022-05-05 23:00,53,15,38,0,0,0
2022-05-05 23:15,56,30,26,0,0,0
2022-05-05 23:30,39,12,27,0,0,0
2022-05-05 23:45,16,4,12,0,0,0
2022-05-06 00:00,18,3,15,0,0,0
2022-05-06 00:15,15,5,10,0,0,0
2022-05-06 00:30,12,3,9,0,0,0
2022-05-06 00:45,13,5,8,0,0,0
2022-05-06 01:00,6,0,6,0,0,0
2022-05-06 01:15,4,1,3,0,0,0
2022-05-06 01:30,5,2,3,0,0,0
2022-05-06 01:45,2,0,2,0,0,0
2022-05-06 02:00,3,0,3,0,0,0
2022-05-06 02:15,8,0,8,0,0,0
2022-05-06 02:30,4,0,4,0,0,0
2022-05-06 02:45,1,1,0,0,0,0
2022-05-06 03:00,2,1,1,0,0,0
2022-05-06 03:15,0,0,0,0,0,0
2022-05-06 03:30,0,0,0,0,0,0
2022-05-06 03:45,1,0,1,0,0,0
2022-05-06 04:00,3,2,1,0,0,0
2022-05-06 04:15,3,1,2,0,0,0
2022-05-06 04:30,0,0,0,0,0,0
2022-05-06 04:45,2,2,0,0,0,0
2022-05-06 05:00,3,2,1,0,0,0
2022-05-06 05:15,5,2,3,0,0,0
2022-05-06 05:30,19,13,6,0,0,0
2022-05-06 05:45,19,17,2,0,0,0
2022-05-06 06:00,29,18,11,0,0,0
2022-05-06 06:15,26,18,8,0,0,0
2022-05-06 06:30,41,21,20,0,0,0
2022-05-06 06:45,81,52,29,0,0,0
2022-05-06 07:00,83,47,36,0,0,0
2022-05-06 07:15,100,61,39,0,0,0
2022-05-06 07:30,160,88,72,0,0,0
2022-05-06 07:45,176,126,50,0,0,0
2022-05-06 08:00,136,91,45,0,0,0
2022-05-06 08:15,162,102,60,0,0,0
2022-05-06 08:30,133,85,48,0,0,0
2022-05-06 08:45,125,81,44,0,0,0
2022-05-06 09:00,117,70,47,0,0,0
2022-05-06 09:15,114,71,43,0,0,0
2022-05-06 09:30,105,70,35,0,0,0
2022-05-06 09:45,141,95,46,0,0,0
2022-05-06 10:00,118,72,46,0,0,0
2022-05-06 10:15,106,60,46,0,0,0
2022-05-06 10:30,118,60,58,0,0,0
2022-05-06 10:45,108,58,50,0,0,0
2022-05-06 11:00,114,58,56,0,0,0
2022-05-06 11:15,113,57,56,0,0,0
2022-05-06 11:30,151,82,69,0,0,0
2022-05-06 11:45,168,73,95,0,0,0
2022-05-06 12:00,153,68,85,0,0,0
2022-05-06 12:15,161,73,88,0,0,0
2022-05-06 12:30,163,63,100,0,0,0
2022-05-06 12:45,167,70,97,0,0,0
2022-05-06 13:00,163,64,99,0,0,0
2022-05-06 13:15,162,53,109,0,0,0
2022-05-06 13:30,166,71,95,0,0,0
2022-05-06 13:45,226,96,130,0,0,0
2022-05-06 14:00,207,84,123,0,0,0
2022-05-06 14:15,206,89,117,0,0,0
2022-05-06 14:30,199,89,110,0,0,0
2022-05-06 14:45,198,93,105,0,0,0
2022-05-06 15:00,192,87,105,0,0,0
2022-05-06 15:15,206,95,111,0,0,0
2022-05-06 15:30,202,84,118,0,0,0
2022-05-06 15:45,217,114,103,0,0,0
2022-05-06 16:00,195,82,113,0,0,0
2022-05-06 16:15,213,91,122,0,0,0
2022-05-06 16:30,201,90,111,0,0,0
2022-05-06 16:45,203,102,101,0,0,0
2022-05-06 17:00,203,73,130,0,0,0
2022-05-06 17:15,195,108,87,0,0,0
2022-05-06 17:30,184,84,100,0,0,0
2022-05-06 17:45,175,74,101,0,0,0
2022-05-06 18:00,213,111,102,0,0,0
2022-05-06 18:15,179,75,104,0,0,0
2022-05-06 18:30,149,59,90,0,0,0
2022-05-06 18:45,157,83,74,0,0,0
2022-05-06 19:00,141,57,84,0,0,0
2022-05-06 19:15,130,65,65,0,0,0
2022-05-06 19:30,118,58,60,0,0,0
2022-05-06 19:45,138,55,83,0,0,0
2022-05-06 20:00,107,44,63,0,0,0
2022-05-06 20:15,82,30,52,0,0,0
2022-05-06 20:30,96,42,54,0,0,0
2022-05-06 20:45,94,35,59,0,0,0
2022-05-06 21:00,67,27,40,0,0,0
2022-05-06 21:15,64,18,46,0,0,0
2022-05-06 21:30,79,49,30,0,0,0
2022-05-06 21:45,59,29,30,0,0,0
2022-05-06 22:00,50,22,28,0,0,0
2022-05-06 22:15,80,27,53,0,0,0
2022-05-06 22:30,69,21,48,0,0,0
2022-05-06 22:45,43,20,23,0,0,0
2022-05-06 23:00,48,22,26,0,0,0
2022-05-06 23:15,49,20,29,0,0,0
2022-05-06 23:30,59,22,37,0,0,0
2022-05-06 23:45,45,15,30,0,0,0
2022-05-07 00:00,51,13,38,0,0,0
2022-05-07 00:15,36,13,23,0,0,0
2022-05-07 00:30,35,13,22,0,0,0
2022-05-07 00:45,34,8,26,0,0,0
2022-05-07 01:00,23,2,21,0,0,0
2022-05-07 01:15,27,12,15,0,0,0
2022-05-07 01:30,15,3,12,0,0,0
2022-05-07 01:45,19,6,13,0,0,0
2022-05-07 02:00,14,5,9,0,0,0
2022-05-07 02:15,26,8,18,0,0,0
2022-05-07 02:30,11,0,11,0,0,0
2022-05-07 02:45,20,5,15,0,0,0
2022-05-07 03:00,12,3,9,0,0,0
2022-05-07 03:15,14,6,8,0,0,0
2022-05-07 03:30,8,0,8,0,0,0
2022-05-07 03:45,3,0,3,0,0,0
2022-05-07 04:00,4,1,3,0,0,0
2022-05-07 04:15,7,0,7,0,0,0
2022-05-07 04:30,3,0,3,0,0,0
2022-05-07 04:45,8,2,6,0,0,0
2022-05-07 05:00,0,0,0,0,0,0
2022-05-07 05:15,4,0,4,0,0,0
2022-05-07 05:30,14,7,7,0,0,0
2022-05-07 05:45,10,8,2,0,0,0
2022-05-07 06:00,7,4,3,0,0,0
2022-05-07 06:15,9,5,4,0,0,0
2022-05-07 06:30,9,5,4,0,0,0
2022-05-07 06:45,10,6,4,0,0,0
2022-05-07 07:00,14,9,5,0,0,0
2022-05-07 07:15,22,17,5,0,0,0
2022-05-07 07:30,28,18,10,0,0,0
2022-05-07 07:45,25,14,11,0,0,0
2022-05-07 08:00,28,19,9,0,0,0
2022-05-07 08:15,44,27,17,0,0,0
2022-05-07 08:30,54,36,18,0,0,0
2022-05-07 08:45,73,49,24,0,0,0
2022-05-07 09:00,78,47,31,0,0,0
2022-05-07 09:15,92,60,32,0,0,0
2022-05-07 09:30,88,51,37,0,0,0
2022-05-07 09:45,138,98,40,0,0,0
2022-05-07 10:00,118,86,32,0,0,0
2022-05-07 10:15,136,88,48,0,0,0
2022-05-07 10:30,144,94,50,0,0,0
2022-05-07 10:45,166,107,59,0,0,0
2022-05-07 11:00,140,80,60,0,0,0
2022-05-07 11:15,156,89,67,0,0,0
2022-05-07 11:30,169,96,73,0,0,0
2022-05-07 11:45,160,93,67,0,0,0
2022-05-07 12:00,182,100,82,0,0,0
2022-05-07 12:15,168,96,72,0,0,0
2022-05-07 12:30,205,112,93,0,0,0
2022-05-07 12:45,185,97,88,0,0,0
2022-05-07 13:00,186,89,97,0,0,0
2022-05-07 13:15,199,109,90,0,0,0
2022-05-07 13:30,190,91,99,0,0,0
2022-05-07 13:45,174,82,92,0,0,0
2022-05-07 14:00,210,85,125,0,0,0
2022-05-07 14:15,173,68,105,0,0,0
2022-05-07 14:30,187,83,104,0,0,0
2022-05-07 14:45,200,89,111,0,0,0
2022-05-07 15:00,183,72,111,0,0,0
2022-05-07 15:15,156,57,99,0,0,0
2022-05-07 15:30,139,67,72,0,0,0
2022-05-07 15:45,137,63,74,0,0,0
2022-05-07 16:00,154,83,71,0,0,0
2022-05-07 16:15,131,55,76,0,0,0
2022-05-07 16:30,115,55,60,0,0,0
2022-05-07 16:45,138,46,92,0,0,0
2022-05-07 17:00,135,62,73,0,0,0
2022-05-07 17:15,103,41,62,0,0,0
2022-05-07 17:30,120,51,69,0,0,0
2022-05-07 17:45,136,51,85,0,0,0
2022-05-07 18:00,120,32,88,0,0,0
2022-05-07 18:15,110,53,57,0,0,0
2022-05-07 18:30,105,41,64,0,0,0
2022-05-07 18:45,105,45,60,0,0,0
2022-05-07 19:00,95,49,46,0,0,0
2022-05-07 19:15,98,53,45,0,0,0
2022-05-07 19:30,92,33,59,0,0,0
2022-05-07 19:45,95,40,55,0,0,0
2022-05-07 20:00,81,31,50,0,0,0
2022-05-07 20:15,57,26,31,0,0,0
2022-05-07 20:30,56,27,29,0,0,0
2022-05-07 20:45,59,18,41,0,0,0
2022-05-07 21:00,47,22,25,0,0,0
2022-05-07 21:15,52,29,23,0,0,0
2022-05-07 21:30,46,13,33,0,0,0
2022-05-07 21:45,32,14,18,0,0,0
2022-05-07 22:00,63,15,48,0,0,0
2022-05-07 22:15,53,17,36,0,0,0
2022-05-07 22:30,37,16,21,0,0,0
2022-05-07 22:45,22,8,14,0,0,0
2022-05-07 23:00,65,27,38,0,0,0
2022-05-07 23:15,45,9,36,0,0,0
2022-05-07 23:30,53,16,37,0,0,0
2022-05-07 23:45,41,19,22,0,0,0
2022-05-08 00:00,40,19,21,0,0,0
2022-05-08 00:15,25,9,16,0,0,0
2022-05-08 00:30,21,10,11,0,0,0
2022-05-08 00:45,38,12,26,0,0,0
2022-05-08 01:00,24,9,15,0,0,0
2022-05-08 01:15,16,5,11,0,0,0
2022-05-08 01:30,29,11,18,0,0,0
2022-05-08 01:45,22,6,16,0,0,0
2022-05-08 02:00,22,9,13,0,0,0
2022-05-08 02:15,7,0,7,0,0,0
2022-05-08 02:30,8,2,6,0,0,0
2022-05-08 02:45,7,1,6,0,0,0
2022-05-08 03:00,9,1,8,0,0,0
2022-05-08 03:15,9,1,8,0,0,0
2022-05-08 03:30,7,0,7,0,0,0
2022-05-08 03:45,4,2,2,0,0,0
2022-05-08 04:00,8,4,4,0,0,0
2022-05-08 04:15,7,1,6,0,0,0
2022-05-08 04:30,6,3,3,0,0,0
2022-05-08 04:45,4,0,4,0,0,0
2022-05-08 05:00,1,1,0,0,0,0
2022-05-08 05:15,1,1,0,0,0,0
2022-05-08 05:30,4,3,1,0,0,0
2022-05-08 05:45,7,7,0,0,0,0
2022-05-08 06:00,2,1,1,0,0,0
2022-05-08 06:15,5,2,3,0,0,0
2022-05-08 06:30,1,1,0,0,0,0
2022-05-08 06:45,5,2,3,0,0,0
2022-05-08 07:00,10,7,3,0,0,0
2022-05-08 07:15,5,3,2,0,0,0
2022-05-08 07:30,8,4,4,0,0,0
2022-05-08 07:45,10,3,7,0,0,0
2022-05-08 08:00,10,5,5,0,0,0
2022-05-08 08:15,7,4,3,0,0,0
2022-05-08 08:30,15,6,9,0,0,0
2022-05-08 08:45,25,18,7,0,0,0
2022-05-08 09:00,18,11,7,0,0,0
2022-05-08 09:15,28,16,12,0,0,0
2022-05-08 09:30,37,22,15,0,0,0
2022-05-08 09:45,46,32,14,0,0,0
2022-05-08 10:00,28,18,10,0,0,0
2022-05-08 10:15,44,26,18,0,0,0
2022-05-08 10:30,53,27,26,0,0,0
2022-05-08 10:45,52,28,24,0,0,0
2022-05-08 11:00,54,30,24,0,0,0
2022-05-08 11:15,47,26,21,0,0,0
2022-05-08 11:30,53,37,16,0,0,0
2022-05-08 11:45,46,30,16,0,0,0
2022-05-08 12:00,52,31,21,0,0,0
2022-05-08 12:15,70,43,27,0,0,0
2022-05-08 12:30,56,22,34,0,0,0
2022-05-08 12:45,92,45,47,0,0,0
2022-05-08 13:00,71,31,40,0,0,0
2022-05-08 13:15,84,40,44,0,0,0
2022-05-08 13:30,70,34,36,0,0,0
2022-05-08 13:45,81,40,41,0,0,0
2022-05-08 14:00,88,37,51,0,0,0
2022-05-08 14:15,74,33,41,0,0,0
2022-05-08 14:30,71,33,38,0,0,0
2022-05-08 14:45,106,58,48,0,0,0
2022-05-08 15:00,80,37,43,0,0,0
2022-05-08 15:15,76,28,48,0,0,0
2022-05-08 15:30,82,38,44,0,0,0
2022-05-08 15:45,126,57,69,0,0,0
2022-05-08 16:00,119,67,52,0,0,0
2022-05-08 16:15,92,37,55,0,0,0
2022-05-08 16:30,107,33,74,0,0,0
2022-05-08 16:45,57,30,27,0,0,0
2022-05-08 17:00,109,50,59,0,0,0
2022-05-08 17:15,123,53,70,0,0,0
2022-05-08 17:30,81,30,51,0,0,0
2022-05-08 17:45,112,49,63,0,0,0
2022-05-08 18:00,80,38,42,0,0,0
2022-05-08 18:15,86,41,45,0,0,0
2022-05-08 18:30,97,43,54,0,0,0
2022-05-08 18:45,99,51,48,0,0,0
2022-05-08 19:00,69,25,44,0,0,0
2022-05-08 19:15,79,34,45,0,0,0
2022-05-08 19:30,57,23,34,0,0,0
2022-05-08 19:45,74,26,48,0,0,0
2022-05-08 20:00,77,33,44,0,0,0
2022-05-08 20:15,53,16,37,0,0,0
2022-05-08 20:30,63,24,39,0,0,0
2022-05-08 20:45,63,18,45,0,0,0
2022-05-08 21:00,61,19,42,0,0,0
2022-05-08 21:15,34,14,20,0,0,0
2022-05-08 21:30,55,19,36,0,0,0
2022-05-08 21:45,22,7,15,0,0,0
2022-05-08 22:00,21,9,12,0,0,0
2022-05-08 22:15,25,11,14,0,0,0
2022-05-08 22:30,17,8,9,0,0,0
2022-05-08 22:45,9,4,5,0,0,0
2022-05-08 23:00,17,5,12,0,0,0
2022-05-08 23:15,9,1,8,0,0,0
2022-05-08 23:30,12,5,7,0,0,0
2022-05-08 23:45,7,3,4,0,0,0
2022-05-09 00:00,7,3,4,0,0,0
2022-05-09 00:15,8,5,3,0,0,0
2022-05-09 00:30,3,0,3,0,0,0
2022-05-09 00:45,6,2,4,0,0,0
2022-05-09 01:00,4,4,0,0,0,0
2022-05-09 01:15,5,5,0,0,0,0
2022-05-09 01:30,2,0,2,0,0,0
2022-05-09 01:45,1,1,0,0,0,0
2022-05-09 02:00,2,0,2,0,0,0
2022-05-09 02:15,0,0,0,0,0,0
2022-05-09 02:30,2,1,1,0,0,0
2022-05-09 02:45,1,0,1,0,0,0
2022-05-09 03:00,2,1,1,0,0,0
2022-05-09 03:15,2,0,2,0,0,0
2022-05-09 03:30,2,0,2,0,0,0
2022-05-09 03:45,1,0,1,0,0,0
2022-05-09 04:00,1,1,0,0,0,0
2022-05-09 04:15,0,0,0,0,0,0
2022-05-09 04:30,2,2,0,0,0,0
2022-05-09 04:45,2,2,0,0,0,0
2022-05-09 05:00,3,2,1,0,0,0
2022-05-09 05:15,9,6,3,0,0,0
2022-05-09 05:30,18,13,5,0,0,0
2022-05-09 05:45,26,22,4,0,0,0
2022-05-09 06:00,27,21,6,0,0,0
2022-05-09 06:15,37,27,10,0,0,0
2022-05-09 06:30,49,26,23,0,0,0
2022-05-09 06:45,74,52,22,0,0,0
2022-05-09 07:00,102,67,35,0,0,0
2022-05-09 07:15,128,88,40,0,0,0
2022-05-09 07:30,225,138,87,0,0,0
2022-05-09 07:45,187,117,70,0,0,0
2022-05-09 08:00,167,105,62,0,0,0
2022-05-09 08:15,154,101,53,0,0,0
2022-05-09 08:30,163,111,52,0,0,0
2022-05-09 08:45,139,95,44,0,0,0
2022-05-09 09:00,112,72,40,0,0,0
2022-05-09 09:15,94,50,44,0,0,0
2022-05-09 09:30,115,71,44,0,0,0
2022-05-09 09:45,116,82,34,0,0,0
2022-05-09 10:00,119,75,44,0,0,0
2022-05-09 10:15,92,49,43,0,0,0
2022-05-09 10:30,99,55,44,0,0,0
2022-05-09 10:45,119,56,63,0,0,0
2022-05-09 11:00,107,59,48,0,0,0
2022-05-09 11:15,117,61,56,0,0,0
2022-05-09 11:30,109,58,51,0,0,0
2022-05-09 11:45,143,64,79,0,0,0
2022-05-09 12:00,129,75,54,0,0,0
2022-05-09 12:15,118,42,76,0,0,0
2022-05-09 12:30,149,59,90,0,0,0
2022-05-09 12:45,144,69,75,0,0,0
2022-05-09 13:00,136,53,83,0,0,0
2022-05-09 13:15,149,60,89,0,0,0
2022-05-09 13:30,133,59,74,0,0,0
2022-05-09 13:45,215,106,109,0,0,0
2022-05-09 14:00,175,76,99,0,0,0
2022-05-09 14:15,176,68,108,0,0,0
2022-05-09 14:30,155,70,85,0,0,0
2022-05-09 14:45,167,89,78,0,0,0
2022-05-09 15:00,169,72,97,0,0,0
2022-05-09 15:15,189,87,102,0,0,0
2022-05-09 15:30,223,66,157,0,0,0
2022-05-09 15:45,209,98,111,0,0,0
2022-05-09 16:00,231,87,144,0,0,0
2022-05-09 16:15,241,111,130,0,0,0
2022-05-09 16:30,257,105,152,0,0,0
2022-05-09 16:45,234,101,133,0,0,0
2022-05-09 17:00,238,101,137,0,0,0
2022-05-09 17:15,218,85,133,0,0,0
2022-05-09 17:30,261,113,148,0,0,0
2022-05-09 17:45,281,120,161,0,0,0
2022-05-09 18:00,247,93,154,0,0,0
2022-05-09 18:15,196,73,123,0,0,0
2022-05-09 18:30,204,74,130,0,0,0
2022-05-09 18:45,200,91,109,0,0,0
2022-05-09 19:00,160,65,95,0,0,0
2022-05-09 19:15,167,72,95,0,0,0
2022-05-09 19:30,167,63,104,0,0,0
2022-05-09 19:45,146,54,92,0,0,0
2022-05-09 20:00,126,42,84,0,0,0
2022-05-09 20:15,100,34,66,0,0,0
2022-05-09 20:30,66,24,42,0,0,0
2022-05-09 20:45,57,25,32,0,0,0
2022-05-09 21:00,54,19,35,0,0,0
2022-05-09 21:15,73,32,41,0,0,0
2022-05-09 21:30,69,25,44,0,0,0
2022-05-09 21:45,73,26,47,0,0,0
2022-05-09 22:00,84,22,62,0,0,0
2022-05-09 22:15,48,18,30,0,0,0
2022-05-09 22:30,43,9,34,0,0,0
2022-05-09 22:45,33,5,28,0,0,0
2022-05-09 23:00,27,9,18,0,0,0
2022-05-09 23:15,22,8,14,0,0,0
2022-05-09 23:30,20,6,14,0,0,0
2022-05-09 23:45,13,6,7,0,0,0
2022-05-10 00:00,30,9,21,0,0,0
2022-05-10 00:15,10,1,9,0,0,0
2022-05-10 00:30,11,3,8,0,0,0
2022-05-10 00:45,5,1,4,0,0,0
2022-05-10 01:00,10,1,9,0,0,0
2022-05-10 01:15,9,0,9,0,0,0
2022-05-10 01:30,6,1,5,0,0,0
2022-05-10 01:45,4,0,4,0,0,0
2022-05-10 02:00,9,1,8,0,0,0
2022-05-10 02:15,8,4,4,0,0,0
2022-05-10 02:30,3,0,3,0,0,0
2022-05-10 02:45,5,2,3,0,0,0
2022-05-10 03:00,2,0,2,0,0,0
2022-05-10 03:15,4,0,4,0,0,0
2022-05-10 03:30,4,1,3,0,0,0
2022-05-10 03:45,2,0,2,0,0,0
2022-05-10 04:00,2,0,2,0,0,0
2022-05-10 04:15,6,4,2,0,0,0
2022-05-10 04:30,4,2,2,0,0,0
2022-05-10 04:45,4,4,0,0,0,0
2022-05-10 05:00,1,0,1,0,0,0
2022-05-10 05:15,5,4,1,0,0,0
2022-05-10 05:30,20,16,4,0,0,0
2022-05-10 05:45,26,24,2,0,0,0
2022-05-10 06:00,31,24,7,0,0,0
2022-05-10 06:15,43,33,10,0,0,0
2022-05-10 06:30,51,34,17,0,0,0
2022-05-10 06:45,62,40,22,0,0,0
2022-05-10 07:00,97,68,29,0,0,0
2022-05-10 07:15,146,90,56,0,0,0
2022-05-10 07:30,186,106,80,0,0,0
2022-05-10 07:45,210,144,66,0,0,0
2022-05-10 08:00,162,109,53,0,0,0
2022-05-10 08:15,158,98,60,0,0,0
2022-05-10 08:30,145,95,50,0,0,0
2022-05-10 08:45,152,113,39,0,0,0
2022-05-10 09:00,112,63,49,0,0,0
2022-05-10 09:15,97,65,32,0,0,0
2022-05-10 09:30,115,73,42,0,0,0
2022-05-10 09:45,139,86,53,0,0,0
2022-05-10 10:00,124,80,44,0,0,0
2022-05-10 10:15,119,63,56,0,0,0
2022-05-10 10:30,99,59,40,0,0,0
2022-05-10 10:45,115,55,60,0,0,0
2022-05-10 11:00,131,66,65,0,0,0
2022-05-10 11:15,133,64,69,0,0,0
2022-05-10 11:30,124,53,71,0,0,0
2022-05-10 11:45,166,77,89,0,0,0
2022-05-10 12:00,167,77,90,0,0,0
2022-05-10 12:15,146,63,83,0,0,0
2022-05-10 12:30,128,63,65,0,0,0
2022-05-10 12:45,144,71,73,0,0,0
2022-05-10 13:00,156,59,97,0,0,0
2022-05-10 13:15,149,64,85,0,0,0
2022-05-10 13:30,133,53,80,0,0,0
2022-05-10 13:45,201,98,103,0,0,0
2022-05-10 14:00,165,67,98,0,0,0
2022-05-10 14:15,170,74,96,0,0,0
2022-05-10 14:30,184,80,104,0,0,0
2022-05-10 14:45,163,74,89,0,0,0
2022-05-10 15:00,174,79,95,0,0,0
2022-05-10 15:15,178,71,107,0,0,0
2022-05-10 15:30,201,89,112,0,0,0
2022-05-10 15:45,238,118,120,0,0,0
2022-05-10 16:00,219,98,121,0,0,0
2022-05-10 16:15,233,91,142,0,0,0
2022-05-10 16:30,202,89,113,0,0,0
2022-05-10 16:45,229,83,146,0,0,0
2022-05-10 17:00,220,94,126,0,0,0
2022-05-10 17:15,220,79,141,0,0,0
2022-05-10 17:30,208,84,124,0,0,0
2022-05-10 17:45,241,96,145,0,0,0
2022-05-10 18:00,265,102,163,0,0,0
2022-05-10 18:15,223,93,130,0,0,0
2022-05-10 18:30,178,57,121,0,0,0
2022-05-10 18:45,180,76,104,0,0,0
2022-05-10 19:00,160,56,104,0,0,0
2022-05-10 19:15,161,59,102,0,0,0
2022-05-10 19:30,122,42,80,0,0,0
2022-05-10 19:45,109,34,75,0,0,0
2022-05-10 20:00,100,30,70,0,0,0
2022-05-10 20:15,99,40,59,0,0,0
2022-05-10 20:30,76,23,53,0,0,0
2022-05-10 20:45,67,26,41,0,0,0
2022-05-10 21:00,78,20,58,0,0,0
2022-05-10 21:15,77,26,51,0,0,0
2022-05-10 21:30,75,30,45,0,0,0
2022-05-10 21:45,40,18,22,0,0,0
2022-05-10 22:00,56,14,42,0,0,0
2022-05-10 22:15,44,12,32,0,0,0
2022-05-10 22:30,68,23,45,0,0,0
2022-05-10 22:45,49,19,30,0,0,0
2022-05-10 23:00,58,16,42,0,0,0
2022-05-10 23:15,25,9,16,0,0,0
2022-05-10 23:30,18,6,12,0,0,0
2022-05-10 23:45,15,4,11,0,0,0
2022-05-11 00:00,16,4,12,0,0,0
2022-05-11 00:15,16,9,7,0,0,0
2022-05-11 00:30,5,2,3,0,0,0
2022-05-11 00:45,7,2,5,0,0,0
2022-05-11 01:00,14,6,8,0,0,0
2022-05-11 01:15,1,1,0,0,0,0
2022-05-11 01:30,1,0,1,0,0,0
2022-05-11 01:45,4,0,4,0,0,0
2022-05-11 02:00,3,1,2,0,0,0
2022-05-11 02:15,1,0,1,0,0,0
2022-05-11 02:30,2,0,2,0,0,0
2022-05-11 02:45,1,1,0,0,0,0
2022-05-11 03:00,1,0,1,0,0,0
2022-05-11 03:15,2,1,1,0,0,0
2022-05-11 03:30,0,0,0,0,0,0
2022-05-11 03:45,0,0,0,0,0,0
2022-05-11 04:00,1,1,0,0,0,0
2022-05-11 04:15,4,3,1,0,0,0
2022-05-11 04:30,0,0,0,0,0,0
2022-05-11 04:45,4,4,0,0,0,0
2022-05-11 05:00,8,4,4,0,0,0
2022-05-11 05:15,7,6,1,0,0,0
2022-05-11 05:30,26,19,7,0,0,0
2022-05-11 05:45,21,18,3,0,0,0
2022-05-11 06:00,26,23,3,0,0,0
2022-05-11 06:15,42,32,10,0,0,0
2022-05-11 06:30,56,33,23,0,0,0
2022-05-11 06:45,69,37,32,0,0,0
2022-05-11 07:00,93,68,25,0,0,0
2022-05-11 07:15,162,105,57,0,0,0
2022-05-11 07:30,178,99,79,0,0,0
2022-05-11 07:45,215,148,67,0,0,0
2022-05-11 08:00,185,122,63,0,0,0
2022-05-11 08:15,171,111,60,0,0,0
2022-05-11 08:30,181,105,76,0,0,0
2022-05-11 08:45,177,121,56,0,0,0
2022-05-11 09:00,141,92,49,0,0,0
2022-05-11 09:15,112,72,40,0,0,0
2022-05-11 09:30,125,72,53,0,0,0
2022-05-11 09:45,164,116,48,0,0,0
2022-05-11 10:00,145,88,57,0,0,0
2022-05-11 10:15,145,93,52,0,0,0
2022-05-11 10:30,142,82,60,0,0,0
2022-05-11 10:45,131,73,58,0,0,0
2022-05-11 11:00,140,73,67,0,0,0
2022-05-11 11:15,131,73,58,0,0,0
2022-05-11 11:30,136,76,60,0,0,0
2022-05-11 11:45,160,79,81,0,0,0
2022-05-11 12:00,185,80,105,0,0,0
2022-05-11 12:15,168,77,91,0,0,0
2022-05-11 12:30,169,78,91,0,0,0
2022-05-11 12:45,189,85,104,0,0,0
2022-05-11 13:00,168,83,85,0,0,0
2022-05-11 13:15,166,80,86,0,0,0
2022-05-11 13:30,185,70,115,0,0,0
2022-05-11 13:45,203,98,105,0,0,0
2022-05-11 14:00,195,87,108,0,0,0
2022-05-11 14:15,151,61,90,0,0,0
2022-05-11 14:30,164,63,101,0,0,0
2022-05-11 14:45,196,67,129,0,0,0
2022-05-11 15:00,165,64,101,0,0,0
2022-05-11 15:15,183,73,110,0,0,0
2022-05-11 15:30,195,66,129,0,0,0
2022-05-11 15:45,252,122,130,0,0,0
2022-05-11 16:00,216,88,128,0,0,0
2022-05-11 16:15,230,99,131,0,0,0
2022-05-11 16:30,247,109,138,0,0,0
2022-05-11 16:45,229,103,126,0,0,0
2022-05-11 17:00,231,106,125,0,0,0
2022-05-11 17:15,243,97,146,0,0,0
2022-05-11 17:30,249,116,133,0,0,0
2022-05-11 17:45,250,91,159,0,0,0
2022-05-11 18:00,223,86,137,0,0,0
2022-05-11 18:15,203,81,122,0,0,0
2022-05-11 18:30,185,73,112,0,0,0
2022-05-11 18:45,216,105,111,0,0,0
2022-05-11 19:00,172,62,110,0,0,0
2022-05-11 19:15,141,59,82,0,0,0
2022-05-11 19:30,126,51,75,0,0,0
2022-05-11 19:45,153,55,98,0,0,0
2022-05-11 20:00,130,43,87,0,0,0
2022-05-11 20:15,120,36,84,0,0,0
2022-05-11 20:30,101,38,63,0,0,0
2022-05-11 20:45,85,26,59,0,0,0
2022-05-11 21:00,71,29,42,0,0,0
2022-05-11 21:15,69,32,37,0,0,0
2022-05-11 21:30,87,27,60,0,0,0
2022-05-11 21:45,76,29,47,0,0,0
2022-05-11 22:00,80,23,57,0,0,0
2022-05-11 22:15,70,32,38,0,0,0
2022-05-11 22:30,75,27,48,0,0,0
2022-05-11 22:45,58,21,37,0,0,0
2022-05-11 23:00,39,19,20,0,0,0
2022-05-11 23:15,44,19,25,0,0,0
2022-05-11 23:30,28,14,14,0,0,0
2022-05-11 23:45,17,10,7,0,0,0
2022-05-12 00:00,15,3,12,0,0,0
2022-05-12 00:15,18,5,13,0,0,0
2022-05-12 00:30,23,7,16,0,0,0
2022-05-12 00:45,11,1,10,0,0,0
2022-05-12 01:00,19,3,16,0,0,0
2022-05-12 01:15,1,0,1,0,0,0
2022-05-12 01:30,2,1,1,0,0,0
2022-05-12 01:45,7,1,6,0,0,0
2022-05-12 02:00,8,1,7,0,0,0
2022-05-12 02:15,0,0,0,0,0,0
2022-05-12 02:30,1,0,1,0,0,0
2022-05-12 02:45,2,1,1,0,0,0
2022-05-12 03:00,1,0,1,0,0,0
2022-05-12 03:15,4,0,4,0,0,0
2022-05-12 03:30,0,0,0,0,0,0
2022-05-12 03:45,0,0,0,0,0,0
2022-05-12 04:00,2,1,1,0,0,0
2022-05-12 04:15,1,1,0,0,0,0
2022-05-12 04:30,8,4,4,0,0,0
2022-05-12 04:45,5,3,2,0,0,0
2022-05-12 05:00,1,0,1,0,0,0
2022-05-12 05:15,9,4,5,0,0,0
2022-05-12 05:30,19,17,2,0,0,0
2022-05-12 05:45,15,13,2,0,0,0
2022-05-12 06:00,38,32,6,0,0,0
2022-05-12 06:15,37,22,15,0,0,0
2022-05-12 06:30,49,32,17,0,0,0
2022-05-12 06:45,73,48,25,0,0,0
2022-05-12 07:00,68,44,24,0,0,0
2022-05-12 07:15,126,74,52,0,0,0
2022-05-12 07:30,186,116,70,0,0,0
2022-05-12 07:45,173,123,50,0,0,0
2022-05-12 08:00,137,84,53,0,0,0
2022-05-12 08:15,170,109,61,0,0,0
2022-05-12 08:30,156,87,69,0,0,0
2022-05-12 08:45,159,108,51,0,0,0
2022-05-12 09:00,100,61,39,0,0,0
2022-05-12 09:15,88,55,33,0,0,0
2022-05-12 09:30,114,68,46,0,0,0
2022-05-12 09:45,159,105,54,0,0,0
2022-05-12 10:00,134,84,50,0,0,0
2022-05-12 10:15,105,58,47,0,0,0
2022-05-12 10:30,117,71,46,0,0,0
2022-05-12 10:45,126,62,64,0,0,0
2022-05-12 11:00,122,58,64,0,0,0
2022-05-12 11:15,134,69,65,0,0,0
2022-05-12 11:30,121,61,60,0,0,0
2022-05-12 11:45,142,67,75,0,0,0
2022-05-12 12:00,128,55,73,0,0,0
2022-05-12 12:15,134,51,83,0,0,0
2022-05-12 12:30,173,82,91,0,0,0
2022-05-12 12:45,128,57,71,0,0,0
2022-05-12 13:00,150,54,96,0,0,0
2022-05-12 13:15,143,49,94,0,0,0
2022-05-12 13:30,138,61,77,0,0,0
2022-05-12 13:45,188,90,98,0,0,0
2022-05-12 14:00,183,85,98,0,0,0
2022-05-12 14:15,141,60,81,0,0,0
2022-05-12 14:30,144,54,90,0,0,0
2022-05-12 14:45,190,84,106,0,0,0
2022-05-12 15:00,160,70,90,0,0,0
2022-05-12 15:15,177,74,103,0,0,0
2022-05-12 15:30,178,70,108,0,0,0
2022-05-12 15:45,240,84,156,0,0,0
2022-05-12 16:00,208,75,133,0,0,0
2022-05-12 16:15,217,94,123,0,0,0
2022-05-12 16:30,234,88,146,0,0,0
2022-05-12 16:45,211,102,109,0,0,0
2022-05-12 17:00,226,93,133,0,0,0
2022-05-12 17:15,234,97,137,0,0,0
2022-05-12 17:30,209,82,127,0,0,0
2022-05-12 17:45,215,81,134,0,0,0
2022-05-12 18:00,256,94,162,0,0,0
2022-05-12 18:15,197,88,109,0,0,0
2022-05-12 18:30,144,54,90,0,0,0
2022-05-12 18:45,202,82,120,0,0,0
2022-05-12 19:00,133,59,74,0,0,0
2022-05-12 19:15,124,51,73,0,0,0
2022-05-12 19:30,104,37,67,0,0,0
2022-05-12 19:45,154,60,94,0,0,0
2022-05-12 20:00,106,42,64,0,0,0
2022-05-12 20:15,110,38,72,0,0,0
2022-05-12 20:30,73,26,47,0,0,0
2022-05-12 20:45,70,32,38,0,0,0
2022-05-12 21:00,69,32,37,0,0,0
2022-05-12 21:15,49,15,34,0,0,0
2022-05-12 21:30,51,8,43,0,0,0
2022-05-12 21:45,70,23,47,0,0,0
2022-05-12 22:00,77,24,53,0,0,0
2022-05-12 22:15,67,16,51,0,0,0
2022-05-12 22:30,78,24,54,0,0,0
2022-05-12 22:45,63,21,42,0,0,0
2022-05-12 23:00,42,14,28,0,0,0
2022-05-12 23:15,43,9,34,0,0,0
2022-05-12 23:30,37,19,18,0,0,0
2022-05-12 23:45,30,5,25,0,0,0
2022-05-13 00:00,20,8,12,0,0,0
2022-05-13 00:15,6,1,5,0,0,0
2022-05-13 00:30,6,5,1,0,0,0
2022-05-13 00:45,17,5,12,0,0,0
2022-05-13 01:00,10,7,3,0,0,0
2022-05-13 01:15,9,1,8,0,0,0
2022-05-13 01:30,7,2,5,0,0,0
2022-05-13 01:45,10,1,9,0,0,0
2022-05-13 02:00,1,0,1,0,0,0
2022-05-13 02:15,3,0,3,0,0,0
2022-05-13 02:30,1,0,1,0,0,0
2022-05-13 02:45,1,0,1,0,0,0
2022-05-13 03:00,0,0,0,0,0,0
2022-05-13 03:15,0,0,0,0,0,0
2022-05-13 03:30,3,0,3,0,0,0
2022-05-13 03:45,2,1,1,0,0,0
2022-05-13 04:00,3,1,2,0,0,0
2022-05-13 04:15,1,1,0,0,0,0
2022-05-13 04:30,5,3,2,0,0,0
2022-05-13 04:45,6,4,2,0,0,0
2022-05-13 05:00,2,1,1,0,0,0
2022-05-13 05:15,8,5,3,0,0,0
2022-05-13 05:30,17,15,2,0,0,0
2022-05-13 05:45,19,16,3,0,0,0
2022-05-13 06:00,31,23,8,0,0,0
2022-05-13 06:15,38,27,11,0,0,0
2022-05-13 06:30,31,18,13,0,0,0
2022-05-13 06:45,69,39,30,0,0,0
2022-05-13 07:00,73,46,27,0,0,0
2022-05-13 07:15,122,73,49,0,0,0
2022-05-13 07:30,170,98,72,0,0,0
2022-05-13 07:45,158,106,52,0,0,0
2022-05-13 08:00,132,78,54,0,0,0
2022-05-13 08:15,141,87,54,0,0,0
2022-05-13 08:30,115,75,40,0,0,0
2022-05-13 08:45,151,94,57,0,0,0
2022-05-13 09:00,122,68,54,0,0,0
2022-05-13 09:15,98,63,35,0,0,0
2022-05-13 09:30,116,76,40,0,0,0
2022-05-13 09:45,130,86,44,0,0,0
2022-05-13 10:00,105,53,52,0,0,0
2022-05-13 10:15,108,59,49,0,0,0
2022-05-13 10:30,111,66,45,0,0,0
2022-05-13 10:45,121,48,73,0,0,0
2022-05-13 11:00,102,59,43,0,0,0
2022-05-13 11:15,143,71,72,0,0,0
2022-05-13 11:30,109,43,66,0,0,0
2022-05-13 11:45,147,74,73,0,0,0
2022-05-13 12:00,156,76,80,0,0,0
2022-05-13 12:15,168,81,87,0,0,0
2022-05-13 12:30,189,88,101,0,0,0
2022-05-13 12:45,174,73,101,0,0,0
2022-05-13 13:00,161,45,116,0,0,0
2022-05-13 13:15,162,60,102,0,0,0
2022-05-13 13:30,186,75,111,0,0,0
2022-05-13 13:45,193,83,110,0,0,0
2022-05-13 14:00,187,83,104,0,0,0
2022-05-13 14:15,174,77,97,0,0,0
2022-05-13 14:30,187,74,113,0,0,0
2022-05-13 14:45,209,92,117,0,0,0
2022-05-13 15:00,160,73,87,0,0,0
2022-05-13 15:15,164,64,100,0,0,0
2022-05-13 15:30,197,93,104,0,0,0
2022-05-13 15:45,183,74,109,0,0,0
2022-05-13 16:00,206,85,121,0,0,0
2022-05-13 16:15,181,80,101,0,0,0
2022-05-13 16:30,179,77,102,0,0,0
2022-05-13 16:45,173,84,89,0,0,0
2022-05-13 17:00,164,67,97,0,0,0
2022-05-13 17:15,143,71,72,0,0,0
2022-05-13 17:30,156,67,89,0,0,0
2022-05-13 17:45,224,103,121,0,0,0
2022-05-13 18:00,161,49,112,0,0,0
2022-05-13 18:15,162,62,100,0,0,0
2022-05-13 18:30,135,39,96,0,0,0
2022-05-13 18:45,143,53,90,0,0,0
2022-05-13 19:00,140,63,77,0,0,0
2022-05-13 19:15,152,77,75,0,0,0
2022-05-13 19:30,118,51,67,0,0,0
2022-05-13 19:45,141,61,80,0,0,0
2022-05-13 20:00,110,47,63,0,0,0
2022-05-13 20:15,89,39,50,0,0,0
2022-05-13 20:30,89,35,54,0,0,0
2022-05-13 20:45,73,38,35,0,0,0
2022-05-13 21:00,68,26,42,0,0,0
2022-05-13 21:15,75,29,46,0,0,0
2022-05-13 21:30,65,33,32,0,0,0
2022-05-13 21:45,72,36,36,0,0,0
2022-05-13 22:00,58,23,35,0,0,0
2022-05-13 22:15,56,27,29,0,0,0
2022-05-13 22:30,60,27,33,0,0,0
2022-05-13 22:45,49,18,31,0,0,0
2022-05-13 23:00,52,20,32,0,0,0
2022-05-13 23:15,61,9,52,0,0,0
2022-05-13 23:30,57,12,45,0,0,0
2022-05-13 23:45,36,12,24,0,0,0
2022-05-14 00:00,38,17,21,0,0,0
2022-05-14 00:15,38,14,24,0,0,0
2022-05-14 00:30,30,12,18,0,0,0
2022-05-14 00:45,31,12,19,0,0,0
2022-05-14 01:00,31,11,20,0,0,0
2022-05-14 01:15,24,5,19,0,0,0
2022-05-14 01:30,16,13,3,0,0,0
2022-05-14 01:45,19,8,11,0,0,0
2022-05-14 02:00,14,8,6,0,0,0
2022-05-14 02:15,19,5,14,0,0,0
2022-05-14 02:30,13,6,7,0,0,0
2022-05-14 02:45,10,1,9,0,0,0
2022-05-14 03:00,11,3,8,0,0,0
2022-05-14 03:15,9,0,9,0,0,0
2022-05-14 03:30,13,2,11,0,0,0
2022-05-14 03:45,13,3,10,0,0,0
2022-05-14 04:00,6,4,2,0,0,0
2022-05-14 04:15,2,0,2,0,0,0
2022-05-14 04:30,6,3,3,0,0,0
2022-05-14 04:45,8,2,6,0,0,0
2022-05-14 05:00,8,1,7,0,0,0
2022-05-14 05:15,5,1,4,0,0,0
2022-05-14 05:30,14,9,5,0,0,0
2022-05-14 05:45,14,10,4,0,0,0
2022-05-14 06:00,12,6,6,0,0,0
2022-05-14 06:15,15,8,7,0,0,0
2022-05-14 06:30,7,3,4,0,0,0
2022-05-14 06:45,10,6,4,0,0,0
2022-05-14 07:00,12,10,2,0,0,0
2022-05-14 07:15,28,20,8,0,0,0
2022-05-14 07:30,28,18,10,0,0,0
2022-05-14 07:45,37,19,18,0,0,0
2022-05-14 08:00,28,16,12,0,0,0
2022-05-14 08:15,35,17,18,0,0,0
2022-05-14 08:30,44,32,12,0,0,0
2022-05-14 08:45,64,50,14,0,0,0
2022-05-14 09:00,66,47,19,0,0,0
2022-05-14 09:15,85,55,30,0,0,0
2022-05-14 09:30,103,64,39,0,0,0
2022-05-14 09:45,127,92,35,0,0,0
2022-05-14 10:00,115,65,50,0,0,0
2022-05-14 10:15,138,74,64,0,0,0
2022-05-14 10:30,142,81,61,0,0,0
2022-05-14 10:45,149,95,54,0,0,0
2022-05-14 11:00,133,70,63,0,0,0
2022-05-14 11:15,113,56,57,0,0,0
2022-05-14 11:30,211,96,115,0,0,0
2022-05-14 11:45,252,106,146,0,0,0
2022-05-14 12:00,225,79,146,0,0,0
2022-05-14 12:15,287,82,205,0,0,0
2022-05-14 12:30,253,74,179,0,0,0
2022-05-14 12:45,311,92,219,0,0,0
2022-05-14 13:00,263,84,179,0,0,0
2022-05-14 13:15,259,77,182,0,0,0
2022-05-14 13:30,163,72,91,0,0,0
2022-05-14 13:45,159,72,87,0,0,0
2022-05-14 14:00,189,88,101,0,0,0
2022-05-14 14:15,182,72,110,0,0,0
2022-05-14 14:30,188,86,102,0,0,0
2022-05-14 14:45,184,88,96,0,0,0
2022-05-14 15:00,194,109,85,0,0,0
2022-05-14 15:15,204,128,76,0,0,0
2022-05-14 15:30,171,94,77,0,0,0
2022-05-14 15:45,177,98,79,0,0,0
2022-05-14 16:00,216,141,75,0,0,0
2022-05-14 16:15,306,237,69,0,0,0
2022-05-14 16:30,288,212,76,0,0,0
2022-05-14 16:45,223,157,66,0,0,0
2022-05-14 17:00,199,126,73,0,0,0
2022-05-14 17:15,193,86,107,0,0,0
2022-05-14 17:30,153,82,71,0,0,0
2022-05-14 17:45,208,99,109,0,0,0
2022-05-14 18:00,219,98,121,0,0,0
2022-05-14 18:15,216,95,121,0,0,0
2022-05-14 18:30,153,49,104,0,0,0
2022-05-14 18:45,157,83,74,0,0,0
2022-05-14 19:00,144,66,78,0,0,0
2022-05-14 19:15,115,53,62,0,0,0
2022-05-14 19:30,146,62,84,0,0,0
2022-05-14 19:45,110,48,62,0,0,0
2022-05-14 20:00,104,44,60,0,0,0
2022-05-14 20:15,86,24,62,0,0,0
2022-05-14 20:30,81,30,51,0,0,0
2022-05-14 20:45,79,32,47,0,0,0
2022-05-14 21:00,60,23,37,0,0,0
2022-05-14 21:15,66,27,39,0,0,0
2022-05-14 21:30,53,16,37,0,0,0
2022-05-14 21:45,78,26,52,0,0,0
2022-05-14 22:00,74,20,54,0,0,0
2022-05-14 22:15,63,30,33,0,0,0
2022-05-14 22:30,62,26,36,0,0,0
2022-05-14 22:45,71,21,50,0,0,0
2022-05-14 23:00,62,34,28,0,0,0
2022-05-14 23:15,47,18,29,0,0,0
2022-05-14 23:30,42,7,35,0,0,0
2022-05-14 23:45,33,15,18,0,0,0
2022-05-15 00:00,50,18,32,0,0,0
2022-05-15 00:15,45,24,21,0,0,0
2022-05-15 00:30,38,12,26,0,0,0
2022-05-15 00:45,23,9,14,0,0,0
2022-05-15 01:00,32,13,19,0,0,0
2022-05-15 01:15,33,12,21,0,0,0
2022-05-15 01:30,35,10,25,0,0,0
2022-05-15 01:45,31,12,19,0,0,0
2022-05-15 02:00,23,12,11,0,0,0
2022-05-15 02:15,10,5,5,0,0,0
2022-05-15 02:30,12,4,8,0,0,0
2022-05-15 02:45,17,7,10,0,0,0
2022-05-15 03:00,6,2,4,0,0,0
2022-05-15 03:15,14,8,6,0,0,0
2022-05-15 03:30,8,5,3,0,0,0
2022-05-15 03:45,9,3,6,0,0,0
2022-05-15 04:00,7,4,3,0,0,0
2022-05-15 04:15,5,2,3,0,0,0
2022-05-15 04:30,6,0,6,0,0,0
2022-05-15 04:45,3,1,2,0,0,0
2022-05-15 05:00,6,0,6,0,0,0
2022-05-15 05:15,9,3,6,0,0,0
2022-05-15 05:30,6,1,5,0,0,0
2022-05-15 05:45,8,6,2,0,0,0
2022-05-15 06:00,5,2,3,0,0,0
2022-05-15 06:15,5,1,4,0,0,0
2022-05-15 06:30,3,0,3,0,0,0
2022-05-15 06:45,5,2,3,0,0,0
2022-05-15 07:00,12,5,7,0,0,0
2022-05-15 07:15,13,8,5,0,0,0
2022-05-15 07:30,8,3,5,0,0,0
2022-05-15 07:45,10,7,3,0,0,0
2022-05-15 08:00,12,4,8,0,0,0
2022-05-15 08:15,10,4,6,0,0,0
2022-05-15 08:30,22,15,7,0,0,0
2022-05-15 08:45,37,19,18,0,0,0
2022-05-15 09:00,31,21,10,0,0,0
2022-05-15 09:15,33,18,15,0,0,0
2022-05-15 09:30,31,11,20,0,0,0
2022-05-15 09:45,65,38,27,0,0,0
2022-05-15 10:00,33,18,15,0,0,0
2022-05-15 10:15,45,19,26,0,0,0
2022-05-15 10:30,57,32,25,0,0,0
2022-05-15 10:45,49,34,15,0,0,0
2022-05-15 11:00,57,28,29,0,0,0
2022-05-15 11:15,70,37,33,0,0,0
2022-05-15 11:30,50,30,20,0,0,0
2022-05-15 11:45,74,48,26,0,0,0
2022-05-15 12:00,79,37,42,0,0,0
2022-05-15 12:15,72,32,40,0,0,0
2022-05-15 12:30,79,40,39,0,0,0
2022-05-15 12:45,79,42,37,0,0,0
2022-05-15 13:00,98,44,54,0,0,0
2022-05-15 13:15,99,46,53,0,0,0
2022-05-15 13:30,76,44,32,0,0,0
2022-05-15 13:45,83,37,46,0,0,0
2022-05-15 14:00,86,33,53,0,0,0
2022-05-15 14:15,77,40,37,0,0,0
2022-05-15 14:30,128,54,74,0,0,0
2022-05-15 14:45,131,57,74,0,0,0
2022-05-15 15:00,86,39,47,0,0,0
2022-05-15 15:15,115,50,65,0,0,0
2022-05-15 15:30,94,43,51,0,0,0
2022-05-15 15:45,111,50,61,0,0,0
2022-05-15 16:00,106,48,58,0,0,0
2022-05-15 16:15,102,50,52,0,0,0
2022-05-15 16:30,120,45,75,0,0,0
2022-05-15 16:45,121,44,77,0,0,0
2022-05-15 17:00,122,67,55,0,0,0
2022-05-15 17:15,110,57,53,0,0,0
2022-05-15 17:30,136,63,73,0,0,0
2022-05-15 17:45,136,69,67,0,0,0
2022-05-15 18:00,97,52,45,0,0,0
2022-05-15 18:15,95,42,53,0,0,0
2022-05-15 18:30,117,63,54,0,0,0
2022-05-15 18:45,93,51,42,0,0,0
2022-05-15 19:00,81,30,51,0,0,0
2022-05-15 19:15,84,41,43,0,0,0
2022-05-15 19:30,91,42,49,0,0,0
2022-05-15 19:45,89,37,52,0,0,0
2022-05-15 20:00,76,40,36,0,0,0
2022-05-15 20:15,75,29,46,0,0,0
2022-05-15 20:30,62,25,37,0,0,0
2022-05-15 20:45,46,21,25,0,0,0
2022-05-15 21:00,34,16,18,0,0,0
2022-05-15 21:15,51,22,29,0,0,0
2022-05-15 21:30,58,30,28,0,0,0
2022-05-15 21:45,39,6,33,0,0,0
2022-05-15 22:00,44,11,33,0,0,0
2022-05-15 22:15,29,6,23,0,0,0
2022-05-15 22:30,19,6,13,0,0,0
2022-05-15 22:45,26,4,22,0,0,0
2022-05-15 23:00,22,6,16,0,0,0
2022-05-15 23:15,9,2,7,0,0,0
2022-05-15 23:30,21,7,14,0,0,0
2022-05-15 23:45,19,6,13,0,0,0
2022-05-16 00:00,7,2,5,0,0,0
2022-05-16 00:15,9,2,7,0,0,0
2022-05-16 00:30,3,1,2,0,0,0
2022-05-16 00:45,2,0,2,0,0,0
2022-05-16 01:00,0,0,0,0,0,0
2022-05-16 01:15,2,0,2,0,0,0
2022-05-16 01:30,1,0,1,0,0,0
2022-05-16 01:45,0,0,0,0,0,0
2022-05-16 02:00,3,2,1,0,0,0
2022-05-16 02:15,1,0,1,0,0,0
2022-05-16 02:30,1,0,1,0,0,0
2022-05-16 02:45,1,1,0,0,0,0
2022-05-16 03:00,0,0,0,0,0,0
2022-05-16 03:15,2,2,0,0,0,0
2022-05-16 03:30,0,0,0,0,0,0
2022-05-16 03:45,1,1,0,0,0,0
2022-05-16 04:00,1,1,0,0,0,0
2022-05-16 04:15,2,1,1,0,0,0
2022-05-16 04:30,5,2,3,0,0,0
2022-05-16 04:45,5,4,1,0,0,0
2022-05-16 05:00,2,2,0,0,0,0
2022-05-16 05:15,6,4,2,0,0,0
2022-05-16 05:30,22,14,8,0,0,0
2022-05-16 05:45,19,17,2,0,0,0
2022-05-16 06:00,16,12,4,0,0,0
2022-05-16 06:15,35,27,8,0,0,0
2022-05-16 06:30,47,26,21,0,0,0
2022-05-16 06:45,58,37,21,0,0,0
2022-05-16 07:00,73,41,32,0,0,0
2022-05-16 07:15,126,76,50,0,0,0
2022-05-16 07:30,165,91,74,0,0,0
2022-05-16 07:45,172,114,58,0,0,0
2022-05-16 08:00,136,81,55,0,0,0
2022-05-16 08:15,162,108,54,0,0,0
2022-05-16 08:30,120,73,47,0,0,0
2022-05-16 08:45,148,105,43,0,0,0
2022-05-16 09:00,116,66,50,0,0,0
2022-05-16 09:15,112,71,41,0,0,0
2022-05-16 09:30,109,77,32,0,0,0
2022-05-16 09:45,141,92,49,0,0,0
2022-05-16 10:00,120,79,41,0,0,0
2022-05-16 10:15,93,65,28,0,0,0
2022-05-16 10:30,99,63,36,0,0,0
2022-05-16 10:45,123,62,61,0,0,0
2022-05-16 11:00,101,55,46,0,0,0
2022-05-16 11:15,110,61,49,0,0,0
2022-05-16 11:30,106,45,61,0,0,0
2022-05-16 11:45,136,68,68,0,0,0
2022-05-16 12:00,135,65,70,0,0,0
2022-05-16 12:15,112,57,55,0,0,0
2022-05-16 12:30,147,69,78,0,0,0
2022-05-16 12:45,140,59,81,0,0,0
2022-05-16 13:00,158,75,83,0,0,0
2022-05-16 13:15,141,58,83,0,0,0
2022-05-16 13:30,170,61,109,0,0,0
2022-05-16 13:45,161,74,87,0,0,0
2022-05-16 14:00,175,74,101,0,0,0
2022-05-16 14:15,123,47,76,0,0,0
2022-05-16 14:30,127,56,71,0,0,0
2022-05-16 14:45,151,64,87,0,0,0
2022-05-16 15:00,154,77,77,0,0,0
2022-05-16 15:15,163,86,77,0,0,0
2022-05-16 15:30,156,62,94,0,0,0
2022-05-16 15:45,203,89,114,0,0,0
2022-05-16 16:00,196,57,139,0,0,0
2022-05-16 16:15,168,59,109,0,0,0
2022-05-16 16:30,132,49,83,0,0,0
2022-05-16 16:45,128,57,71,0,0,0
2022-05-16 17:00,151,50,101,0,0,0
2022-05-16 17:15,165,67,98,0,0,0
2022-05-16 17:30,149,58,91,0,0,0
2022-05-16 17:45,160,70,90,0,0,0
2022-05-16 18:00,168,65,103,0,0,0
2022-05-16 18:15,110,31,79,0,0,0
2022-05-16 18:30,103,24,79,0,0,0
2022-05-16 18:45,113,49,64,0,0,0
2022-05-16 19:00,88,29,59,0,0,0
2022-05-16 19:15,89,28,61,0,0,0
2022-05-16 19:30,79,30,49,0,0,0
2022-05-16 19:45,94,31,63,0,0,0
2022-05-16 20:00,89,26,63,0,0,0
2022-05-16 20:15,61,30,31,0,0,0
2022-05-16 20:30,56,27,29,0,0,0
2022-05-16 20:45,40,15,25,0,0,0
2022-05-16 21:00,39,16,23,0,0,0
2022-05-16 21:15,54,18,36,0,0,0
2022-05-16 21:30,43,14,29,0,0,0
2022-05-16 21:45,45,15,30,0,0,0
2022-05-16 22:00,48,15,33,0,0,0
2022-05-16 22:15,33,8,25,0,0,0
2022-05-16 22:30,36,11,25,0,0,0
2022-05-16 22:45,24,4,20,0,0,0
2022-05-16 23:00,24,2,22,0,0,0
2022-05-16 23:15,20,6,14,0,0,0
2022-05-16 23:30,20,3,17,0,0,0
2022-05-16 23:45,15,10,5,0,0,0
2022-05-17 00:00,7,1,6,0,0,0
2022-05-17 00:15,11,1,10,0,0,0
2022-05-17 00:30,1,0,1,0,0,0
2022-05-17 00:45,4,0,4,0,0,0
2022-05-17 01:00,3,0,3,0,0,0
2022-05-17 01:15,5,2,3,0,0,0
2022-05-17 01:30,2,1,1,0,0,0
2022-05-17 01:45,2,0,2,0,0,0
2022-05-17 02:00,2,1,1,0,0,0
2022-05-17 02:15,0,0,0,0,0,0
2022-05-17 02:30,2,1,1,0,0,0
2022-05-17 02:45,1,0,1,0,0,0
2022-05-17 03:00,1,1,0,0,0,0
2022-05-17 03:15,0,0,0,0,0,0
2022-05-17 03:30,1,0,1,0,0,0
2022-05-17 03:45,1,1,0,0,0,0
2022-05-17 04:00,2,2,0,0,0,0
2022-05-17 04:15,1,0,1,0,0,0
2022-05-17 04:30,3,2,1,0,0,0
2022-05-17 04:45,5,3,2,0,0,0
2022-05-17 05:00,0,0,0,0,0,0
2022-05-17 05:15,7,6,1,0,0,0
2022-05-17 05:30,19,12,7,0,0,0
2022-05-17 05:45,20,16,4,0,0,0
2022-05-17 06:00,21,18,3,0,0,0
2022-05-17 06:15,41,31,10,0,0,0
2022-05-17 06:30,57,39,18,0,0,0
2022-05-17 06:45,78,46,32,0,0,0
2022-05-17 07:00,89,54,35,0,0,0
2022-05-17 07:15,143,81,62,0,0,0
2022-05-17 07:30,193,111,82,0,0,0
2022-05-17 07:45,172,128,44,0,0,0
2022-05-17 08:00,176,114,62,0,0,0
2022-05-17 08:15,168,103,65,0,0,0
2022-05-17 08:30,138,97,41,0,0,0
2022-05-17 08:45,141,105,36,0,0,0
2022-05-17 09:00,133,84,49,0,0,0
2022-05-17 09:15,102,63,39,0,0,0
2022-05-17 09:30,109,77,32,0,0,0
2022-05-17 09:45,145,95,50,0,0,0
2022-05-17 10:00,136,83,53,0,0,0
2022-05-17 10:15,99,61,38,0,0,0
2022-05-17 10:30,103,61,42,0,0,0
2022-05-17 10:45,110,63,47,0,0,0
2022-05-17 11:00,119,62,57,0,0,0
2022-05-17 11:15,145,70,75,0,0,0
2022-05-17 11:30,128,69,59,0,0,0
2022-05-17 11:45,140,77,63,0,0,0
2022-05-17 12:00,126,62,64,0,0,0
2022-05-17 12:15,137,54,83,0,0,0
2022-05-17 12:30,141,51,90,0,0,0
2022-05-17 12:45,153,76,77,0,0,0
2022-05-17 13:00,140,55,85,0,0,0
2022-05-17 13:15,136,58,78,0,0,0
2022-05-17 13:30,143,68,75,0,0,0
2022-05-17 13:45,168,79,89,0,0,0
2022-05-17 14:00,168,81,87,0,0,0
2022-05-17 14:15,181,74,107,0,0,0
2022-05-17 14:30,169,83,86,0,0,0
2022-05-17 14:45,183,92,91,0,0,0
2022-05-17 15:00,166,71,95,0,0,0
2022-05-17 15:15,172,81,91,0,0,0
2022-05-17 15:30,208,95,113,0,0,0
2022-05-17 15:45,208,109,99,0,0,0
2022-05-17 16:00,213,97,116,0,0,0
2022-05-17 16:15,229,100,129,0,0,0
2022-05-17 16:30,210,78,132,0,0,0
2022-05-17 16:45,221,95,126,0,0,0
2022-05-17 17:00,225,83,142,0,0,0
2022-05-17 17:15,221,84,137,0,0,0
2022-05-17 17:30,214,73,141,0,0,0
2022-05-17 17:45,241,87,154,0,0,0
2022-05-17 18:00,242,66,176,0,0,0
2022-05-17 18:15,170,62,108,0,0,0
2022-05-17 18:30,150,54,96,0,0,0
2022-05-17 18:45,171,74,97,0,0,0
2022-05-17 19:00,126,60,66,0,0,0
2022-05-17 19:15,134,41,93,0,0,0
2022-05-17 19:30,112,35,77,0,0,0
2022-05-17 19:45,137,44,93,0,0,0
2022-05-17 20:00,92,35,57,0,0,0
2022-05-17 20:15,104,42,62,0,0,0
2022-05-17 20:30,85,37,48,0,0,0
2022-05-17 20:45,62,26,36,0,0,0
2022-05-17 21:00,60,21,39,0,0,0
2022-05-17 21:15,74,26,48,0,0,0
2022-05-17 21:30,79,30,49,0,0,0
2022-05-17 21:45,52,11,41,0,0,0
2022-05-17 22:00,68,20,48,0,0,0
2022-05-17 22:15,46,12,34,0,0,0
2022-05-17 22:30,49,8,41,0,0,0
2022-05-17 22:45,62,18,44,0,0,0
2022-05-17 23:00,42,14,28,0,0,0
2022-05-17 23:15,39,13,26,0,0,0
2022-05-17 23:30,14,7,7,0,0,0
2022-05-17 23:45,31,9,22,0,0,0
2022-05-18 00:00,7,4,3,0,0,0
2022-05-18 00:15,17,4,13,0,0,0
2022-05-18 00:30,9,0,9,0,0,0
2022-05-18 00:45,12,3,9,0,0,0
2022-05-18 01:00,2,0,2,0,0,0
2022-05-18 01:15,8,3,5,0,0,0
2022-05-18 01:30,3,0,3,0,0,0
2022-05-18 01:45,5,0,5,0,0,0
2022-05-18 02:00,4,0,4,0,0,0
2022-05-18 02:15,1,1,0,0,0,0
2022-05-18 02:30,3,0,3,0,0,0
2022-05-18 02:45,1,1,0,0,0,0
2022-05-18 03:00,2,0,2,0,0,0
2022-05-18 03:15,2,0,2,0,0,0
2022-05-18 03:30,3,1,2,0,0,0
2022-05-18 03:45,2,1,1,0,0,0
2022-05-18 04:00,0,0,0,0,0,0
2022-05-18 04:15,2,1,1,0,0,0
2022-05-18 04:30,2,1,1,0,0,0
2022-05-18 04:45,7,6,1,0,0,0
2022-05-18 05:00,7,5,2,0,0,0
2022-05-18 05:15,11,7,4,0,0,0
2022-05-18 05:30,18,11,7,0,0,0
2022-05-18 05:45,16,15,1,0,0,0
2022-05-18 06:00,34,28,6,0,0,0
2022-05-18 06:15,47,34,13,0,0,0
2022-05-18 06:30,65,40,25,0,0,0
2022-05-18 06:45,90,55,35,0,0,0
2022-05-18 07:00,115,77,38,0,0,0
2022-05-18 07:15,149,95,54,0,0,0
2022-05-18 07:30,195,123,72,0,0,0
2022-05-18 07:45,222,149,73,0,0,0
2022-05-18 08:00,178,125,53,0,0,0
2022-05-18 08:15,177,117,60,0,0,0
2022-05-18 08:30,179,130,49,0,0,0
2022-05-18 08:45,175,115,60,0,0,0
2022-05-18 09:00,143,90,53,0,0,0
2022-05-18 09:15,122,77,45,0,0,0
2022-05-18 09:30,128,88,40,0,0,0
2022-05-18 09:45,157,102,55,0,0,0
2022-05-18 10:00,152,99,53,0,0,0
2022-05-18 10:15,132,73,59,0,0,0
2022-05-18 10:30,141,94,47,0,0,0
2022-05-18 10:45,149,83,66,0,0,0
2022-05-18 11:00,113,50,63,0,0,0
2022-05-18 11:15,128,60,68,0,0,0
2022-05-18 11:30,148,75,73,0,0,0
2022-05-18 11:45,196,100,96,0,0,0
2022-05-18 12:00,182,85,97,0,0,0
2022-05-18 12:15,177,71,106,0,0,0
2022-05-18 12:30,166,69,97,0,0,0
2022-05-18 12:45,130,61,69,0,0,0
2022-05-18 13:00,149,63,86,0,0,0
2022-05-18 13:15,177,62,115,0,0,0
2022-05-18 13:30,188,64,124,0,0,0
2022-05-18 13:45,175,59,116,0,0,0
2022-05-18 14:00,167,70,97,0,0,0
2022-05-18 14:15,178,53,125,0,0,0
2022-05-18 14:30,164,62,102,0,0,0
2022-05-18 14:45,184,93,91,0,0,0
2022-05-18 15:00,144,62,82,0,0,0
2022-05-18 15:15,171,58,113,0,0,0
2022-05-18 15:30,199,78,121,0,0,0
2022-05-18 15:45,205,90,115,0,0,0
2022-05-18 16:00,234,99,135,0,0,0
2022-05-18 16:15,209,92,117,0,0,0
2022-05-18 16:30,203,83,120,0,0,0
2022-05-18 16:45,183,75,108,0,0,0
2022-05-18 17:00,208,82,126,0,0,0
2022-05-18 17:15,234,102,132,0,0,0
2022-05-18 17:30,216,96,120,0,0,0
2022-05-18 17:45,194,74,120,0,0,0
2022-05-18 18:00,208,87,121,0,0,0
2022-05-18 18:15,211,95,116,0,0,0
2022-05-18 18:30,182,73,109,0,0,0
2022-05-18 18:45,194,73,121,0,0,0
2022-05-18 19:00,153,62,91,0,0,0
2022-05-18 19:15,125,63,62,0,0,0
2022-05-18 19:30,129,60,69,0,0,0
2022-05-18 19:45,154,53,101,0,0,0
2022-05-18 20:00,151,41,110,0,0,0
2022-05-18 20:15,113,40,73,0,0,0
2022-05-18 20:30,100,34,66,0,0,0
2022-05-18 20:45,103,33,70,0,0,0
2022-05-18 21:00,80,30,50,0,0,0
2022-05-18 21:15,97,39,58,0,0,0
2022-05-18 21:30,71,18,53,0,0,0
2022-05-18 21:45,71,27,44,0,0,0
2022-05-18 22:00,81,32,49,0,0,0
2022-05-18 22:15,63,24,39,0,0,0
2022-05-18 22:30,69,18,51,0,0,0
2022-05-18 22:45,37,9,28,0,0,0
2022-05-18 23:00,45,14,31,0,0,0
2022-05-18 23:15,65,23,42,0,0,0
2022-05-18 23:30,32,10,22,0,0,0
2022-05-18 23:45,29,10,19,0,0,0
2022-05-19 00:00,81,48,33,0,0,0
2022-05-19 00:15,62,25,37,0,0,0
2022-05-19 00:30,35,9,26,0,0,0
2022-05-19 00:45,22,8,14,0,0,0
2022-05-19 01:00,11,4,7,0,0,0
2022-05-19 01:15,16,5,11,0,0,0
2022-05-19 01:30,13,2,11,0,0,0
2022-05-19 01:45,8,3,5,0,0,0
2022-05-19 02:00,5,0,5,0,0,0
2022-05-19 02:15,8,1,7,0,0,0
2022-05-19 02:30,5,1,4,0,0,0
2022-05-19 02:45,4,1,3,0,0,0
2022-05-19 03:00,8,0,8,0,0,0
2022-05-19 03:15,2,0,2,0,0,0
2022-05-19 03:30,0,0,0,0,0,0
2022-05-19 03:45,5,1,4,0,0,0
2022-05-19 04:00,2,1,1,0,0,0
2022-05-19 04:15,6,3,3,0,0,0
2022-05-19 04:30,4,2,2,0,0,0
2022-05-19 04:45,9,7,2,0,0,0
2022-05-19 05:00,2,2,0,0,0,0
2022-05-19 05:15,9,6,3,0,0,0
2022-05-19 05:30,16,13,3,0,0,0
2022-05-19 05:45,19,16,3,0,0,0
2022-05-19 06:00,28,24,4,0,0,0
2022-05-19 06:15,37,28,9,0,0,0
2022-05-19 06:30,51,35,16,0,0,0
2022-05-19 06:45,57,34,23,0,0,0
2022-05-19 07:00,87,54,33,0,0,0
2022-05-19 07:15,139,88,51,0,0,0
2022-05-19 07:30,182,108,74,0,0,0
2022-05-19 07:45,193,134,59,0,0,0
2022-05-19 08:00,148,96,52,0,0,0
2022-05-19 08:15,164,101,63,0,0,0
2022-05-19 08:30,148,95,53,0,0,0
2022-05-19 08:45,164,112,52,0,0,0
2022-05-19 09:00,103,72,31,0,0,0
2022-05-19 09:15,107,73,34,0,0,0
2022-05-19 09:30,118,69,49,0,0,0
2022-05-19 09:45,118,73,45,0,0,0
2022-05-19 10:00,149,100,49,0,0,0
2022-05-19 10:15,138,85,53,0,0,0
2022-05-19 10:30,124,64,60,0,0,0
2022-05-19 10:45,163,91,72,0,0,0
2022-05-19 11:00,133,74,59,0,0,0
2022-05-19 11:15,107,62,45,0,0,0
2022-05-19 11:30,122,59,63,0,0,0
2022-05-19 11:45,147,83,64,0,0,0
2022-05-19 12:00,180,87,93,0,0,0
2022-05-19 12:15,146,54,92,0,0,0
2022-05-19 12:30,163,69,94,0,0,0
2022-05-19 12:45,171,79,92,0,0,0
2022-05-19 13:00,162,57,105,0,0,0
2022-05-19 13:15,150,74,76,0,0,0
2022-05-19 13:30,161,77,84,0,0,0
2022-05-19 13:45,166,87,79,0,0,0
2022-05-19 14:00,175,86,89,0,0,0
2022-05-19 14:15,149,63,86,0,0,0
2022-05-19 14:30,152,68,84,0,0,0
2022-05-19 14:45,150,73,77,0,0,0
2022-05-19 15:00,155,77,78,0,0,0
2022-05-19 15:15,174,84,90,0,0,0
2022-05-19 15:30,236,87,149,0,0,0
2022-05-19 15:45,139,52,87,0,0,0
2022-05-19 16:00,79,29,50,0,0,0
2022-05-19 16:15,73,29,44,0,0,0
2022-05-19 16:30,102,38,64,0,0,0
2022-05-19 16:45,134,40,94,0,0,0
2022-05-19 17:00,128,43,85,0,0,0
2022-05-19 17:15,150,45,105,0,0,0
2022-05-19 17:30,143,46,97,0,0,0
2022-05-19 17:45,142,64,78,0,0,0
2022-05-19 18:00,131,46,85,0,0,0
2022-05-19 18:15,139,48,91,0,0,0
2022-05-19 18:30,133,44,89,0,0,0
2022-05-19 18:45,131,72,59,0,0,0
2022-05-19 19:00,106,42,64,0,0,0
2022-05-19 19:15,101,42,59,0,0,0
2022-05-19 19:30,95,37,58,0,0,0
2022-05-19 19:45,107,43,64,0,0,0
2022-05-19 20:00,107,39,68,0,0,0
2022-05-19 20:15,78,27,51,0,0,0
2022-05-19 20:30,62,22,40,0,0,0
2022-05-19 20:45,59,26,33,0,0,0
2022-05-19 21:00,41,18,23,0,0,0
2022-05-19 21:15,58,29,29,0,0,0
2022-05-19 21:30,62,21,41,0,0,0
2022-05-19 21:45,62,14,48,0,0,0
2022-05-19 22:00,62,19,43,0,0,0
2022-05-19 22:15,55,13,42,0,0,0
2022-05-19 22:30,43,12,31,0,0,0
2022-05-19 22:45,53,20,33,0,0,0
2022-05-19 23:00,41,19,22,0,0,0
2022-05-19 23:15,40,12,28,0,0,0
2022-05-19 23:30,27,8,19,0,0,0
2022-05-19 23:45,37,12,25,0,0,0
2022-05-20 00:00,16,4,12,0,0,0
2022-05-20 00:15,22,10,12,0,0,0
2022-05-20 00:30,11,2,9,0,0,0
2022-05-20 00:45,10,1,9,0,0,0
2022-05-20 01:00,7,0,7,0,0,0
2022-05-20 01:15,8,2,6,0,0,0
2022-05-20 01:30,5,1,4,0,0,0
2022-05-20 01:45,7,2,5,0,0,0
2022-05-20 02:00,5,1,4,0,0,0
2022-05-20 02:15,2,0,2,0,0,0
2022-05-20 02:30,5,0,5,0,0,0
2022-05-20 02:45,12,2,10,0,0,0
2022-05-20 03:00,5,0,5,0,0,0
2022-05-20 03:15,5,2,3,0,0,0
2022-05-20 03:30,3,1,2,0,0,0
2022-05-20 03:45,7,3,4,0,0,0
2022-05-20 04:00,2,2,0,0,0,0
2022-05-20 04:15,5,2,3,0,0,0
2022-05-20 04:30,7,2,5,0,0,0
2022-05-20 04:45,5,4,1,0,0,0
2022-05-20 05:00,1,0,1,0,0,0
2022-05-20 05:15,5,5,0,0,0,0
2022-05-20 05:30,19,11,8,0,0,0
2022-05-20 05:45,15,10,5,0,0,0
2022-05-20 06:00,25,21,4,0,0,0
2022-05-20 06:15,32,27,5,0,0,0
2022-05-20 06:30,32,23,9,0,0,0
2022-05-20 06:45,49,25,24,0,0,0
2022-05-20 07:00,85,50,35,0,0,0
2022-05-20 07:15,115,72,43,0,0,0
2022-05-20 07:30,151,100,51,0,0,0
2022-05-20 07:45,154,100,54,0,0,0
2022-05-20 08:00,123,78,45,0,0,0
2022-05-20 08:15,132,86,46,0,0,0
2022-05-20 08:30,104,62,42,0,0,0
2022-05-20 08:45,148,92,56,0,0,0
2022-05-20 09:00,125,87,38,0,0,0
2022-05-20 09:15,108,65,43,0,0,0
2022-05-20 09:30,131,94,37,0,0,0
2022-05-20 09:45,128,83,45,0,0,0
2022-05-20 10:00,108,72,36,0,0,0
2022-05-20 10:15,120,61,59,0,0,0
2022-05-20 10:30,129,76,53,0,0,0
2022-05-20 10:45,141,74,67,0,0,0
2022-05-20 11:00,111,60,51,0,0,0
2022-05-20 11:15,130,70,60,0,0,0
2022-05-20 11:30,154,82,72,0,0,0
2022-05-20 11:45,170,87,83,0,0,0
2022-05-20 12:00,167,61,106,0,0,0
2022-05-20 12:15,135,61,74,0,0,0
2022-05-20 12:30,165,66,99,0,0,0
2022-05-20 12:45,173,85,88,0,0,0
2022-05-20 13:00,163,61,102,0,0,0
2022-05-20 13:15,157,57,100,0,0,0
2022-05-20 13:30,144,47,97,0,0,0
2022-05-20 13:45,172,71,101,0,0,0
2022-05-20 14:00,176,61,115,0,0,0
2022-05-20 14:15,158,69,89,0,0,0
2022-05-20 14:30,176,65,111,0,0,0
2022-05-20 14:45,174,58,116,0,0,0
2022-05-20 15:00,158,58,100,0,0,0
2022-05-20 15:15,183,56,127,0,0,0
2022-05-20 15:30,125,51,74,0,0,0
2022-05-20 15:45,124,36,88,0,0,0
2022-05-20 16:00,52,11,41,0,0,0
2022-05-20 16:15,23,9,14,0,0,0
2022-05-20 16:30,32,16,16,0,0,0
2022-05-20 16:45,72,32,40,0,0,0
2022-05-20 17:00,105,32,73,0,0,0
2022-05-20 17:15,59,24,35,0,0,0
2022-05-20 17:30,55,22,33,0,0,0
2022-05-20 17:45,73,34,39,0,0,0
2022-05-20 18:00,104,48,56,0,0,0
2022-05-20 18:15,107,48,59,0,0,0
2022-05-20 18:30,102,40,62,0,0,0
2022-05-20 18:45,101,54,47,0,0,0
2022-05-20 19:00,96,47,49,0,0,0
2022-05-20 19:15,80,41,39,0,0,0
2022-05-20 19:30,78,33,45,0,0,0
2022-05-20 19:45,88,38,50,0,0,0
2022-05-20 20:00,87,38,49,0,0,0
2022-05-20 20:15,90,33,57,0,0,0
2022-05-20 20:30,54,17,37,0,0,0
2022-05-20 20:45,52,24,28,0,0,0
2022-05-20 21:00,35,14,21,0,0,0
2022-05-20 21:15,48,21,27,0,0,0
2022-05-20 21:30,36,8,28,0,0,0
2022-05-20 21:45,38,14,24,0,0,0
2022-05-20 22:00,57,18,39,0,0,0
2022-05-20 22:15,41,20,21,0,0,0
2022-05-20 22:30,36,17,19,0,0,0
2022-05-20 22:45,25,11,14,0,0,0
2022-05-20 23:00,27,11,16,0,0,0
2022-05-20 23:15,46,25,21,0,0,0
2022-05-20 23:30,38,12,26,0,0,0
2022-05-20 23:45,37,13,24,0,0,0
2022-05-21 00:00,37,13,24,0,0,0
2022-05-21 00:15,23,9,14,0,0,0
2022-05-21 00:30,26,13,13,0,0,0
2022-05-21 00:45,33,9,24,0,0,0
2022-05-21 01:00,25,8,17,0,0,0
2022-05-21 01:15,13,5,8,0,0,0
2022-05-21 01:30,13,3,10,0,0,0
2022-05-21 01:45,20,10,10,0,0,0
2022-05-21 02:00,21,12,9,0,0,0
2022-05-21 02:15,15,9,6,0,0,0
2022-05-21 02:30,17,5,12,0,0,0
2022-05-21 02:45,13,5,8,0,0,0
2022-05-21 03:00,9,1,8,0,0,0
2022-05-21 03:15,15,1,14,0,0,0
2022-05-21 03:30,8,1,7,0,0,0
2022-05-21 03:45,4,1,3,0,0,0
2022-05-21 04:00,9,3,6,0,0,0
2022-05-21 04:15,6,0,6,0,0,0
2022-05-21 04:30,8,1,7,0,0,0
2022-05-21 04:45,3,2,1,0,0,0
2022-05-21 05:00,7,4,3,0,0,0
2022-05-21 05:15,6,2,4,0,0,0
2022-05-21 05:30,13,9,4,0,0,0
2022-05-21 05:45,7,4,3,0,0,0
2022-05-21 06:00,11,8,3,0,0,0
2022-05-21 06:15,8,7,1,0,0,0
2022-05-21 06:30,9,4,5,0,0,0
2022-05-21 06:45,14,13,1,0,0,0
2022-05-21 07:00,17,13,4,0,0,0
2022-05-21 07:15,25,22,3,0,0,0
2022-05-21 07:30,29,21,8,0,0,0
2022-05-21 07:45,33,23,10,0,0,0
2022-05-21 08:00,41,29,12,0,0,0
2022-05-21 08:15,51,37,14,0,0,0
2022-05-21 08:30,50,36,14,0,0,0
2022-05-21 08:45,70,42,28,0,0,0
2022-05-21 09:00,81,61,20,0,0,0
2022-05-21 09:15,88,66,22,0,0,0
2022-05-21 09:30,113,78,35,0,0,0
2022-05-21 09:45,141,93,48,0,0,0
2022-05-21 10:00,116,96,20,0,0,0
2022-05-21 10:15,131,79,52,0,0,0
2022-05-21 10:30,133,88,45,0,0,0
2022-05-21 10:45,129,91,38,0,0,0
2022-05-21 11:00,142,102,40,0,0,0
2022-05-21 11:15,128,69,59,0,0,0
2022-05-21 11:30,150,93,57,0,0,0
2022-05-21 11:45,176,95,81,0,0,0
2022-05-21 12:00,195,114,81,0,0,0
2022-05-21 12:15,160,74,86,0,0,0
2022-05-21 12:30,157,92,65,0,0,0
2022-05-21 12:45,197,91,106,0,0,0
2022-05-21 13:00,165,83,82,0,0,0
2022-05-21 13:15,157,82,75,0,0,0
2022-05-21 13:30,163,72,91,0,0,0
2022-05-21 13:45,190,104,86,0,0,0
2022-05-21 14:00,178,73,105,0,0,0
2022-05-21 14:15,174,84,90,0,0,0
2022-05-21 14:30,178,76,102,0,0,0
2022-05-21 14:45,185,80,105,0,0,0
2022-05-21 15:00,158,55,103,0,0,0
2022-05-21 15:15,147,50,97,0,0,0
2022-05-21 15:30,201,68,133,0,0,0
2022-05-21 15:45,249,60,189,0,0,0
2022-05-21 16:00,201,67,134,0,0,0
2022-05-21 16:15,178,56,122,0,0,0
2022-05-21 16:30,135,47,88,0,0,0
2022-05-21 16:45,119,59,60,0,0,0
2022-05-21 17:00,112,46,66,0,0,0
2022-05-21 17:15,124,62,62,0,0,0
2022-05-21 17:30,126,48,78,0,0,0
2022-05-21 17:45,115,46,69,0,0,0
2022-05-21 18:00,129,54,75,0,0,0
2022-05-21 18:15,121,53,68,0,0,0
2022-05-21 18:30,121,56,65,0,0,0
2022-05-21 18:45,132,51,81,0,0,0
2022-05-21 19:00,197,146,51,0,0,0
2022-05-21 19:15,183,124,59,0,0,0
2022-05-21 19:30,118,69,49,0,0,0
2022-05-21 19:45,122,58,64,0,0,0
2022-05-21 20:00,88,37,51,0,0,0
2022-05-21 20:15,73,25,48,0,0,0
2022-05-21 20:30,62,26,36,0,0,0
2022-05-21 20:45,76,46,30,0,0,0
2022-05-21 21:00,44,29,15,0,0,0
2022-05-21 21:15,53,29,24,0,0,0
2022-05-21 21:30,61,28,33,0,0,0
2022-05-21 21:45,42,14,28,0,0,0
2022-05-21 22:00,32,17,15,0,0,0
2022-05-21 22:15,37,14,23,0,0,0
2022-05-21 22:30,57,24,33,0,0,0
2022-05-21 22:45,57,33,24,0,0,0
2022-05-21 23:00,65,43,22,0,0,0
2022-05-21 23:15,71,27,44,0,0,0
2022-05-21 23:30,40,17,23,0,0,0
2022-05-21 23:45,55,29,26,0,0,0
2022-05-22 00:00,50,24,26,0,0,0
2022-05-22 00:15,36,16,20,0,0,0
2022-05-22 00:30,34,12,22,0,0,0
2022-05-22 00:45,40,12,28,0,0,0
2022-05-22 01:00,28,5,23,0,0,0
2022-05-22 01:15,27,9,18,0,0,0
2022-05-22 01:30,35,11,24,0,0,0
2022-05-22 01:45,24,11,13,0,0,0
2022-05-22 02:00,14,6,8,0,0,0
2022-05-22 02:15,17,5,12,0,0,0
2022-05-22 02:30,9,1,8,0,0,0
2022-05-22 02:45,16,7,9,0,0,0
2022-05-22 03:00,24,3,21,0,0,0
2022-05-22 03:15,15,4,11,0,0,0
2022-05-22 03:30,11,0,11,0,0,0
2022-05-22 03:45,6,3,3,0,0,0
2022-05-22 04:00,12,4,8,0,0,0
2022-05-22 04:15,8,1,7,0,0,0
2022-05-22 04:30,5,1,4,0,0,0
2022-05-22 04:45,11,3,8,0,0,0
2022-05-22 05:00,3,2,1,0,0,0
2022-05-22 05:15,8,6,2,0,0,0
2022-05-22 05:30,9,7,2,0,0,0
2022-05-22 05:45,8,6,2,0,0,0
2022-05-22 06:00,5,2,3,0,0,0
2022-05-22 06:15,12,2,10,0,0,0
2022-05-22 06:30,3,2,1,0,0,0
2022-05-22 06:45,10,6,4,0,0,0
2022-05-22 07:00,7,1,6,0,0,0
2022-05-22 07:15,4,3,1,0,0,0
2022-05-22 07:30,7,4,3,0,0,0
2022-05-22 07:45,12,7,5,0,0,0
2022-05-22 08:00,12,7,5,0,0,0
2022-05-22 08:15,14,4,10,0,0,0
2022-05-22 08:30,19,10,9,0,0,0
2022-05-22 08:45,26,12,14,0,0,0
2022-05-22 09:00,22,9,13,0,0,0
2022-05-22 09:15,24,14,10,0,0,0
2022-05-22 09:30,41,25,16,0,0,0
2022-05-22 09:45,76,59,17,0,0,0
2022-05-22 10:00,37,25,12,0,0,0
2022-05-22 10:15,54,23,31,0,0,0
2022-05-22 10:30,39,26,13,0,0,0
2022-05-22 10:45,64,44,20,0,0,0
2022-05-22 11:00,43,25,18,0,0,0
2022-05-22 11:15,58,34,24,0,0,0
2022-05-22 11:30,52,16,36,0,0,0
2022-05-22 11:45,79,39,40,0,0,0
2022-05-22 12:00,85,40,45,0,0,0
2022-05-22 12:15,80,47,33,0,0,0
2022-05-22 12:30,73,41,32,0,0,0
2022-05-22 12:45,83,44,39,0,0,0
2022-05-22 13:00,88,51,37,0,0,0
2022-05-22 13:15,99,59,40,0,0,0
2022-05-22 13:30,78,46,32,0,0,0
2022-05-22 13:45,112,60,52,0,0,0
2022-05-22 14:00,85,41,44,0,0,0
2022-05-22 14:15,96,49,47,0,0,0
2022-05-22 14:30,99,40,59,0,0,0
2022-05-22 14:45,137,73,64,0,0,0
2022-05-22 15:00,83,48,35,0,0,0
2022-05-22 15:15,83,34,49,0,0,0
2022-05-22 15:30,111,58,53,0,0,0
2022-05-22 15:45,76,29,47,0,0,0
2022-05-22 16:00,101,55,46,0,0,0
2022-05-22 16:15,96,37,59,0,0,0
2022-05-22 16:30,85,44,41,0,0,0
2022-05-22 16:45,106,51,55,0,0,0
2022-05-22 17:00,82,35,47,0,0,0
2022-05-22 17:15,98,35,63,0,0,0
2022-05-22 17:30,122,65,57,0,0,0
2022-05-22 17:45,118,52,66,0,0,0
2022-05-22 18:00,103,46,57,0,0,0
2022-05-22 18:15,113,59,54,0,0,0
2022-05-22 18:30,66,25,41,0,0,0
2022-05-22 18:45,88,39,49,0,0,0
2022-05-22 19:00,107,34,73,0,0,0
2022-05-22 19:15,69,23,46,0,0,0
2022-05-22 19:30,68,28,40,0,0,0
2022-05-22 19:45,65,27,38,0,0,0
2022-05-22 20:00,68,28,40,0,0,0
2022-05-22 20:15,71,29,42,0,0,0
2022-05-22 20:30,44,15,29,0,0,0
2022-05-22 20:45,42,14,28,0,0,0
2022-05-22 21:00,48,19,29,0,0,0
2022-05-22 21:15,60,16,44,0,0,0
2022-05-22 21:30,34,8,26,0,0,0
2022-05-22 21:45,29,10,19,0,0,0
2022-05-22 22:00,47,16,31,0,0,0
2022-05-22 22:15,30,14,16,0,0,0
2022-05-22 22:30,18,10,8,0,0,0
2022-05-22 22:45,26,17,9,0,0,0
2022-05-22 23:00,40,18,22,0,0,0
2022-05-22 23:15,17,8,9,0,0,0
2022-05-22 23:30,11,6,5,0,0,0
2022-05-22 23:45,5,3,2,0,0,0
2022-05-23 00:00,8,4,4,0,0,0
2022-05-23 00:15,8,1,7,0,0,0
2022-05-23 00:30,6,3,3,0,0,0
2022-05-23 00:45,5,4,1,0,0,0
2022-05-23 01:00,0,0,0,0,0,0
2022-05-23 01:15,5,2,3,0,0,0
2022-05-23 01:30,1,0,1,0,0,0
2022-05-23 01:45,2,1,1,0,0,0
2022-05-23 02:00,1,1,0,0,0,0
2022-05-23 02:15,3,1,2,0,0,0
2022-05-23 02:30,0,0,0,0,0,0
2022-05-23 02:45,1,0,1,0,0,0
2022-05-23 03:00,1,0,1,0,0,0
2022-05-23 03:15,0,0,0,0,0,0
2022-05-23 03:30,1,1,0,0,0,0
2022-05-23 03:45,2,0,2,0,0,0
2022-05-23 04:00,0,0,0,0,0,0
2022-05-23 04:15,5,4,1,0,0,0
2022-05-23 04:30,2,2,0,0,0,0
2022-05-23 04:45,4,3,1,0,0,0
2022-05-23 05:00,6,5,1,0,0,0
2022-05-23 05:15,8,6,2,0,0,0
2022-05-23 05:30,8,6,2,0,0,0
2022-05-23 05:45,18,16,2,0,0,0
2022-05-23 06:00,21,20,1,0,0,0
2022-05-23 06:15,50,36,14,0,0,0
2022-05-23 06:30,52,35,17,0,0,0
2022-05-23 06:45,62,33,29,0,0,0
2022-05-23 07:00,84,50,34,0,0,0
2022-05-23 07:15,146,94,52,0,0,0
2022-05-23 07:30,195,128,67,0,0,0
2022-05-23 07:45,163,103,60,0,0,0
2022-05-23 08:00,158,107,51,0,0,0
2022-05-23 08:15,141,81,60,0,0,0
2022-05-23 08:30,118,83,35,0,0,0
2022-05-23 08:45,128,80,48,0,0,0
2022-05-23 09:00,111,77,34,0,0,0
2022-05-23 09:15,93,57,36,0,0,0
2022-05-23 09:30,102,69,33,0,0,0
2022-05-23 09:45,138,100,38,0,0,0
2022-05-23 10:00,100,73,27,0,0,0
2022-05-23 10:15,112,67,45,0,0,0
2022-05-23 10:30,113,60,53,0,0,0
2022-05-23 10:45,115,69,46,0,0,0
2022-05-23 11:00,122,51,71,0,0,0
2022-05-23 11:15,121,60,61,0,0,0
2022-05-23 11:30,108,54,54,0,0,0
2022-05-23 11:45,153,73,80,0,0,0
2022-05-23 12:00,137,76,61,0,0,0
2022-05-23 12:15,140,65,75,0,0,0
2022-05-23 12:30,144,61,83,0,0,0
2022-05-23 12:45,170,66,104,0,0,0
2022-05-23 13:00,151,62,89,0,0,0
2022-05-23 13:15,126,62,64,0,0,0
2022-05-23 13:30,132,64,68,0,0,0
2022-05-23 13:45,188,86,102,0,0,0
2022-05-23 14:00,150,59,91,0,0,0
2022-05-23 14:15,128,47,81,0,0,0
2022-05-23 14:30,132,53,79,0,0,0
2022-05-23 14:45,161,66,95,0,0,0
2022-05-23 15:00,151,56,95,0,0,0
2022-05-23 15:15,161,65,96,0,0,0
2022-05-23 15:30,163,58,105,0,0,0
2022-05-23 15:45,188,72,116,0,0,0
2022-05-23 16:00,205,65,140,0,0,0
2022-05-23 16:15,180,69,111,0,0,0
2022-05-23 16:30,227,84,143,0,0,0
2022-05-23 16:45,206,88,118,0,0,0
2022-05-23 17:00,187,61,126,0,0,0
2022-05-23 17:15,209,72,137,0,0,0
2022-05-23 17:30,156,53,103,0,0,0
2022-05-23 17:45,170,61,109,0,0,0
2022-05-23 18:00,150,39,111,0,0,0
2022-05-23 18:15,146,44,102,0,0,0
2022-05-23 18:30,149,51,98,0,0,0
2022-05-23 18:45,132,42,90,0,0,0
2022-05-23 19:00,68,22,46,0,0,0
2022-05-23 19:15,70,25,45,0,0,0
2022-05-23 19:30,71,20,51,0,0,0
2022-05-23 19:45,66,21,45,0,0,0
2022-05-23 20:00,75,19,56,0,0,0
2022-05-23 20:15,50,17,33,0,0,0
2022-05-23 20:30,48,20,28,0,0,0
2022-05-23 20:45,40,17,23,0,0,0
2022-05-23 21:00,41,16,25,0,0,0
2022-05-23 21:15,46,24,22,0,0,0
2022-05-23 21:30,32,16,16,0,0,0
2022-05-23 21:45,46,11,35,0,0,0
2022-05-23 22:00,39,10,29,0,0,0
2022-05-23 22:15,27,9,18,0,0,0
2022-05-23 22:30,33,18,15,0,0,0
2022-05-23 22:45,34,22,12,0,0,0
2022-05-23 23:00,22,9,13,0,0,0
2022-05-23 23:15,29,9,20,0,0,0
2022-05-23 23:30,15,7,8,0,0,0
2022-05-23 23:45,10,4,6,0,0,0
2022-05-24 00:00,7,2,5,0,0,0
2022-05-24 00:15,12,6,6,0,0,0
2022-05-24 00:30,7,0,7,0,0,0
2022-05-24 00:45,3,0,3,0,0,0
2022-05-24 01:00,2,0,2,0,0,0
2022-05-24 01:15,1,0,1,0,0,0
2022-05-24 01:30,2,0,2,0,0,0
2022-05-24 01:45,2,0,2,0,0,0
2022-05-24 02:00,2,0,2,0,0,0
2022-05-24 02:15,1,0,1,0,0,0
2022-05-24 02:30,1,1,0,0,0,0
2022-05-24 02:45,0,0,0,0,0,0
2022-05-24 03:00,1,1,0,0,0,0
2022-05-24 03:15,1,0,1,0,0,0
2022-05-24 03:30,1,0,1,0,0,0
2022-05-24 03:45,1,1,0,0,0,0
2022-05-24 04:00,0,0,0,0,0,0
2022-05-24 04:15,3,3,0,0,0,0
2022-05-24 04:30,4,4,0,0,0,0
2022-05-24 04:45,5,4,1,0,0,0
2022-05-24 05:00,3,3,0,0,0,0
2022-05-24 05:15,7,4,3,0,0,0
2022-05-24 05:30,16,13,3,0,0,0
2022-05-24 05:45,14,12,2,0,0,0
2022-05-24 06:00,25,19,6,0,0,0
2022-05-24 06:15,41,34,7,0,0,0
2022-05-24 06:30,50,38,12,0,0,0
2022-05-24 06:45,64,36,28,0,0,0
2022-05-24 07:00,92,63,29,0,0,0
2022-05-24 07:15,128,82,46,0,0,0
2022-05-24 07:30,224,136,88,0,0,0
2022-05-24 07:45,211,147,64,0,0,0
2022-05-24 08:00,178,131,47,0,0,0
2022-05-24 08:15,165,108,57,0,0,0
2022-05-24 08:30,135,95,40,0,0,0
2022-05-24 08:45,138,98,40,0,0,0
2022-05-24 09:00,108,79,29,0,0,0
2022-05-24 09:15,59,37,22,0,0,0
2022-05-24 09:30,72,45,27,0,0,0
2022-05-24 09:45,101,74,27,0,0,0
2022-05-24 10:00,81,53,28,0,0,0
2022-05-24 10:15,86,49,37,0,0,0
2022-05-24 10:30,92,52,40,0,0,0
2022-05-24 10:45,89,47,42,0,0,0
2022-05-24 11:00,84,41,43,0,0,0
2022-05-24 11:15,104,61,43,0,0,0
2022-05-24 11:30,93,49,44,0,0,0
2022-05-24 11:45,114,63,51,0,0,0
2022-05-24 12:00,130,71,59,0,0,0
2022-05-24 12:15,137,59,78,0,0,0
2022-05-24 12:30,113,46,67,0,0,0
2022-05-24 12:45,121,48,73,0,0,0
2022-05-24 13:00,137,57,80,0,0,0
2022-05-24 13:15,151,66,85,0,0,0
2022-05-24 13:30,130,70,60,0,0,0
2022-05-24 13:45,155,82,73,0,0,0
2022-05-24 14:00,149,61,88,0,0,0
2022-05-24 14:15,152,76,76,0,0,0
2022-05-24 14:30,175,76,99,0,0,0
2022-05-24 14:45,161,83,78,0,0,0
2022-05-24 15:00,152,58,94,0,0,0
2022-05-24 15:15,173,65,108,0,0,0
2022-05-24 15:30,162,64,98,0,0,0
2022-05-24 15:45,188,87,101,0,0,0
2022-05-24 16:00,202,89,113,0,0,0
2022-05-24 16:15,216,89,127,0,0,0
2022-05-24 16:30,152,54,98,0,0,0
2022-05-24 16:45,140,57,83,0,0,0
2022-05-24 17:00,210,89,121,0,0,0
2022-05-24 17:15,153,59,94,0,0,0
2022-05-24 17:30,175,66,109,0,0,0
2022-05-24 17:45,196,87,109,0,0,0
2022-05-24 18:00,201,78,123,0,0,0
2022-05-24 18:15,155,41,114,0,0,0
2022-05-24 18:30,138,56,82,0,0,0
2022-05-24 18:45,150,65,85,0,0,0
2022-05-24 19:00,137,46,91,0,0,0
2022-05-24 19:15,133,56,77,0,0,0
2022-05-24 19:30,104,48,56,0,0,0
2022-05-24 19:45,128,49,79,0,0,0
2022-05-24 20:00,103,38,65,0,0,0
2022-05-24 20:15,99,35,64,0,0,0
2022-05-24 20:30,70,37,33,0,0,0
2022-05-24 20:45,73,33,40,0,0,0
2022-05-24 21:00,52,21,31,0,0,0
2022-05-24 21:15,59,23,36,0,0,0
2022-05-24 21:30,54,27,27,0,0,0
2022-05-24 21:45,56,19,37,0,0,0
2022-05-24 22:00,45,12,33,0,0,0
2022-05-24 22:15,72,22,50,0,0,0
2022-05-24 22:30,57,19,38,0,0,0
2022-05-24 22:45,43,17,26,0,0,0
2022-05-24 23:00,28,5,23,0,0,0
2022-05-24 23:15,33,14,19,0,0,0
2022-05-24 23:30,23,5,18,0,0,0
2022-05-24 23:45,22,6,16,0,0,0
2022-05-25 00:00,16,4,12,0,0,0
2022-05-25 00:15,13,6,7,0,0,0
2022-05-25 00:30,10,2,8,0,0,0
2022-05-25 00:45,10,1,9,0,0,0
2022-05-25 01:00,6,1,5,0,0,0
2022-05-25 01:15,9,2,7,0,0,0
2022-05-25 01:30,5,1,4,0,0,0
2022-05-25 01:45,0,0,0,0,0,0
2022-05-25 02:00,1,1,0,0,0,0
2022-05-25 02:15,0,0,0,0,0,0
2022-05-25 02:30,3,2,1,0,0,0
2022-05-25 02:45,1,1,0,0,0,0
2022-05-25 03:00,3,1,2,0,0,0
2022-05-25 03:15,2,1,1,0,0,0
2022-05-25 03:30,1,0,1,0,0,0
2022-05-25 03:45,2,2,0,0,0,0
2022-05-25 04:00,3,2,1,0,0,0
2022-05-25 04:15,4,3,1,0,0,0
2022-05-25 04:30,3,2,1,0,0,0
2022-05-25 04:45,4,4,0,0,0,0
2022-05-25 05:00,6,5,1,0,0,0
2022-05-25 05:15,8,6,2,0,0,0
2022-05-25 05:30,12,10,2,0,0,0
2022-05-25 05:45,19,15,4,0,0,0
2022-05-25 06:00,29,20,9,0,0,0
2022-05-25 06:15,36,29,7,0,0,0
2022-05-25 06:30,52,36,16,0,0,0
2022-05-25 06:45,64,43,21,0,0,0
2022-05-25 07:00,93,62,31,0,0,0
2022-05-25 07:15,144,90,54,0,0,0
2022-05-25 07:30,216,143,73,0,0,0
2022-05-25 07:45,189,128,61,0,0,0
2022-05-25 08:00,170,128,42,0,0,0
2022-05-25 08:15,163,114,49,0,0,0
2022-05-25 08:30,164,114,50,0,0,0
2022-05-25 08:45,172,119,53,0,0,0
2022-05-25 09:00,131,97,34,0,0,0
2022-05-25 09:15,128,74,54,0,0,0
2022-05-25 09:30,122,82,40,0,0,0
2022-05-25 09:45,167,103,64,0,0,0
2022-05-25 10:00,151,96,55,0,0,0
2022-05-25 10:15,110,66,44,0,0,0
2022-05-25 10:30,122,71,51,0,0,0
2022-05-25 10:45,169,100,69,0,0,0
2022-05-25 11:00,134,75,59,0,0,0
2022-05-25 11:15,132,69,63,0,0,0
2022-05-25 11:30,148,75,73,0,0,0
2022-05-25 11:45,185,100,85,0,0,0
2022-05-25 12:00,172,81,91,0,0,0
2022-05-25 12:15,174,83,91,0,0,0
2022-05-25 12:30,157,72,85,0,0,0
2022-05-25 12:45,182,74,108,0,0,0
2022-05-25 13:00,168,77,91,0,0,0
2022-05-25 13:15,161,62,99,0,0,0
2022-05-25 13:30,168,64,104,0,0,0
2022-05-25 13:45,179,82,97,0,0,0
2022-05-25 14:00,150,63,87,0,0,0
2022-05-25 14:15,181,59,122,0,0,0
2022-05-25 14:30,169,67,102,0,0,0
2022-05-25 14:45,199,91,108,0,0,0
2022-05-25 15:00,150,66,84,0,0,0
2022-05-25 15:15,178,63,115,0,0,0
2022-05-25 15:30,199,77,122,0,0,0
2022-05-25 15:45,196,94,102,0,0,0
2022-05-25 16:00,227,103,124,0,0,0
2022-05-25 16:15,203,87,116,0,0,0
2022-05-25 16:30,219,84,135,0,0,0
2022-05-25 16:45,219,95,124,0,0,0
2022-05-25 17:00,184,76,108,0,0,0
2022-05-25 17:15,209,79,130,0,0,0
2022-05-25 17:30,178,67,111,0,0,0
2022-05-25 17:45,199,76,123,0,0,0
2022-05-25 18:00,214,77,137,0,0,0
2022-05-25 18:15,173,68,105,0,0,0
2022-05-25 18:30,160,76,84,0,0,0
2022-05-25 18:45,167,71,96,0,0,0
2022-05-25 19:00,153,60,93,0,0,0
2022-05-25 19:15,131,66,65,0,0,0
2022-05-25 19:30,128,57,71,0,0,0
2022-05-25 19:45,154,60,94,0,0,0
2022-05-25 20:00,88,38,50,0,0,0
2022-05-25 20:15,124,47,77,0,0,0
2022-05-25 20:30,78,41,37,0,0,0
2022-05-25 20:45,78,40,38,0,0,0
2022-05-25 21:00,60,26,34,0,0,0
2022-05-25 21:15,56,16,40,0,0,0
2022-05-25 21:30,46,17,29,0,0,0
2022-05-25 21:45,68,24,44,0,0,0
2022-05-25 22:00,42,20,22,0,0,0
2022-05-25 22:15,48,13,35,0,0,0
2022-05-25 22:30,52,17,35,0,0,0
2022-05-25 22:45,60,18,42,0,0,0
2022-05-25 23:00,63,27,36,0,0,0
2022-05-25 23:15,39,12,27,0,0,0
2022-05-25 23:30,39,15,24,0,0,0
2022-05-25 23:45,58,23,35,0,0,0
2022-05-26 00:00,30,7,23,0,0,0
2022-05-26 00:15,45,12,33,0,0,0
2022-05-26 00:30,27,5,22,0,0,0
2022-05-26 00:45,29,13,16,0,0,0
2022-05-26 01:00,27,8,19,0,0,0
2022-05-26 01:15,23,6,17,0,0,0
2022-05-26 01:30,19,9,10,0,0,0
2022-05-26 01:45,21,11,10,0,0,0
2022-05-26 02:00,16,7,9,0,0,0
2022-05-26 02:15,27,4,23,0,0,0
2022-05-26 02:30,11,2,9,0,0,0
2022-05-26 02:45,15,2,13,0,0,0
2022-05-26 03:00,14,1,13,0,0,0
2022-05-26 03:15,6,3,3,0,0,0
2022-05-26 03:30,9,5,4,0,0,0
2022-05-26 03:45,9,0,9,0,0,0
2022-05-26 04:00,8,3,5,0,0,0
2022-05-26 04:15,2,0,2,0,0,0
2022-05-26 04:30,7,0,7,0,0,0
2022-05-26 04:45,10,1,9,0,0,0
2022-05-26 05:00,5,4,1,0,0,0
2022-05-26 05:15,4,4,0,0,0,0
2022-05-26 05:30,5,0,5,0,0,0
2022-05-26 05:45,11,7,4,0,0,0
2022-05-26 06:00,5,2,3,0,0,0
2022-05-26 06:15,4,1,3,0,0,0
2022-05-26 06:30,5,3,2,0,0,0
2022-05-26 06:45,5,3,2,0,0,0
2022-05-26 07:00,8,6,2,0,0,0
2022-05-26 07:15,4,2,2,0,0,0
2022-05-26 07:30,13,7,6,0,0,0
2022-05-26 07:45,16,12,4,0,0,0
2022-05-26 08:00,11,7,4,0,0,0
2022-05-26 08:15,22,14,8,0,0,0
2022-05-26 08:30,18,10,8,0,0,0
2022-05-26 08:45,33,14,19,0,0,0
2022-05-26 09:00,18,9,9,0,0,0
2022-05-26 09:15,31,19,12,0,0,0
2022-05-26 09:30,29,19,10,0,0,0
2022-05-26 09:45,41,27,14,0,0,0
2022-05-26 10:00,35,16,19,0,0,0
2022-05-26 10:15,30,20,10,0,0,0
2022-05-26 10:30,49,29,20,0,0,0
2022-05-26 10:45,58,28,30,0,0,0
2022-05-26 11:00,47,31,16,0,0,0
2022-05-26 11:15,50,29,21,0,0,0
2022-05-26 11:30,41,31,10,0,0,0
2022-05-26 11:45,47,20,27,0,0,0
2022-05-26 12:00,52,26,26,0,0,0
2022-05-26 12:15,61,35,26,0,0,0
2022-05-26 12:30,57,32,25,0,0,0
2022-05-26 12:45,79,43,36,0,0,0
2022-05-26 13:00,74,45,29,0,0,0
2022-05-26 13:15,62,27,35,0,0,0
2022-05-26 13:30,56,14,42,0,0,0
2022-05-26 13:45,75,37,38,0,0,0
2022-05-26 14:00,68,36,32,0,0,0
2022-05-26 14:15,70,33,37,0,0,0
2022-05-26 14:30,56,31,25,0,0,0
2022-05-26 14:45,72,37,35,0,0,0
2022-05-26 15:00,78,23,55,0,0,0
2022-05-26 15:15,77,40,37,0,0,0
2022-05-26 15:30,72,33,39,0,0,0
2022-05-26 15:45,97,57,40,0,0,0
2022-05-26 16:00,101,43,58,0,0,0
2022-05-26 16:15,67,38,29,0,0,0
2022-05-26 16:30,74,37,37,0,0,0
2022-05-26 16:45,91,41,50,0,0,0
2022-05-26 17:00,61,27,34,0,0,0
2022-05-26 17:15,76,32,44,0,0,0
2022-05-26 17:30,70,29,41,0,0,0
2022-05-26 17:45,78,47,31,0,0,0
2022-05-26 18:00,75,24,51,0,0,0
2022-05-26 18:15,87,32,55,0,0,0
2022-05-26 18:30,62,24,38,0,0,0
2022-05-26 18:45,85,41,44,0,0,0
2022-05-26 19:00,75,41,34,0,0,0
2022-05-26 19:15,89,37,52,0,0,0
2022-05-26 19:30,71,24,47,0,0,0
2022-05-26 19:45,54,21,33,0,0,0
2022-05-26 20:00,61,31,30,0,0,0
2022-05-26 20:15,48,13,35,0,0,0
2022-05-26 20:30,59,19,40,0,0,0
2022-05-26 20:45,40,15,25,0,0,0
2022-05-26 21:00,45,15,30,0,0,0
2022-05-26 21:15,36,17,19,0,0,0
2022-05-26 21:30,28,11,17,0,0,0
2022-05-26 21:45,47,11,36,0,0,0
2022-05-26 22:00,48,9,39,0,0,0
2022-05-26 22:15,39,5,34,0,0,0
2022-05-26 22:30,25,12,13,0,0,0
2022-05-26 22:45,23,9,14,0,0,0
2022-05-26 23:00,20,5,15,0,0,0
2022-05-26 23:15,23,10,13,0,0,0
2022-05-26 23:30,22,3,19,0,0,0
2022-05-26 23:45,18,5,13,0,0,0
2022-05-27 00:00,11,2,9,0,0,0
2022-05-27 00:15,15,5,10,0,0,0
2022-05-27 00:30,7,0,7,0,0,0
2022-05-27 00:45,12,2,10,0,0,0
2022-05-27 01:00,7,3,4,0,0,0
2022-05-27 01:15,8,2,6,0,0,0
2022-05-27 01:30,5,1,4,0,0,0
2022-05-27 01:45,5,4,1,0,0,0
2022-05-27 02:00,3,2,1,0,0,0
2022-05-27 02:15,3,1,2,0,0,0
2022-05-27 02:30,2,0,2,0,0,0
2022-05-27 02:45,1,0,1,0,0,0
2022-05-27 03:00,2,0,2,0,0,0
2022-05-27 03:15,0,0,0,0,0,0
2022-05-27 03:30,2,0,2,0,0,0
2022-05-27 03:45,1,0,1,0,0,0
2022-05-27 04:00,1,1,0,0,0,0
2022-05-27 04:15,6,2,4,0,0,0
2022-05-27 04:30,1,1,0,0,0,0
2022-05-27 04:45,0,0,0,0,0,0
2022-05-27 05:00,2,1,1,0,0,0
2022-05-27 05:15,5,3,2,0,0,0
2022-05-27 05:30,10,10,0,0,0,0
2022-05-27 05:45,9,9,0,0,0,0
2022-05-27 06:00,19,15,4,0,0,0
2022-05-27 06:15,19,14,5,0,0,0
2022-05-27 06:30,27,17,10,0,0,0
2022-05-27 06:45,35,18,17,0,0,0
2022-05-27 07:00,38,22,16,0,0,0
2022-05-27 07:15,54,32,22,0,0,0
2022-05-27 07:30,65,37,28,0,0,0
2022-05-27 07:45,87,57,30,0,0,0
2022-05-27 08:00,84,63,21,0,0,0
2022-05-27 08:15,74,52,22,0,0,0
2022-05-27 08:30,77,49,28,0,0,0
2022-05-27 08:45,108,83,25,0,0,0
2022-05-27 09:00,94,69,25,0,0,0
2022-05-27 09:15,85,57,28,0,0,0
2022-05-27 09:30,106,69,37,0,0,0
2022-05-27 09:45,128,85,43,0,0,0
2022-05-27 10:00,96,64,32,0,0,0
2022-05-27 10:15,133,96,37,0,0,0
2022-05-27 10:30,109,61,48,0,0,0
2022-05-27 10:45,120,73,47,0,0,0
2022-05-27 11:00,143,68,75,0,0,0
2022-05-27 11:15,145,80,65,0,0,0
2022-05-27 11:30,141,70,71,0,0,0
2022-05-27 11:45,157,88,69,0,0,0
2022-05-27 12:00,149,77,72,0,0,0
2022-05-27 12:15,158,87,71,0,0,0
2022-05-27 12:30,161,74,87,0,0,0
2022-05-27 12:45,148,67,81,0,0,0
2022-05-27 13:00,138,78,60,0,0,0
2022-05-27 13:15,186,87,99,0,0,0
2022-05-27 13:30,178,81,97,0,0,0
2022-05-27 13:45,157,74,83,0,0,0
2022-05-27 14:00,169,70,99,0,0,0
2022-05-27 14:15,151,64,87,0,0,0
2022-05-27 14:30,148,83,65,0,0,0
2022-05-27 14:45,171,82,89,0,0,0
2022-05-27 15:00,162,66,96,0,0,0
2022-05-27 15:15,172,94,78,0,0,0
2022-05-27 15:30,162,68,94,0,0,0
2022-05-27 15:45,197,76,121,0,0,0
2022-05-27 16:00,145,61,84,0,0,0
2022-05-27 16:15,167,80,87,0,0,0
2022-05-27 16:30,159,63,96,0,0,0
2022-05-27 16:45,161,63,98,0,0,0
2022-05-27 17:00,153,67,86,0,0,0
2022-05-27 17:15,147,66,81,0,0,0
2022-05-27 17:30,152,68,84,0,0,0
2022-05-27 17:45,156,66,90,0,0,0
2022-05-27 18:00,157,66,91,0,0,0
2022-05-27 18:15,165,68,97,0,0,0
2022-05-27 18:30,139,51,88,0,0,0
2022-05-27 18:45,128,55,73,0,0,0
2022-05-27 19:00,126,49,77,0,0,0
2022-05-27 19:15,105,46,59,0,0,0
2022-05-27 19:30,125,50,75,0,0,0
2022-05-27 19:45,89,45,44,0,0,0
2022-05-27 20:00,94,38,56,0,0,0
2022-05-27 20:15,87,40,47,0,0,0
2022-05-27 20:30,65,32,33,0,0,0
2022-05-27 20:45,56,21,35,0,0,0
2022-05-27 21:00,84,31,53,0,0,0
2022-05-27 21:15,50,23,27,0,0,0
2022-05-27 21:30,50,20,30,0,0,0
2022-05-27 21:45,41,18,23,0,0,0
2022-05-27 22:00,58,28,30,0,0,0
2022-05-27 22:15,33,14,19,0,0,0
2022-05-27 22:30,54,13,41,0,0,0
2022-05-27 22:45,43,18,25,0,0,0
2022-05-27 23:00,46,17,29,0,0,0
2022-05-27 23:15,55,25,30,0,0,0
2022-05-27 23:30,31,17,14,0,0,0
2022-05-27 23:45,39,17,22,0,0,0
2022-05-28 00:00,26,17,9,0,0,0
2022-05-28 00:15,28,7,21,0,0,0
2022-05-28 00:30,18,7,11,0,0,0
2022-05-28 00:45,22,6,16,0,0,0
2022-05-28 01:00,26,9,17,0,0,0
2022-05-28 01:15,13,1,12,0,0,0
2022-05-28 01:30,12,3,9,0,0,0
2022-05-28 01:45,11,0,11,0,0,0
2022-05-28 02:00,10,7,3,0,0,0
2022-05-28 02:15,25,4,21,0,0,0
2022-05-28 02:30,11,3,8,0,0,0
2022-05-28 02:45,9,3,6,0,0,0
2022-05-28 03:00,9,1,8,0,0,0
2022-05-28 03:15,8,1,7,0,0,0
2022-05-28 03:30,2,0,2,0,0,0
2022-05-28 03:45,8,1,7,0,0,0
2022-05-28 04:00,0,0,0,0,0,0
2022-05-28 04:15,2,0,2,0,0,0
2022-05-28 04:30,2,1,1,0,0,0
2022-05-28 04:45,4,2,2,0,0,0
2022-05-28 05:00,6,0,6,0,0,0
2022-05-28 05:15,4,1,3,0,0,0
2022-05-28 05:30,9,6,3,0,0,0
2022-05-28 05:45,11,10,1,0,0,0
2022-05-28 06:00,7,4,3,0,0,0
2022-05-28 06:15,8,5,3,0,0,0
2022-05-28 06:30,16,9,7,0,0,0
2022-05-28 06:45,10,6,4,0,0,0
2022-05-28 07:00,16,10,6,0,0,0
2022-05-28 07:15,12,11,1,0,0,0
2022-05-28 07:30,19,16,3,0,0,0
2022-05-28 07:45,31,21,10,0,0,0
2022-05-28 08:00,22,14,8,0,0,0
2022-05-28 08:15,31,17,14,0,0,0
2022-05-28 08:30,37,22,15,0,0,0
2022-05-28 08:45,57,41,16,0,0,0
2022-05-28 09:00,46,26,20,0,0,0
2022-05-28 09:15,77,58,19,0,0,0
2022-05-28 09:30,80,48,32,0,0,0
2022-05-28 09:45,114,92,22,0,0,0
2022-05-28 10:00,104,72,32,0,0,0
2022-05-28 10:15,127,85,42,0,0,0
2022-05-28 10:30,92,69,23,0,0,0
2022-05-28 10:45,132,83,49,0,0,0
2022-05-28 11:00,114,69,45,0,0,0
2022-05-28 11:15,124,74,50,0,0,0
2022-05-28 11:30,125,75,50,0,0,0
2022-05-28 11:45,184,98,86,0,0,0
2022-05-28 12:00,134,60,74,0,0,0
2022-05-28 12:15,117,62,55,0,0,0
2022-05-28 12:30,143,69,74,0,0,0
2022-05-28 12:45,151,93,58,0,0,0
2022-05-28 13:00,135,83,52,0,0,0
2022-05-28 13:15,150,80,70,0,0,0
2022-05-28 13:30,155,66,89,0,0,0
2022-05-28 13:45,132,62,70,0,0,0
2022-05-28 14:00,147,62,85,0,0,0
2022-05-28 14:15,128,52,76,0,0,0
2022-05-28 14:30,149,60,89,0,0,0
2022-05-28 14:45,137,54,83,0,0,0
2022-05-28 15:00,133,58,75,0,0,0
2022-05-28 15:15,129,58,71,0,0,0
2022-05-28 15:30,124,46,78,0,0,0
2022-05-28 15:45,130,68,62,0,0,0
2022-05-28 16:00,113,50,63,0,0,0
2022-05-28 16:15,126,46,80,0,0,0
2022-05-28 16:30,121,57,64,0,0,0
2022-05-28 16:45,128,55,73,0,0,0
2022-05-28 17:00,117,42,75,0,0,0
2022-05-28 17:15,132,47,85,0,0,0
2022-05-28 17:30,114,50,64,0,0,0
2022-05-28 17:45,130,49,81,0,0,0
2022-05-28 18:00,118,35,83,0,0,0
2022-05-28 18:15,90,38,52,0,0,0
2022-05-28 18:30,87,35,52,0,0,0
2022-05-28 18:45,115,48,67,0,0,0
2022-05-28 19:00,87,34,53,0,0,0
2022-05-28 19:15,106,47,59,0,0,0
2022-05-28 19:30,57,21,36,0,0,0
2022-05-28 19:45,106,53,53,0,0,0
2022-05-28 20:00,70,32,38,0,0,0
2022-05-28 20:15,64,20,44,0,0,0
2022-05-28 20:30,64,30,34,0,0,0
2022-05-28 20:45,62,22,40,0,0,0
2022-05-28 21:00,51,21,30,0,0,0
2022-05-28 21:15,28,11,17,0,0,0
2022-05-28 21:30,39,13,26,0,0,0
2022-05-28 21:45,28,9,19,0,0,0
2022-05-28 22:00,37,15,22,0,0,0
2022-05-28 22:15,28,11,17,0,0,0
2022-05-28 22:30,39,16,23,0,0,0
2022-05-28 22:45,36,12,24,0,0,0
2022-05-28 23:00,20,3,17,0,0,0
2022-05-28 23:15,24,9,15,0,0,0
2022-05-28 23:30,30,17,13,0,0,0
2022-05-28 23:45,39,13,26,0,0,0
2022-05-29 00:00,51,23,28,0,0,0
2022-05-29 00:15,45,22,23,0,0,0
2022-05-29 00:30,35,10,25,0,0,0
2022-05-29 00:45,32,7,25,0,0,0
2022-05-29 01:00,17,3,14,0,0,0
2022-05-29 01:15,18,7,11,0,0,0
2022-05-29 01:30,21,8,13,0,0,0
2022-05-29 01:45,14,7,7,0,0,0
2022-05-29 02:00,24,7,17,0,0,0
2022-05-29 02:15,20,4,16,0,0,0
2022-05-29 02:30,9,1,8,0,0,0
2022-05-29 02:45,8,4,4,0,0,0
2022-05-29 03:00,16,8,8,0,0,0
2022-05-29 03:15,9,1,8,0,0,0
2022-05-29 03:30,7,2,5,0,0,0
2022-05-29 03:45,6,2,4,0,0,0
2022-05-29 04:00,4,1,3,0,0,0
2022-05-29 04:15,7,1,6,0,0,0
2022-05-29 04:30,6,2,4,0,0,0
2022-05-29 04:45,6,3,3,0,0,0
2022-05-29 05:00,1,0,1,0,0,0
2022-05-29 05:15,4,3,1,0,0,0
2022-05-29 05:30,7,3,4,0,0,0
2022-05-29 05:45,7,6,1,0,0,0
2022-05-29 06:00,3,2,1,0,0,0
2022-05-29 06:15,7,4,3,0,0,0
2022-05-29 06:30,3,1,2,0,0,0
2022-05-29 06:45,1,1,0,0,0,0
2022-05-29 07:00,3,2,1,0,0,0
2022-05-29 07:15,7,6,1,0,0,0
2022-05-29 07:30,7,4,3,0,0,0
2022-05-29 07:45,10,7,3,0,0,0
2022-05-29 08:00,5,3,2,0,0,0
2022-05-29 08:15,9,7,2,0,0,0
2022-05-29 08:30,15,8,7,0,0,0
2022-05-29 08:45,14,11,3,0,0,0
2022-05-29 09:00,14,9,5,0,0,0
2022-05-29 09:15,16,8,8,0,0,0
2022-05-29 09:30,14,8,6,0,0,0
2022-05-29 09:45,27,14,13,0,0,0
2022-05-29 10:00,34,19,15,0,0,0
2022-05-29 10:15,31,19,12,0,0,0
2022-05-29 10:30,35,16,19,0,0,0
2022-05-29 10:45,28,15,13,0,0,0
2022-05-29 11:00,29,17,12,0,0,0
2022-05-29 11:15,27,11,16,0,0,0
2022-05-29 11:30,35,17,18,0,0,0
2022-05-29 11:45,49,20,29,0,0,0
2022-05-29 12:00,27,13,14,0,0,0
2022-05-29 12:15,29,11,18,0,0,0
2022-05-29 12:30,24,16,8,0,0,0
2022-05-29 12:45,48,27,21,0,0,0
2022-05-29 13:00,42,28,14,0,0,0
2022-05-29 13:15,56,28,28,0,0,0
2022-05-29 13:30,31,8,23,0,0,0
2022-05-29 13:45,46,21,25,0,0,0
2022-05-29 14:00,50,24,26,0,0,0
2022-05-29 14:15,42,13,29,0,0,0
2022-05-29 14:30,48,15,33,0,0,0
2022-05-29 14:45,62,30,32,0,0,0
2022-05-29 15:00,54,28,26,0,0,0
2022-05-29 15:15,72,39,33,0,0,0
2022-05-29 15:30,47,16,31,0,0,0
2022-05-29 15:45,66,32,34,0,0,0
2022-05-29 16:00,46,22,24,0,0,0
2022-05-29 16:15,68,34,34,0,0,0
2022-05-29 16:30,44,20,24,0,0,0
2022-05-29 16:45,77,33,44,0,0,0
2022-05-29 17:00,75,36,39,0,0,0
2022-05-29 17:15,91,43,48,0,0,0
2022-05-29 17:30,72,30,42,0,0,0
2022-05-29 17:45,81,31,50,0,0,0
2022-05-29 18:00,63,29,34,0,0,0
2022-05-29 18:15,64,33,31,0,0,0
2022-05-29 18:30,52,21,31,0,0,0
2022-05-29 18:45,58,21,37,0,0,0
2022-05-29 19:00,73,22,51,0,0,0
2022-05-29 19:15,61,24,37,0,0,0
2022-05-29 19:30,53,25,28,0,0,0
2022-05-29 19:45,47,19,28,0,0,0
2022-05-29 20:00,36,8,28,0,0,0
2022-05-29 20:15,49,25,24,0,0,0
2022-05-29 20:30,25,10,15,0,0,0
2022-05-29 20:45,24,9,15,0,0,0
2022-05-29 21:00,28,12,16,0,0,0
2022-05-29 21:15,30,8,22,0,0,0
2022-05-29 21:30,24,10,14,0,0,0
2022-05-29 21:45,32,12,20,0,0,0
2022-05-29 22:00,19,6,13,0,0,0
2022-05-29 22:15,15,4,11,0,0,0
2022-05-29 22:30,23,9,14,0,0,0
2022-05-29 22:45,18,9,9,0,0,0
2022-05-29 23:00,29,23,6,0,0,0
2022-05-29 23:15,15,11,4,0,0,0
2022-05-29 23:30,8,1,7,0,0,0
2022-05-29 23:45,7,4,3,0,0,0
2022-05-30 00:00,5,2,3,0,0,0
2022-05-30 00:15,7,3,4,0,0,0
2022-05-30 00:30,1,1,0,0,0,0
2022-05-30 00:45,4,0,4,0,0,0
2022-05-30 01:00,1,0,1,0,0,0
2022-05-30 01:15,2,0,2,0,0,0
2022-05-30 01:30,2,1,1,0,0,0
2022-05-30 01:45,4,0,4,0,0,0
2022-05-30 02:00,0,0,0,0,0,0
2022-05-30 02:15,0,0,0,0,0,0
2022-05-30 02:30,0,0,0,0,0,0
2022-05-30 02:45,0,0,0,0,0,0
2022-05-30 03:00,1,1,0,0,0,0
2022-05-30 03:15,1,0,1,0,0,0
2022-05-30 03:30,1,1,0,0,0,0
2022-05-30 03:45,1,1,0,0,0,0
2022-05-30 04:00,1,1,0,0,0,0
2022-05-30 04:15,4,3,1,0,0,0
2022-05-30 04:30,1,1,0,0,0,0
2022-05-30 04:45,6,5,1,0,0,0
2022-05-30 05:00,4,2,2,0,0,0
2022-05-30 05:15,10,8,2,0,0,0
2022-05-30 05:30,16,13,3,0,0,0
2022-05-30 05:45,17,15,2,0,0,0
2022-05-30 06:00,21,16,5,0,0,0
2022-05-30 06:15,23,19,4,0,0,0
2022-05-30 06:30,40,30,10,0,0,0
2022-05-30 06:45,57,36,21,0,0,0
2022-05-30 07:00,83,51,32,0,0,0
2022-05-30 07:15,113,72,41,0,0,0
2022-05-30 07:30,182,111,71,0,0,0
2022-05-30 07:45,173,115,58,0,0,0
2022-05-30 08:00,152,88,64,0,0,0
2022-05-30 08:15,140,91,49,0,0,0
2022-05-30 08:30,126,80,46,0,0,0
2022-05-30 08:45,159,108,51,0,0,0
2022-05-30 09:00,102,65,37,0,0,0
2022-05-30 09:15,96,58,38,0,0,0
2022-05-30 09:30,80,52,28,0,0,0
2022-05-30 09:45,123,80,43,0,0,0
2022-05-30 10:00,116,74,42,0,0,0
2022-05-30 10:15,102,58,44,0,0,0
2022-05-30 10:30,90,40,50,0,0,0
2022-05-30 10:45,101,58,43,0,0,0
2022-05-30 11:00,103,45,58,0,0,0
2022-05-30 11:15,122,58,64,0,0,0
2022-05-30 11:30,129,67,62,0,0,0
2022-05-30 11:45,137,71,66,0,0,0
2022-05-30 12:00,151,71,80,0,0,0
2022-05-30 12:15,139,65,74,0,0,0
2022-05-30 12:30,125,48,77,0,0,0
2022-05-30 12:45,139,73,66,0,0,0
2022-05-30 13:00,135,55,80,0,0,0
2022-05-30 13:15,135,56,79,0,0,0
2022-05-30 13:30,147,70,77,0,0,0
2022-05-30 13:45,171,81,90,0,0,0
2022-05-30 14:00,149,61,88,0,0,0
2022-05-30 14:15,128,55,73,0,0,0
2022-05-30 14:30,133,55,78,0,0,0
2022-05-30 14:45,152,72,80,0,0,0
2022-05-30 15:00,138,69,69,0,0,0
2022-05-30 15:15,155,59,96,0,0,0
2022-05-30 15:30,187,76,111,0,0,0
2022-05-30 15:45,190,72,118,0,0,0
2022-05-30 16:00,217,86,131,0,0,0
2022-05-30 16:15,189,81,108,0,0,0
2022-05-30 16:30,215,74,141,0,0,0
2022-05-30 16:45,227,91,136,0,0,0
2022-05-30 17:00,205,73,132,0,0,0
2022-05-30 17:15,204,77,127,0,0,0
2022-05-30 17:30,180,65,115,0,0,0
2022-05-30 17:45,204,78,126,0,0,0
2022-05-30 18:00,185,68,117,0,0,0
2022-05-30 18:15,168,53,115,0,0,0
2022-05-30 18:30,176,43,133,0,0,0
2022-05-30 18:45,141,56,85,0,0,0
2022-05-30 19:00,132,42,90,0,0,0
2022-05-30 19:15,131,48,83,0,0,0
2022-05-30 19:30,111,47,64,0,0,0
2022-05-30 19:45,138,44,94,0,0,0
2022-05-30 20:00,94,31,63,0,0,0
2022-05-30 20:15,76,25,51,0,0,0
2022-05-30 20:30,61,23,38,0,0,0
2022-05-30 20:45,51,17,34,0,0,0
2022-05-30 21:00,51,29,22,0,0,0
2022-05-30 21:15,39,13,26,0,0,0
2022-05-30 21:30,48,15,33,0,0,0
2022-05-30 21:45,46,14,32,0,0,0
2022-05-30 22:00,48,14,34,0,0,0
2022-05-30 22:15,36,8,28,0,0,0
2022-05-30 22:30,48,11,37,0,0,0
2022-05-30 22:45,23,8,15,0,0,0
2022-05-30 23:00,23,4,19,0,0,0
2022-05-30 23:15,33,8,25,0,0,0
2022-05-30 23:30,8,3,5,0,0,0
2022-05-30 23:45,15,9,6,0,0,0
