Datetime,100031300 (HafenstraÃŸe),101031300 (Channel 1 IN),102031300 (Channel 2 OUT),100031300-status,101031300-status,102031300-status
2022-04-01 00:00,21,7,14,0,0,0
2022-04-01 00:15,17,10,7,0,0,0
2022-04-01 00:30,15,10,5,0,0,0
2022-04-01 00:45,7,3,4,0,0,0
2022-04-01 01:00,17,10,7,0,0,0
2022-04-01 01:15,3,2,1,0,0,0
2022-04-01 01:30,10,4,6,0,0,0
2022-04-01 01:45,8,0,8,0,0,0
2022-04-01 02:00,8,3,5,0,0,0
2022-04-01 02:15,10,1,9,0,0,0
2022-04-01 02:30,10,1,9,0,0,0
2022-04-01 02:45,11,0,11,0,0,0
2022-04-01 03:00,16,0,16,0,0,0
2022-04-01 03:15,9,0,9,0,0,0
2022-04-01 03:30,9,0,9,0,0,0
2022-04-01 03:45,10,1,9,0,0,0
2022-04-01 04:00,5,1,4,0,0,0
2022-04-01 04:15,14,2,12,0,0,0
2022-04-01 04:30,5,1,4,0,0,0
2022-04-01 04:45,13,1,12,0,0,0
2022-04-01 05:00,6,2,4,0,0,0
2022-04-01 05:15,15,2,13,0,0,0
2022-04-01 05:30,19,4,15,0,0,0
2022-04-01 05:45,12,7,5,0,0,0
2022-04-01 06:00,15,3,12,0,0,0
2022-04-01 06:15,36,16,20,0,0,0
2022-04-01 06:30,27,4,23,0,0,0
2022-04-01 06:45,52,25,27,0,0,0
2022-04-01 07:00,50,25,25,0,0,0
2022-04-01 07:15,65,27,38,0,0,0
2022-04-01 07:30,112,37,75,0,0,0
2022-04-01 07:45,133,76,57,0,0,0
2022-04-01 08:00,77,26,51,0,0,0
2022-04-01 08:15,87,37,50,0,0,0
2022-04-01 08:30,74,32,42,0,0,0
2022-04-01 08:45,93,44,49,0,0,0
2022-04-01 09:00,76,31,45,0,0,0
2022-04-01 09:15,56,24,32,0,0,0
2022-04-01 09:30,69,21,48,0,0,0
2022-04-01 09:45,76,39,37,0,0,0
2022-04-01 10:00,66,20,46,0,0,0
2022-04-01 10:15,63,25,38,0,0,0
2022-04-01 10:30,69,24,45,0,0,0
2022-04-01 10:45,80,31,49,0,0,0
2022-04-01 11:00,70,14,56,0,0,0
2022-04-01 11:15,58,34,24,0,0,0
2022-04-01 11:30,56,22,34,0,0,0
2022-04-01 11:45,76,30,46,0,0,0
2022-04-01 12:00,72,36,36,0,0,0
2022-04-01 12:15,70,26,44,0,0,0
2022-04-01 12:30,85,31,54,0,0,0
2022-04-01 12:45,93,38,55,0,0,0
2022-04-01 13:00,92,32,60,0,0,0
2022-04-01 13:15,83,34,49,0,0,0
2022-04-01 13:30,81,38,43,0,0,0
2022-04-01 13:45,109,39,70,0,0,0
2022-04-01 14:00,103,34,69,0,0,0
2022-04-01 14:15,95,29,66,0,0,0
2022-04-01 14:30,97,34,63,0,0,0
2022-04-01 14:45,108,44,64,0,0,0
2022-04-01 15:00,83,40,43,0,0,0
2022-04-01 15:15,82,38,44,0,0,0
2022-04-01 15:30,77,27,50,0,0,0
2022-04-01 15:45,79,29,50,0,0,0
2022-04-01 16:00,89,40,49,0,0,0
2022-04-01 16:15,77,39,38,0,0,0
2022-04-01 16:30,85,36,49,0,0,0
2022-04-01 16:45,78,26,52,0,0,0
2022-04-01 17:00,93,36,57,0,0,0
2022-04-01 17:15,104,46,58,0,0,0
2022-04-01 17:30,105,41,64,0,0,0
2022-04-01 17:45,95,43,52,0,0,0
2022-04-01 18:00,85,43,42,0,0,0
2022-04-01 18:15,101,52,49,0,0,0
2022-04-01 18:30,73,27,46,0,0,0
2022-04-01 18:45,81,42,39,0,0,0
2022-04-01 19:00,52,30,22,0,0,0
2022-04-01 19:15,51,33,18,0,0,0
2022-04-01 19:30,45,19,26,0,0,0
2022-04-01 19:45,39,16,23,0,0,0
2022-04-01 20:00,59,20,39,0,0,0
2022-04-01 20:15,61,21,40,0,0,0
2022-04-01 20:30,61,31,30,0,0,0
2022-04-01 20:45,44,20,24,0,0,0
2022-04-01 21:00,42,14,28,0,0,0
2022-04-01 21:15,36,11,25,0,0,0
2022-04-01 21:30,44,14,30,0,0,0
2022-04-01 21:45,41,15,26,0,0,0
2022-04-01 22:00,53,21,32,0,0,0
2022-04-01 22:15,40,16,24,0,0,0
2022-04-01 22:30,45,21,24,0,0,0
2022-04-01 22:45,39,22,17,0,0,0
2022-04-01 23:00,31,14,17,0,0,0
2022-04-01 23:15,34,18,16,0,0,0
2022-04-01 23:30,26,7,19,0,0,0
2022-04-01 23:45,25,14,11,0,0,0
2022-04-02 00:00,41,13,28,0,0,0
2022-04-02 00:15,36,22,14,0,0,0
2022-04-02 00:30,27,20,7,0,0,0
2022-04-02 00:45,22,14,8,0,0,0
2022-04-02 01:00,27,17,10,0,0,0
2022-04-02 01:15,35,17,18,0,0,0
2022-04-02 01:30,17,5,12,0,0,0
2022-04-02 01:45,19,6,13,0,0,0
2022-04-02 02:00,14,5,9,0,0,0
2022-04-02 02:15,16,4,12,0,0,0
2022-04-02 02:30,9,3,6,0,0,0
2022-04-02 02:45,9,4,5,0,0,0
2022-04-02 03:00,14,2,12,0,0,0
2022-04-02 03:15,18,5,13,0,0,0
2022-04-02 03:30,20,7,13,0,0,0
2022-04-02 03:45,17,2,15,0,0,0
2022-04-02 04:00,7,2,5,0,0,0
2022-04-02 04:15,13,2,11,0,0,0
2022-04-02 04:30,14,1,13,0,0,0
2022-04-02 04:45,14,1,13,0,0,0
2022-04-02 05:00,5,1,4,0,0,0
2022-04-02 05:15,21,2,19,0,0,0
2022-04-02 05:30,11,0,11,0,0,0
2022-04-02 05:45,17,1,16,0,0,0
2022-04-02 06:00,19,1,18,0,0,0
2022-04-02 06:15,9,2,7,0,0,0
2022-04-02 06:30,12,3,9,0,0,0
2022-04-02 06:45,12,6,6,0,0,0
2022-04-02 07:00,12,2,10,0,0,0
2022-04-02 07:15,16,4,12,0,0,0
2022-04-02 07:30,23,8,15,0,0,0
2022-04-02 07:45,26,8,18,0,0,0
2022-04-02 08:00,20,6,14,0,0,0
2022-04-02 08:15,17,8,9,0,0,0
2022-04-02 08:30,37,15,22,0,0,0
2022-04-02 08:45,35,12,23,0,0,0
2022-04-02 09:00,30,12,18,0,0,0
2022-04-02 09:15,37,15,22,0,0,0
2022-04-02 09:30,52,21,31,0,0,0
2022-04-02 09:45,55,33,22,0,0,0
2022-04-02 10:00,55,25,30,0,0,0
2022-04-02 10:15,61,27,34,0,0,0
2022-04-02 10:30,70,23,47,0,0,0
2022-04-02 10:45,76,24,52,0,0,0
2022-04-02 11:00,76,22,54,0,0,0
2022-04-02 11:15,72,22,50,0,0,0
2022-04-02 11:30,78,28,50,0,0,0
2022-04-02 11:45,80,29,51,0,0,0
2022-04-02 12:00,78,28,50,0,0,0
2022-04-02 12:15,80,27,53,0,0,0
2022-04-02 12:30,90,38,52,0,0,0
2022-04-02 12:45,91,43,48,0,0,0
2022-04-02 13:00,78,30,48,0,0,0
2022-04-02 13:15,97,49,48,0,0,0
2022-04-02 13:30,86,40,46,0,0,0
2022-04-02 13:45,92,54,38,0,0,0
2022-04-02 14:00,94,48,46,0,0,0
2022-04-02 14:15,77,40,37,0,0,0
2022-04-02 14:30,74,41,33,0,0,0
2022-04-02 14:45,85,36,49,0,0,0
2022-04-02 15:00,96,47,49,0,0,0
2022-04-02 15:15,72,33,39,0,0,0
2022-04-02 15:30,77,30,47,0,0,0
2022-04-02 15:45,86,39,47,0,0,0
2022-04-02 16:00,84,34,50,0,0,0
2022-04-02 16:15,73,25,48,0,0,0
2022-04-02 16:30,71,28,43,0,0,0
2022-04-02 16:45,80,40,40,0,0,0
2022-04-02 17:00,77,32,45,0,0,0
2022-04-02 17:15,85,36,49,0,0,0
2022-04-02 17:30,66,32,34,0,0,0
2022-04-02 17:45,89,41,48,0,0,0
2022-04-02 18:00,81,44,37,0,0,0
2022-04-02 18:15,76,36,40,0,0,0
2022-04-02 18:30,63,28,35,0,0,0
2022-04-02 18:45,79,45,34,0,0,0
2022-04-02 19:00,79,35,44,0,0,0
2022-04-02 19:15,72,38,34,0,0,0
2022-04-02 19:30,66,23,43,0,0,0
2022-04-02 19:45,64,21,43,0,0,0
2022-04-02 20:00,68,39,29,0,0,0
2022-04-02 20:15,55,20,35,0,0,0
2022-04-02 20:30,49,22,27,0,0,0
2022-04-02 20:45,50,30,20,0,0,0
2022-04-02 21:00,47,24,23,0,0,0
2022-04-02 21:15,42,14,28,0,0,0
2022-04-02 21:30,41,17,24,0,0,0
2022-04-02 21:45,50,19,31,0,0,0
2022-04-02 22:00,42,19,23,0,0,0
2022-04-02 22:15,46,28,18,0,0,0
2022-04-02 22:30,32,12,20,0,0,0
2022-04-02 22:45,37,13,24,0,0,0
2022-04-02 23:00,39,13,26,0,0,0
2022-04-02 23:15,39,21,18,0,0,0
2022-04-02 23:30,37,13,24,0,0,0
2022-04-02 23:45,43,21,22,0,0,0
2022-04-03 00:00,22,9,13,0,0,0
2022-04-03 00:15,44,24,20,0,0,0
2022-04-03 00:30,58,32,26,0,0,0
2022-04-03 00:45,40,24,16,0,0,0
2022-04-03 01:00,30,11,19,0,0,0
2022-04-03 01:15,27,17,10,0,0,0
2022-04-03 01:30,34,20,14,0,0,0
2022-04-03 01:45,28,11,17,0,0,0
2022-04-03 02:00,25,5,20,0,0,0
2022-04-03 02:15,14,3,11,0,0,0
2022-04-03 02:30,25,4,21,0,0,0
2022-04-03 02:45,16,6,10,0,0,0
2022-04-03 03:00,11,3,8,0,0,0
2022-04-03 03:15,23,2,21,0,0,0
2022-04-03 03:30,13,5,8,0,0,0
2022-04-03 03:45,19,5,14,0,0,0
2022-04-03 04:00,4,1,3,0,0,0
2022-04-03 04:15,9,0,9,0,0,0
2022-04-03 04:30,22,6,16,0,0,0
2022-04-03 04:45,14,6,8,0,0,0
2022-04-03 05:00,1,0,1,0,0,0
2022-04-03 05:15,10,1,9,0,0,0
2022-04-03 05:30,10,1,9,0,0,0
2022-04-03 05:45,10,1,9,0,0,0
2022-04-03 06:00,10,0,10,0,0,0
2022-04-03 06:15,11,3,8,0,0,0
2022-04-03 06:30,10,5,5,0,0,0
2022-04-03 06:45,7,3,4,0,0,0
2022-04-03 07:00,10,1,9,0,0,0
2022-04-03 07:15,10,2,8,0,0,0
2022-04-03 07:30,6,3,3,0,0,0
2022-04-03 07:45,10,2,8,0,0,0
2022-04-03 08:00,9,0,9,0,0,0
2022-04-03 08:15,3,2,1,0,0,0
2022-04-03 08:30,16,3,13,0,0,0
2022-04-03 08:45,22,9,13,0,0,0
2022-04-03 09:00,15,9,6,0,0,0
2022-04-03 09:15,20,6,14,0,0,0
2022-04-03 09:30,23,11,12,0,0,0
2022-04-03 09:45,49,31,18,0,0,0
2022-04-03 10:00,28,20,8,0,0,0
2022-04-03 10:15,42,17,25,0,0,0
2022-04-03 10:30,25,8,17,0,0,0
2022-04-03 10:45,45,22,23,0,0,0
2022-04-03 11:00,36,10,26,0,0,0
2022-04-03 11:15,44,15,29,0,0,0
2022-04-03 11:30,46,11,35,0,0,0
2022-04-03 11:45,49,23,26,0,0,0
2022-04-03 12:00,43,11,32,0,0,0
2022-04-03 12:15,31,9,22,0,0,0
2022-04-03 12:30,39,12,27,0,0,0
2022-04-03 12:45,51,23,28,0,0,0
2022-04-03 13:00,51,12,39,0,0,0
2022-04-03 13:15,51,20,31,0,0,0
2022-04-03 13:30,56,21,35,0,0,0
2022-04-03 13:45,57,33,24,0,0,0
2022-04-03 14:00,67,23,44,0,0,0
2022-04-03 14:15,65,20,45,0,0,0
2022-04-03 14:30,46,21,25,0,0,0
2022-04-03 14:45,55,21,34,0,0,0
2022-04-03 15:00,58,26,32,0,0,0
2022-04-03 15:15,64,29,35,0,0,0
2022-04-03 15:30,62,27,35,0,0,0
2022-04-03 15:45,67,26,41,0,0,0
2022-04-03 16:00,66,29,37,0,0,0
2022-04-03 16:15,77,38,39,0,0,0
2022-04-03 16:30,51,13,38,0,0,0
2022-04-03 16:45,79,25,54,0,0,0
2022-04-03 17:00,81,37,44,0,0,0
2022-04-03 17:15,71,33,38,0,0,0
2022-04-03 17:30,60,25,35,0,0,0
2022-04-03 17:45,68,35,33,0,0,0
2022-04-03 18:00,71,32,39,0,0,0
2022-04-03 18:15,68,32,36,0,0,0
2022-04-03 18:30,64,27,37,0,0,0
2022-04-03 18:45,64,30,34,0,0,0
2022-04-03 19:00,56,25,31,0,0,0
2022-04-03 19:15,68,38,30,0,0,0
2022-04-03 19:30,53,23,30,0,0,0
2022-04-03 19:45,72,38,34,0,0,0
2022-04-03 20:00,44,14,30,0,0,0
2022-04-03 20:15,52,22,30,0,0,0
2022-04-03 20:30,32,17,15,0,0,0
2022-04-03 20:45,41,14,27,0,0,0
2022-04-03 21:00,36,15,21,0,0,0
2022-04-03 21:15,34,10,24,0,0,0
2022-04-03 21:30,24,12,12,0,0,0
2022-04-03 21:45,46,18,28,0,0,0
2022-04-03 22:00,27,11,16,0,0,0
2022-04-03 22:15,29,6,23,0,0,0
2022-04-03 22:30,20,4,16,0,0,0
2022-04-03 22:45,33,12,21,0,0,0
2022-04-03 23:00,24,5,19,0,0,0
2022-04-03 23:15,16,7,9,0,0,0
2022-04-03 23:30,9,5,4,0,0,0
2022-04-03 23:45,13,4,9,0,0,0
2022-04-04 00:00,13,1,12,0,0,0
2022-04-04 00:15,13,3,10,0,0,0
2022-04-04 00:30,3,1,2,0,0,0
2022-04-04 00:45,5,4,1,0,0,0
2022-04-04 01:00,3,1,2,0,0,0
2022-04-04 01:15,5,3,2,0,0,0
2022-04-04 01:30,1,1,0,0,0,0
2022-04-04 01:45,4,0,4,0,0,0
2022-04-04 02:00,2,2,0,0,0,0
2022-04-04 02:15,0,0,0,0,0,0
2022-04-04 02:30,1,0,1,0,0,0
2022-04-04 02:45,4,0,4,0,0,0
2022-04-04 03:00,0,0,0,0,0,0
2022-04-04 03:15,1,1,0,0,0,0
2022-04-04 03:30,0,0,0,0,0,0
2022-04-04 03:45,0,0,0,0,0,0
2022-04-04 04:00,0,0,0,0,0,0
2022-04-04 04:15,2,1,1,0,0,0
2022-04-04 04:30,2,2,0,0,0,0
2022-04-04 04:45,5,2,3,0,0,0
2022-04-04 05:00,0,0,0,0,0,0
2022-04-04 05:15,9,7,2,0,0,0
2022-04-04 05:30,4,1,3,0,0,0
2022-04-04 05:45,16,6,10,0,0,0
2022-04-04 06:00,16,6,10,0,0,0
2022-04-04 06:15,32,13,19,0,0,0
2022-04-04 06:30,33,9,24,0,0,0
2022-04-04 06:45,60,32,28,0,0,0
2022-04-04 07:00,73,38,35,0,0,0
2022-04-04 07:15,84,38,46,0,0,0
2022-04-04 07:30,139,53,86,0,0,0
2022-04-04 07:45,142,73,69,0,0,0
2022-04-04 08:00,121,64,57,0,0,0
2022-04-04 08:15,104,56,48,0,0,0
2022-04-04 08:30,102,50,52,0,0,0
2022-04-04 08:45,115,45,70,0,0,0
2022-04-04 09:00,88,30,58,0,0,0
2022-04-04 09:15,75,26,49,0,0,0
2022-04-04 09:30,80,30,50,0,0,0
2022-04-04 09:45,100,32,68,0,0,0
2022-04-04 10:00,83,28,55,0,0,0
2022-04-04 10:15,80,30,50,0,0,0
2022-04-04 10:30,71,26,45,0,0,0
2022-04-04 10:45,60,18,42,0,0,0
2022-04-04 11:00,78,34,44,0,0,0
2022-04-04 11:15,70,31,39,0,0,0
2022-04-04 11:30,73,22,51,0,0,0
2022-04-04 11:45,85,29,56,0,0,0
2022-04-04 12:00,104,39,65,0,0,0
2022-04-04 12:15,98,40,58,0,0,0
2022-04-04 12:30,71,36,35,0,0,0
2022-04-04 12:45,84,34,50,0,0,0
2022-04-04 13:00,83,37,46,0,0,0
2022-04-04 13:15,99,58,41,0,0,0
2022-04-04 13:30,84,43,41,0,0,0
2022-04-04 13:45,80,37,43,0,0,0
2022-04-04 14:00,114,59,55,0,0,0
2022-04-04 14:15,88,32,56,0,0,0
2022-04-04 14:30,84,27,57,0,0,0
2022-04-04 14:45,95,43,52,0,0,0
2022-04-04 15:00,111,53,58,0,0,0
2022-04-04 15:15,92,37,55,0,0,0
2022-04-04 15:30,104,46,58,0,0,0
2022-04-04 15:45,124,52,72,0,0,0
2022-04-04 16:00,111,58,53,0,0,0
2022-04-04 16:15,107,40,67,0,0,0
2022-04-04 16:30,113,45,68,0,0,0
2022-04-04 16:45,114,47,67,0,0,0
2022-04-04 17:00,128,70,58,0,0,0
2022-04-04 17:15,144,71,73,0,0,0
2022-04-04 17:30,134,58,76,0,0,0
2022-04-04 17:45,135,61,74,0,0,0
2022-04-04 18:00,119,36,83,0,0,0
2022-04-04 18:15,97,37,60,0,0,0
2022-04-04 18:30,80,32,48,0,0,0
2022-04-04 18:45,78,46,32,0,0,0
2022-04-04 19:00,81,39,42,0,0,0
2022-04-04 19:15,97,39,58,0,0,0
2022-04-04 19:30,66,28,38,0,0,0
2022-04-04 19:45,89,46,43,0,0,0
2022-04-04 20:00,59,24,35,0,0,0
2022-04-04 20:15,72,34,38,0,0,0
2022-04-04 20:30,47,19,28,0,0,0
2022-04-04 20:45,40,20,20,0,0,0
2022-04-04 21:00,30,11,19,0,0,0
2022-04-04 21:15,57,26,31,0,0,0
2022-04-04 21:30,31,13,18,0,0,0
2022-04-04 21:45,35,12,23,0,0,0
2022-04-04 22:00,42,14,28,0,0,0
2022-04-04 22:15,24,9,15,0,0,0
2022-04-04 22:30,37,11,26,0,0,0
2022-04-04 22:45,39,16,23,0,0,0
2022-04-04 23:00,28,7,21,0,0,0
2022-04-04 23:15,31,11,20,0,0,0
2022-04-04 23:30,18,8,10,0,0,0
2022-04-04 23:45,22,12,10,0,0,0
2022-04-05 00:00,23,19,4,0,0,0
2022-04-05 00:15,15,13,2,0,0,0
2022-04-05 00:30,19,13,6,0,0,0
2022-04-05 00:45,15,9,6,0,0,0
2022-04-05 01:00,6,0,6,0,0,0
2022-04-05 01:15,4,2,2,0,0,0
2022-04-05 01:30,6,3,3,0,0,0
2022-04-05 01:45,9,2,7,0,0,0
2022-04-05 02:00,20,1,19,0,0,0
2022-04-05 02:15,13,1,12,0,0,0
2022-04-05 02:30,20,1,19,0,0,0
2022-04-05 02:45,22,0,22,0,0,0
2022-04-05 03:00,21,0,21,0,0,0
2022-04-05 03:15,26,1,25,0,0,0
2022-04-05 03:30,6,0,6,0,0,0
2022-04-05 03:45,13,0,13,0,0,0
2022-04-05 04:00,12,2,10,0,0,0
2022-04-05 04:15,7,0,7,0,0,0
2022-04-05 04:30,21,3,18,0,0,0
2022-04-05 04:45,8,0,8,0,0,0
2022-04-05 05:00,3,1,2,0,0,0
2022-04-05 05:15,17,2,15,0,0,0
2022-04-05 05:30,12,5,7,0,0,0
2022-04-05 05:45,18,9,9,0,0,0
2022-04-05 06:00,12,3,9,0,0,0
2022-04-05 06:15,32,9,23,0,0,0
2022-04-05 06:30,33,13,20,0,0,0
2022-04-05 06:45,54,20,34,0,0,0
2022-04-05 07:00,66,31,35,0,0,0
2022-04-05 07:15,102,40,62,0,0,0
2022-04-05 07:30,118,46,72,0,0,0
2022-04-05 07:45,132,63,69,0,0,0
2022-04-05 08:00,146,64,82,0,0,0
2022-04-05 08:15,104,51,53,0,0,0
2022-04-05 08:30,106,51,55,0,0,0
2022-04-05 08:45,107,39,68,0,0,0
2022-04-05 09:00,83,31,52,0,0,0
2022-04-05 09:15,85,28,57,0,0,0
2022-04-05 09:30,74,28,46,0,0,0
2022-04-05 09:45,136,42,94,0,0,0
2022-04-05 10:00,80,29,51,0,0,0
2022-04-05 10:15,64,25,39,0,0,0
2022-04-05 10:30,69,27,42,0,0,0
2022-04-05 10:45,67,22,45,0,0,0
2022-04-05 11:00,83,41,42,0,0,0
2022-04-05 11:15,71,26,45,0,0,0
2022-04-05 11:30,96,47,49,0,0,0
2022-04-05 11:45,93,43,50,0,0,0
2022-04-05 12:00,95,41,54,0,0,0
2022-04-05 12:15,93,34,59,0,0,0
2022-04-05 12:30,101,56,45,0,0,0
2022-04-05 12:45,76,42,34,0,0,0
2022-04-05 13:00,102,41,61,0,0,0
2022-04-05 13:15,120,59,61,0,0,0
2022-04-05 13:30,95,45,50,0,0,0
2022-04-05 13:45,106,50,56,0,0,0
2022-04-05 14:00,120,52,68,0,0,0
2022-04-05 14:15,93,47,46,0,0,0
2022-04-05 14:30,69,35,34,0,0,0
2022-04-05 14:45,97,46,51,0,0,0
2022-04-05 15:00,106,52,54,0,0,0
2022-04-05 15:15,119,58,61,0,0,0
2022-04-05 15:30,122,64,58,0,0,0
2022-04-05 15:45,120,64,56,0,0,0
2022-04-05 16:00,146,81,65,0,0,0
2022-04-05 16:15,151,81,70,0,0,0
2022-04-05 16:30,130,71,59,0,0,0
2022-04-05 16:45,133,57,76,0,0,0
2022-04-05 17:00,115,53,62,0,0,0
2022-04-05 17:15,122,65,57,0,0,0
2022-04-05 17:30,147,69,78,0,0,0
2022-04-05 17:45,156,74,82,0,0,0
2022-04-05 18:00,157,77,80,0,0,0
2022-04-05 18:15,145,60,85,0,0,0
2022-04-05 18:30,112,60,52,0,0,0
2022-04-05 18:45,114,72,42,0,0,0
2022-04-05 19:00,122,74,48,0,0,0
2022-04-05 19:15,100,55,45,0,0,0
2022-04-05 19:30,84,48,36,0,0,0
2022-04-05 19:45,63,24,39,0,0,0
2022-04-05 20:00,98,39,59,0,0,0
2022-04-05 20:15,60,33,27,0,0,0
2022-04-05 20:30,70,33,37,0,0,0
2022-04-05 20:45,53,20,33,0,0,0
2022-04-05 21:00,69,27,42,0,0,0
2022-04-05 21:15,35,14,21,0,0,0
2022-04-05 21:30,47,8,39,0,0,0
2022-04-05 21:45,47,18,29,0,0,0
2022-04-05 22:00,40,12,28,0,0,0
2022-04-05 22:15,51,19,32,0,0,0
2022-04-05 22:30,41,20,21,0,0,0
2022-04-05 22:45,35,10,25,0,0,0
2022-04-05 23:00,35,13,22,0,0,0
2022-04-05 23:15,31,13,18,0,0,0
2022-04-05 23:30,33,18,15,0,0,0
2022-04-05 23:45,37,17,20,0,0,0
2022-04-06 00:00,23,10,13,0,0,0
2022-04-06 00:15,10,3,7,0,0,0
2022-04-06 00:30,11,7,4,0,0,0
2022-04-06 00:45,16,7,9,0,0,0
2022-04-06 01:00,8,1,7,0,0,0
2022-04-06 01:15,18,4,14,0,0,0
2022-04-06 01:30,6,1,5,0,0,0
2022-04-06 01:45,5,0,5,0,0,0
2022-04-06 02:00,9,1,8,0,0,0
2022-04-06 02:15,28,1,27,0,0,0
2022-04-06 02:30,14,1,13,0,0,0
2022-04-06 02:45,17,0,17,0,0,0
2022-04-06 03:00,18,0,18,0,0,0
2022-04-06 03:15,8,1,7,0,0,0
2022-04-06 03:30,0,0,0,0,0,0
2022-04-06 03:45,9,1,8,0,0,0
2022-04-06 04:00,8,0,8,0,0,0
2022-04-06 04:15,4,2,2,0,0,0
2022-04-06 04:30,4,0,4,0,0,0
2022-04-06 04:45,4,0,4,0,0,0
2022-04-06 05:00,4,2,2,0,0,0
2022-04-06 05:15,10,0,10,0,0,0
2022-04-06 05:30,19,7,12,0,0,0
2022-04-06 05:45,28,13,15,0,0,0
2022-04-06 06:00,26,8,18,0,0,0
2022-04-06 06:15,34,9,25,0,0,0
2022-04-06 06:30,45,17,28,0,0,0
2022-04-06 06:45,83,37,46,0,0,0
2022-04-06 07:00,74,36,38,0,0,0
2022-04-06 07:15,106,54,52,0,0,0
2022-04-06 07:30,149,50,99,0,0,0
2022-04-06 07:45,175,97,78,0,0,0
2022-04-06 08:00,145,72,73,0,0,0
2022-04-06 08:15,143,70,73,0,0,0
2022-04-06 08:30,124,66,58,0,0,0
2022-04-06 08:45,141,67,74,0,0,0
2022-04-06 09:00,114,50,64,0,0,0
2022-04-06 09:15,98,33,65,0,0,0
2022-04-06 09:30,85,34,51,0,0,0
2022-04-06 09:45,117,30,87,0,0,0
2022-04-06 10:00,105,36,69,0,0,0
2022-04-06 10:15,85,39,46,0,0,0
2022-04-06 10:30,82,40,42,0,0,0
2022-04-06 10:45,86,38,48,0,0,0
2022-04-06 11:00,69,32,37,0,0,0
2022-04-06 11:15,85,37,48,0,0,0
2022-04-06 11:30,99,45,54,0,0,0
2022-04-06 11:45,95,32,63,0,0,0
2022-04-06 12:00,108,46,62,0,0,0
2022-04-06 12:15,102,48,54,0,0,0
2022-04-06 12:30,118,69,49,0,0,0
2022-04-06 12:45,118,56,62,0,0,0
2022-04-06 13:00,121,54,67,0,0,0
2022-04-06 13:15,118,60,58,0,0,0
2022-04-06 13:30,109,58,51,0,0,0
2022-04-06 13:45,133,73,60,0,0,0
2022-04-06 14:00,143,80,63,0,0,0
2022-04-06 14:15,121,73,48,0,0,0
2022-04-06 14:30,103,55,48,0,0,0
2022-04-06 14:45,115,55,60,0,0,0
2022-04-06 15:00,121,58,63,0,0,0
2022-04-06 15:15,115,68,47,0,0,0
2022-04-06 15:30,102,54,48,0,0,0
2022-04-06 15:45,126,59,67,0,0,0
2022-04-06 16:00,144,88,56,0,0,0
2022-04-06 16:15,134,63,71,0,0,0
2022-04-06 16:30,123,62,61,0,0,0
2022-04-06 16:45,167,88,79,0,0,0
2022-04-06 17:00,137,57,80,0,0,0
2022-04-06 17:15,155,79,76,0,0,0
2022-04-06 17:30,172,79,93,0,0,0
2022-04-06 17:45,151,61,90,0,0,0
2022-04-06 18:00,159,72,87,0,0,0
2022-04-06 18:15,148,80,68,0,0,0
2022-04-06 18:30,100,65,35,0,0,0
2022-04-06 18:45,153,102,51,0,0,0
2022-04-06 19:00,122,71,51,0,0,0
2022-04-06 19:15,117,68,49,0,0,0
2022-04-06 19:30,70,40,30,0,0,0
2022-04-06 19:45,113,53,60,0,0,0
2022-04-06 20:00,93,44,49,0,0,0
2022-04-06 20:15,62,20,42,0,0,0
2022-04-06 20:30,56,22,34,0,0,0
2022-04-06 20:45,58,29,29,0,0,0
2022-04-06 21:00,59,25,34,0,0,0
2022-04-06 21:15,55,16,39,0,0,0
2022-04-06 21:30,56,15,41,0,0,0
2022-04-06 21:45,124,33,91,0,0,0
2022-04-06 22:00,52,15,37,0,0,0
2022-04-06 22:15,42,12,30,0,0,0
2022-04-06 22:30,56,15,41,0,0,0
2022-04-06 22:45,53,12,41,0,0,0
2022-04-06 23:00,69,25,44,0,0,0
2022-04-06 23:15,86,54,32,0,0,0
2022-04-06 23:30,38,27,11,0,0,0
2022-04-06 23:45,46,24,22,0,0,0
2022-04-07 00:00,43,37,6,0,0,0
2022-04-07 00:15,23,16,7,0,0,0
2022-04-07 00:30,23,15,8,0,0,0
2022-04-07 00:45,25,11,14,0,0,0
2022-04-07 01:00,8,3,5,0,0,0
2022-04-07 01:15,8,7,1,0,0,0
2022-04-07 01:30,20,4,16,0,0,0
2022-04-07 01:45,11,2,9,0,0,0
2022-04-07 02:00,11,2,9,0,0,0
2022-04-07 02:15,18,2,16,0,0,0
2022-04-07 02:30,10,2,8,0,0,0
2022-04-07 02:45,25,0,25,0,0,0
2022-04-07 03:00,29,0,29,0,0,0
2022-04-07 03:15,28,3,25,0,0,0
2022-04-07 03:30,31,1,30,0,0,0
2022-04-07 03:45,30,0,30,0,0,0
2022-04-07 04:00,15,0,15,0,0,0
2022-04-07 04:15,17,1,16,0,0,0
2022-04-07 04:30,22,1,21,0,0,0
2022-04-07 04:45,20,1,19,0,0,0
2022-04-07 05:00,15,3,12,0,0,0
2022-04-07 05:15,14,5,9,0,0,0
2022-04-07 05:30,16,4,12,0,0,0
2022-04-07 05:45,19,9,10,0,0,0
2022-04-07 06:00,20,6,14,0,0,0
2022-04-07 06:15,34,7,27,0,0,0
2022-04-07 06:30,46,18,28,0,0,0
2022-04-07 06:45,68,37,31,0,0,0
2022-04-07 07:00,81,34,47,0,0,0
2022-04-07 07:15,93,38,55,0,0,0
2022-04-07 07:30,118,45,73,0,0,0
2022-04-07 07:45,144,58,86,0,0,0
2022-04-07 08:00,109,58,51,0,0,0
2022-04-07 08:15,112,59,53,0,0,0
2022-04-07 08:30,124,67,57,0,0,0
2022-04-07 08:45,100,37,63,0,0,0
2022-04-07 09:00,68,26,42,0,0,0
2022-04-07 09:15,87,34,53,0,0,0
2022-04-07 09:30,66,27,39,0,0,0
2022-04-07 09:45,100,28,72,0,0,0
2022-04-07 10:00,75,26,49,0,0,0
2022-04-07 10:15,61,30,31,0,0,0
2022-04-07 10:30,66,21,45,0,0,0
2022-04-07 10:45,63,28,35,0,0,0
2022-04-07 11:00,60,24,36,0,0,0
2022-04-07 11:15,59,22,37,0,0,0
2022-04-07 11:30,61,25,36,0,0,0
2022-04-07 11:45,80,32,48,0,0,0
2022-04-07 12:00,82,22,60,0,0,0
2022-04-07 12:15,96,32,64,0,0,0
2022-04-07 12:30,87,35,52,0,0,0
2022-04-07 12:45,99,40,59,0,0,0
2022-04-07 13:00,104,46,58,0,0,0
2022-04-07 13:15,99,54,45,0,0,0
2022-04-07 13:30,90,33,57,0,0,0
2022-04-07 13:45,127,71,56,0,0,0
2022-04-07 14:00,111,61,50,0,0,0
2022-04-07 14:15,91,46,45,0,0,0
2022-04-07 14:30,90,48,42,0,0,0
2022-04-07 14:45,100,52,48,0,0,0
2022-04-07 15:00,88,42,46,0,0,0
2022-04-07 15:15,98,44,54,0,0,0
2022-04-07 15:30,118,57,61,0,0,0
2022-04-07 15:45,143,64,79,0,0,0
2022-04-07 16:00,101,50,51,0,0,0
2022-04-07 16:15,105,41,64,0,0,0
2022-04-07 16:30,113,57,56,0,0,0
2022-04-07 16:45,136,61,75,0,0,0
2022-04-07 17:00,127,60,67,0,0,0
2022-04-07 17:15,132,59,73,0,0,0
2022-04-07 17:30,125,46,79,0,0,0
2022-04-07 17:45,173,88,85,0,0,0
2022-04-07 18:00,149,73,76,0,0,0
2022-04-07 18:15,140,65,75,0,0,0
2022-04-07 18:30,109,61,48,0,0,0
2022-04-07 18:45,107,56,51,0,0,0
2022-04-07 19:00,93,51,42,0,0,0
2022-04-07 19:15,108,63,45,0,0,0
2022-04-07 19:30,120,58,62,0,0,0
2022-04-07 19:45,74,31,43,0,0,0
2022-04-07 20:00,87,26,61,0,0,0
2022-04-07 20:15,71,33,38,0,0,0
2022-04-07 20:30,44,25,19,0,0,0
2022-04-07 20:45,51,22,29,0,0,0
2022-04-07 21:00,43,18,25,0,0,0
2022-04-07 21:15,40,10,30,0,0,0
2022-04-07 21:30,40,16,24,0,0,0
2022-04-07 21:45,34,17,17,0,0,0
2022-04-07 22:00,53,17,36,0,0,0
2022-04-07 22:15,34,8,26,0,0,0
2022-04-07 22:30,59,16,43,0,0,0
2022-04-07 22:45,57,8,49,0,0,0
2022-04-07 23:00,32,8,24,0,0,0
2022-04-07 23:15,29,13,16,0,0,0
2022-04-07 23:30,37,14,23,0,0,0
2022-04-07 23:45,30,7,23,0,0,0
2022-04-08 00:00,13,5,8,0,0,0
2022-04-08 00:15,25,8,17,0,0,0
2022-04-08 00:30,8,2,6,0,0,0
2022-04-08 00:45,12,5,7,0,0,0
2022-04-08 01:00,11,1,10,0,0,0
2022-04-08 01:15,10,1,9,0,0,0
2022-04-08 01:30,5,1,4,0,0,0
2022-04-08 01:45,10,4,6,0,0,0
2022-04-08 02:00,15,5,10,0,0,0
2022-04-08 02:15,12,1,11,0,0,0
2022-04-08 02:30,6,2,4,0,0,0
2022-04-08 02:45,15,1,14,0,0,0
2022-04-08 03:00,12,3,9,0,0,0
2022-04-08 03:15,4,0,4,0,0,0
2022-04-08 03:30,3,1,2,0,0,0
2022-04-08 03:45,5,1,4,0,0,0
2022-04-08 04:00,8,0,8,0,0,0
2022-04-08 04:15,2,0,2,0,0,0
2022-04-08 04:30,4,1,3,0,0,0
2022-04-08 04:45,4,0,4,0,0,0
2022-04-08 05:00,4,2,2,0,0,0
2022-04-08 05:15,13,4,9,0,0,0
2022-04-08 05:30,16,8,8,0,0,0
2022-04-08 05:45,13,5,8,0,0,0
2022-04-08 06:00,24,4,20,0,0,0
2022-04-08 06:15,24,11,13,0,0,0
2022-04-08 06:30,46,15,31,0,0,0
2022-04-08 06:45,56,27,29,0,0,0
2022-04-08 07:00,86,43,43,0,0,0
2022-04-08 07:15,89,33,56,0,0,0
2022-04-08 07:30,119,63,56,0,0,0
2022-04-08 07:45,148,71,77,0,0,0
2022-04-08 08:00,111,48,63,0,0,0
2022-04-08 08:15,112,58,54,0,0,0
2022-04-08 08:30,86,43,43,0,0,0
2022-04-08 08:45,91,28,63,0,0,0
2022-04-08 09:00,86,38,48,0,0,0
2022-04-08 09:15,90,29,61,0,0,0
2022-04-08 09:30,76,26,50,0,0,0
2022-04-08 09:45,112,36,76,0,0,0
2022-04-08 10:00,99,35,64,0,0,0
2022-04-08 10:15,90,41,49,0,0,0
2022-04-08 10:30,71,39,32,0,0,0
2022-04-08 10:45,107,47,60,0,0,0
2022-04-08 11:00,98,45,53,0,0,0
2022-04-08 11:15,79,38,41,0,0,0
2022-04-08 11:30,118,50,68,0,0,0
2022-04-08 11:45,116,48,68,0,0,0
2022-04-08 12:00,100,49,51,0,0,0
2022-04-08 12:15,114,47,67,0,0,0
2022-04-08 12:30,113,59,54,0,0,0
2022-04-08 12:45,117,67,50,0,0,0
2022-04-08 13:00,128,63,65,0,0,0
2022-04-08 13:15,118,59,59,0,0,0
2022-04-08 13:30,105,44,61,0,0,0
2022-04-08 13:45,118,54,64,0,0,0
2022-04-08 14:00,132,61,71,0,0,0
2022-04-08 14:15,122,49,73,0,0,0
2022-04-08 14:30,130,60,70,0,0,0
2022-04-08 14:45,110,60,50,0,0,0
2022-04-08 15:00,115,53,62,0,0,0
2022-04-08 15:15,112,61,51,0,0,0
2022-04-08 15:30,129,59,70,0,0,0
2022-04-08 15:45,122,56,66,0,0,0
2022-04-08 16:00,120,70,50,0,0,0
2022-04-08 16:15,109,48,61,0,0,0
2022-04-08 16:30,104,48,56,0,0,0
2022-04-08 16:45,90,51,39,0,0,0
2022-04-08 17:00,100,52,48,0,0,0
2022-04-08 17:15,111,48,63,0,0,0
2022-04-08 17:30,141,75,66,0,0,0
2022-04-08 17:45,117,68,49,0,0,0
2022-04-08 18:00,119,49,70,0,0,0
2022-04-08 18:15,85,44,41,0,0,0
2022-04-08 18:30,99,43,56,0,0,0
2022-04-08 18:45,101,64,37,0,0,0
2022-04-08 19:00,119,72,47,0,0,0
2022-04-08 19:15,122,67,55,0,0,0
2022-04-08 19:30,81,47,34,0,0,0
2022-04-08 19:45,106,49,57,0,0,0
2022-04-08 20:00,98,56,42,0,0,0
2022-04-08 20:15,79,40,39,0,0,0
2022-04-08 20:30,70,27,43,0,0,0
2022-04-08 20:45,73,31,42,0,0,0
2022-04-08 21:00,67,36,31,0,0,0
2022-04-08 21:15,52,22,30,0,0,0
2022-04-08 21:30,46,19,27,0,0,0
2022-04-08 21:45,53,20,33,0,0,0
2022-04-08 22:00,50,25,25,0,0,0
2022-04-08 22:15,43,27,16,0,0,0
2022-04-08 22:30,60,16,44,0,0,0
2022-04-08 22:45,44,14,30,0,0,0
2022-04-08 23:00,39,14,25,0,0,0
2022-04-08 23:15,59,17,42,0,0,0
2022-04-08 23:30,48,23,25,0,0,0
2022-04-08 23:45,71,38,33,0,0,0
2022-04-09 00:00,80,39,41,0,0,0
2022-04-09 00:15,41,16,25,0,0,0
2022-04-09 00:30,40,23,17,0,0,0
2022-04-09 00:45,41,19,22,0,0,0
2022-04-09 01:00,32,18,14,0,0,0
2022-04-09 01:15,36,15,21,0,0,0
2022-04-09 01:30,23,11,12,0,0,0
2022-04-09 01:45,26,14,12,0,0,0
2022-04-09 02:00,33,22,11,0,0,0
2022-04-09 02:15,37,16,21,0,0,0
2022-04-09 02:30,20,10,10,0,0,0
2022-04-09 02:45,26,12,14,0,0,0
2022-04-09 03:00,31,6,25,0,0,0
2022-04-09 03:15,28,9,19,0,0,0
2022-04-09 03:30,28,4,24,0,0,0
2022-04-09 03:45,18,1,17,0,0,0
2022-04-09 04:00,21,2,19,0,0,0
2022-04-09 04:15,17,2,15,0,0,0
2022-04-09 04:30,16,3,13,0,0,0
2022-04-09 04:45,29,0,29,0,0,0
2022-04-09 05:00,10,0,10,0,0,0
2022-04-09 05:15,20,3,17,0,0,0
2022-04-09 05:30,25,7,18,0,0,0
2022-04-09 05:45,13,0,13,0,0,0
2022-04-09 06:00,8,2,6,0,0,0
2022-04-09 06:15,17,1,16,0,0,0
2022-04-09 06:30,13,5,8,0,0,0
2022-04-09 06:45,12,5,7,0,0,0
2022-04-09 07:00,25,8,17,0,0,0
2022-04-09 07:15,13,6,7,0,0,0
2022-04-09 07:30,26,13,13,0,0,0
2022-04-09 07:45,15,5,10,0,0,0
2022-04-09 08:00,16,8,8,0,0,0
2022-04-09 08:15,31,11,20,0,0,0
2022-04-09 08:30,21,8,13,0,0,0
2022-04-09 08:45,25,12,13,0,0,0
2022-04-09 09:00,39,14,25,0,0,0
2022-04-09 09:15,32,10,22,0,0,0
2022-04-09 09:30,42,11,31,0,0,0
2022-04-09 09:45,55,19,36,0,0,0
2022-04-09 10:00,40,16,24,0,0,0
2022-04-09 10:15,42,19,23,0,0,0
2022-04-09 10:30,54,19,35,0,0,0
2022-04-09 10:45,40,11,29,0,0,0
2022-04-09 11:00,48,16,32,0,0,0
2022-04-09 11:15,58,29,29,0,0,0
2022-04-09 11:30,52,14,38,0,0,0
2022-04-09 11:45,58,24,34,0,0,0
2022-04-09 12:00,61,24,37,0,0,0
2022-04-09 12:15,65,16,49,0,0,0
2022-04-09 12:30,75,32,43,0,0,0
2022-04-09 12:45,58,18,40,0,0,0
2022-04-09 13:00,67,32,35,0,0,0
2022-04-09 13:15,82,45,37,0,0,0
2022-04-09 13:30,83,38,45,0,0,0
2022-04-09 13:45,69,35,34,0,0,0
2022-04-09 14:00,56,19,37,0,0,0
2022-04-09 14:15,63,36,27,0,0,0
2022-04-09 14:30,55,26,29,0,0,0
2022-04-09 14:45,73,28,45,0,0,0
2022-04-09 15:00,65,35,30,0,0,0
2022-04-09 15:15,81,37,44,0,0,0
2022-04-09 15:30,78,29,49,0,0,0
2022-04-09 15:45,61,23,38,0,0,0
2022-04-09 16:00,54,26,28,0,0,0
2022-04-09 16:15,63,36,27,0,0,0
2022-04-09 16:30,57,24,33,0,0,0
2022-04-09 16:45,65,27,38,0,0,0
2022-04-09 17:00,48,23,25,0,0,0
2022-04-09 17:15,49,19,30,0,0,0
2022-04-09 17:30,69,23,46,0,0,0
2022-04-09 17:45,71,41,30,0,0,0
2022-04-09 18:00,65,32,33,0,0,0
2022-04-09 18:15,75,30,45,0,0,0
2022-04-09 18:30,70,36,34,0,0,0
2022-04-09 18:45,77,46,31,0,0,0
2022-04-09 19:00,54,26,28,0,0,0
2022-04-09 19:15,80,34,46,0,0,0
2022-04-09 19:30,50,20,30,0,0,0
2022-04-09 19:45,55,27,28,0,0,0
2022-04-09 20:00,80,43,37,0,0,0
2022-04-09 20:15,63,30,33,0,0,0
2022-04-09 20:30,45,23,22,0,0,0
2022-04-09 20:45,58,26,32,0,0,0
2022-04-09 21:00,47,18,29,0,0,0
2022-04-09 21:15,45,28,17,0,0,0
2022-04-09 21:30,46,18,28,0,0,0
2022-04-09 21:45,36,15,21,0,0,0
2022-04-09 22:00,45,19,26,0,0,0
2022-04-09 22:15,47,15,32,0,0,0
2022-04-09 22:30,58,17,41,0,0,0
2022-04-09 22:45,46,12,34,0,0,0
2022-04-09 23:00,34,16,18,0,0,0
2022-04-09 23:15,34,10,24,0,0,0
2022-04-09 23:30,37,18,19,0,0,0
2022-04-09 23:45,53,25,28,0,0,0
2022-04-10 00:00,42,22,20,0,0,0
2022-04-10 00:15,37,26,11,0,0,0
2022-04-10 00:30,49,28,21,0,0,0
2022-04-10 00:45,31,14,17,0,0,0
2022-04-10 01:00,44,26,18,0,0,0
2022-04-10 01:15,25,7,18,0,0,0
2022-04-10 01:30,16,11,5,0,0,0
2022-04-10 01:45,22,11,11,0,0,0
2022-04-10 02:00,17,9,8,0,0,0
2022-04-10 02:15,26,9,17,0,0,0
2022-04-10 02:30,24,14,10,0,0,0
2022-04-10 02:45,24,7,17,0,0,0
2022-04-10 03:00,21,2,19,0,0,0
2022-04-10 03:15,31,9,22,0,0,0
2022-04-10 03:30,16,7,9,0,0,0
2022-04-10 03:45,21,9,12,0,0,0
2022-04-10 04:00,18,1,17,0,0,0
2022-04-10 04:15,23,5,18,0,0,0
2022-04-10 04:30,11,0,11,0,0,0
2022-04-10 04:45,22,2,20,0,0,0
2022-04-10 05:00,5,1,4,0,0,0
2022-04-10 05:15,22,0,22,0,0,0
2022-04-10 05:30,21,1,20,0,0,0
2022-04-10 05:45,10,2,8,0,0,0
2022-04-10 06:00,18,2,16,0,0,0
2022-04-10 06:15,15,3,12,0,0,0
2022-04-10 06:30,11,2,9,0,0,0
2022-04-10 06:45,17,1,16,0,0,0
2022-04-10 07:00,13,3,10,0,0,0
2022-04-10 07:15,7,1,6,0,0,0
2022-04-10 07:30,13,2,11,0,0,0
2022-04-10 07:45,10,1,9,0,0,0
2022-04-10 08:00,12,2,10,0,0,0
2022-04-10 08:15,12,4,8,0,0,0
2022-04-10 08:30,14,6,8,0,0,0
2022-04-10 08:45,19,6,13,0,0,0
2022-04-10 09:00,23,8,15,0,0,0
2022-04-10 09:15,27,11,16,0,0,0
2022-04-10 09:30,21,10,11,0,0,0
2022-04-10 09:45,33,13,20,0,0,0
2022-04-10 10:00,35,9,26,0,0,0
2022-04-10 10:15,28,14,14,0,0,0
2022-04-10 10:30,34,14,20,0,0,0
2022-04-10 10:45,46,19,27,0,0,0
2022-04-10 11:00,39,20,19,0,0,0
2022-04-10 11:15,42,11,31,0,0,0
2022-04-10 11:30,30,15,15,0,0,0
2022-04-10 11:45,43,20,23,0,0,0
2022-04-10 12:00,50,9,41,0,0,0
2022-04-10 12:15,53,24,29,0,0,0
2022-04-10 12:30,58,24,34,0,0,0
2022-04-10 12:45,70,35,35,0,0,0
2022-04-10 13:00,42,20,22,0,0,0
2022-04-10 13:15,57,17,40,0,0,0
2022-04-10 13:30,53,31,22,0,0,0
2022-04-10 13:45,79,41,38,0,0,0
2022-04-10 14:00,70,27,43,0,0,0
2022-04-10 14:15,52,19,33,0,0,0
2022-04-10 14:30,63,24,39,0,0,0
2022-04-10 14:45,53,31,22,0,0,0
2022-04-10 15:00,63,20,43,0,0,0
2022-04-10 15:15,59,29,30,0,0,0
2022-04-10 15:30,66,29,37,0,0,0
2022-04-10 15:45,74,37,37,0,0,0
2022-04-10 16:00,60,21,39,0,0,0
2022-04-10 16:15,88,42,46,0,0,0
2022-04-10 16:30,72,27,45,0,0,0
2022-04-10 16:45,57,30,27,0,0,0
2022-04-10 17:00,65,38,27,0,0,0
2022-04-10 17:15,83,37,46,0,0,0
2022-04-10 17:30,72,43,29,0,0,0
2022-04-10 17:45,73,43,30,0,0,0
2022-04-10 18:00,72,25,47,0,0,0
2022-04-10 18:15,68,26,42,0,0,0
2022-04-10 18:30,56,30,26,0,0,0
2022-04-10 18:45,49,18,31,0,0,0
2022-04-10 19:00,76,40,36,0,0,0
2022-04-10 19:15,71,34,37,0,0,0
2022-04-10 19:30,63,34,29,0,0,0
2022-04-10 19:45,75,32,43,0,0,0
2022-04-10 20:00,60,18,42,0,0,0
2022-04-10 20:15,75,35,40,0,0,0
2022-04-10 20:30,38,18,20,0,0,0
2022-04-10 20:45,34,11,23,0,0,0
2022-04-10 21:00,39,16,23,0,0,0
2022-04-10 21:15,43,15,28,0,0,0
2022-04-10 21:30,29,8,21,0,0,0
2022-04-10 21:45,26,8,18,0,0,0
2022-04-10 22:00,31,14,17,0,0,0
2022-04-10 22:15,27,7,20,0,0,0
2022-04-10 22:30,46,7,39,0,0,0
2022-04-10 22:45,26,7,19,0,0,0
2022-04-10 23:00,24,3,21,0,0,0
2022-04-10 23:15,37,10,27,0,0,0
2022-04-10 23:30,19,7,12,0,0,0
2022-04-10 23:45,10,3,7,0,0,0
2022-04-11 00:00,14,4,10,0,0,0
2022-04-11 00:15,5,2,3,0,0,0
2022-04-11 00:30,6,1,5,0,0,0
2022-04-11 00:45,8,2,6,0,0,0
2022-04-11 01:00,2,2,0,0,0,0
2022-04-11 01:15,6,1,5,0,0,0
2022-04-11 01:30,4,0,4,0,0,0
2022-04-11 01:45,3,1,2,0,0,0
2022-04-11 02:00,2,1,1,0,0,0
2022-04-11 02:15,1,1,0,0,0,0
2022-04-11 02:30,1,1,0,0,0,0
2022-04-11 02:45,2,1,1,0,0,0
2022-04-11 03:00,1,0,1,0,0,0
2022-04-11 03:15,0,0,0,0,0,0
2022-04-11 03:30,0,0,0,0,0,0
2022-04-11 03:45,1,0,1,0,0,0
2022-04-11 04:00,0,0,0,0,0,0
2022-04-11 04:15,4,2,2,0,0,0
2022-04-11 04:30,0,0,0,0,0,0
2022-04-11 04:45,6,0,6,0,0,0
2022-04-11 05:00,2,1,1,0,0,0
2022-04-11 05:15,15,3,12,0,0,0
2022-04-11 05:30,11,6,5,0,0,0
2022-04-11 05:45,12,10,2,0,0,0
2022-04-11 06:00,30,12,18,0,0,0
2022-04-11 06:15,30,10,20,0,0,0
2022-04-11 06:30,35,15,20,0,0,0
2022-04-11 06:45,66,26,40,0,0,0
2022-04-11 07:00,67,35,32,0,0,0
2022-04-11 07:15,93,45,48,0,0,0
2022-04-11 07:30,90,39,51,0,0,0
2022-04-11 07:45,112,54,58,0,0,0
2022-04-11 08:00,120,53,67,0,0,0
2022-04-11 08:15,95,50,45,0,0,0
2022-04-11 08:30,103,50,53,0,0,0
2022-04-11 08:45,116,59,57,0,0,0
2022-04-11 09:00,94,42,52,0,0,0
2022-04-11 09:15,86,29,57,0,0,0
2022-04-11 09:30,69,26,43,0,0,0
2022-04-11 09:45,120,47,73,0,0,0
2022-04-11 10:00,111,32,79,0,0,0
2022-04-11 10:15,65,21,44,0,0,0
2022-04-11 10:30,79,31,48,0,0,0
2022-04-11 10:45,82,33,49,0,0,0
2022-04-11 11:00,72,31,41,0,0,0
2022-04-11 11:15,76,40,36,0,0,0
2022-04-11 11:30,92,45,47,0,0,0
2022-04-11 11:45,131,61,70,0,0,0
2022-04-11 12:00,119,42,77,0,0,0
2022-04-11 12:15,108,46,62,0,0,0
2022-04-11 12:30,107,54,53,0,0,0
2022-04-11 12:45,105,45,60,0,0,0
2022-04-11 13:00,107,59,48,0,0,0
2022-04-11 13:15,113,61,52,0,0,0
2022-04-11 13:30,101,36,65,0,0,0
2022-04-11 13:45,118,56,62,0,0,0
2022-04-11 14:00,122,59,63,0,0,0
2022-04-11 14:15,113,62,51,0,0,0
2022-04-11 14:30,85,37,48,0,0,0
2022-04-11 14:45,106,50,56,0,0,0
2022-04-11 15:00,84,40,44,0,0,0
2022-04-11 15:15,111,66,45,0,0,0
2022-04-11 15:30,124,67,57,0,0,0
2022-04-11 15:45,176,95,81,0,0,0
2022-04-11 16:00,146,86,60,0,0,0
2022-04-11 16:15,141,69,72,0,0,0
2022-04-11 16:30,168,93,75,0,0,0
2022-04-11 16:45,182,97,85,0,0,0
2022-04-11 17:00,190,102,88,0,0,0
2022-04-11 17:15,139,71,68,0,0,0
2022-04-11 17:30,170,87,83,0,0,0
2022-04-11 17:45,194,106,88,0,0,0
2022-04-11 18:00,190,102,88,0,0,0
2022-04-11 18:15,151,88,63,0,0,0
2022-04-11 18:30,113,71,42,0,0,0
2022-04-11 18:45,135,67,68,0,0,0
2022-04-11 19:00,140,98,42,0,0,0
2022-04-11 19:15,133,86,47,0,0,0
2022-04-11 19:30,164,93,71,0,0,0
2022-04-11 19:45,125,77,48,0,0,0
2022-04-11 20:00,107,57,50,0,0,0
2022-04-11 20:15,87,50,37,0,0,0
2022-04-11 20:30,54,29,25,0,0,0
2022-04-11 20:45,81,49,32,0,0,0
2022-04-11 21:00,57,20,37,0,0,0
2022-04-11 21:15,42,21,21,0,0,0
2022-04-11 21:30,46,21,25,0,0,0
2022-04-11 21:45,69,30,39,0,0,0
2022-04-11 22:00,51,12,39,0,0,0
2022-04-11 22:15,61,17,44,0,0,0
2022-04-11 22:30,87,15,72,0,0,0
2022-04-11 22:45,47,5,42,0,0,0
2022-04-11 23:00,46,12,34,0,0,0
2022-04-11 23:15,29,3,26,0,0,0
2022-04-11 23:30,25,3,22,0,0,0
2022-04-11 23:45,19,5,14,0,0,0
2022-04-12 00:00,10,2,8,0,0,0
2022-04-12 00:15,15,6,9,0,0,0
2022-04-12 00:30,20,6,14,0,0,0
2022-04-12 00:45,5,3,2,0,0,0
2022-04-12 01:00,12,7,5,0,0,0
2022-04-12 01:15,5,3,2,0,0,0
2022-04-12 01:30,3,2,1,0,0,0
2022-04-12 01:45,2,2,0,0,0,0
2022-04-12 02:00,7,0,7,0,0,0
2022-04-12 02:15,3,2,1,0,0,0
2022-04-12 02:30,2,0,2,0,0,0
2022-04-12 02:45,3,2,1,0,0,0
2022-04-12 03:00,1,0,1,0,0,0
2022-04-12 03:15,2,0,2,0,0,0
2022-04-12 03:30,2,0,2,0,0,0
2022-04-12 03:45,0,0,0,0,0,0
2022-04-12 04:00,1,0,1,0,0,0
2022-04-12 04:15,2,0,2,0,0,0
2022-04-12 04:30,0,0,0,0,0,0
2022-04-12 04:45,1,0,1,0,0,0
2022-04-12 05:00,4,1,3,0,0,0
2022-04-12 05:15,13,4,9,0,0,0
2022-04-12 05:30,10,8,2,0,0,0
2022-04-12 05:45,20,16,4,0,0,0
2022-04-12 06:00,30,10,20,0,0,0
2022-04-12 06:15,26,9,17,0,0,0
2022-04-12 06:30,35,13,22,0,0,0
2022-04-12 06:45,81,47,34,0,0,0
2022-04-12 07:00,82,46,36,0,0,0
2022-04-12 07:15,83,41,42,0,0,0
2022-04-12 07:30,113,57,56,0,0,0
2022-04-12 07:45,179,88,91,0,0,0
2022-04-12 08:00,116,56,60,0,0,0
2022-04-12 08:15,114,61,53,0,0,0
2022-04-12 08:30,129,76,53,0,0,0
2022-04-12 08:45,138,64,74,0,0,0
2022-04-12 09:00,101,35,66,0,0,0
2022-04-12 09:15,66,26,40,0,0,0
2022-04-12 09:30,88,45,43,0,0,0
2022-04-12 09:45,115,35,80,0,0,0
2022-04-12 10:00,123,41,82,0,0,0
2022-04-12 10:15,90,43,47,0,0,0
2022-04-12 10:30,80,31,49,0,0,0
2022-04-12 10:45,85,32,53,0,0,0
2022-04-12 11:00,72,23,49,0,0,0
2022-04-12 11:15,87,43,44,0,0,0
2022-04-12 11:30,106,41,65,0,0,0
2022-04-12 11:45,141,52,89,0,0,0
2022-04-12 12:00,139,63,76,0,0,0
2022-04-12 12:15,117,58,59,0,0,0
2022-04-12 12:30,115,52,63,0,0,0
2022-04-12 12:45,115,59,56,0,0,0
2022-04-12 13:00,124,71,53,0,0,0
2022-04-12 13:15,106,50,56,0,0,0
2022-04-12 13:30,115,53,62,0,0,0
2022-04-12 13:45,123,68,55,0,0,0
2022-04-12 14:00,119,58,61,0,0,0
2022-04-12 14:15,128,74,54,0,0,0
2022-04-12 14:30,136,61,75,0,0,0
2022-04-12 14:45,132,61,71,0,0,0
2022-04-12 15:00,109,60,49,0,0,0
2022-04-12 15:15,122,65,57,0,0,0
2022-04-12 15:30,129,67,62,0,0,0
2022-04-12 15:45,174,94,80,0,0,0
2022-04-12 16:00,166,95,71,0,0,0
2022-04-12 16:15,156,77,79,0,0,0
2022-04-12 16:30,157,82,75,0,0,0
2022-04-12 16:45,185,102,83,0,0,0
2022-04-12 17:00,169,97,72,0,0,0
2022-04-12 17:15,182,102,80,0,0,0
2022-04-12 17:30,162,74,88,0,0,0
2022-04-12 17:45,190,105,85,0,0,0
2022-04-12 18:00,179,94,85,0,0,0
2022-04-12 18:15,162,90,72,0,0,0
2022-04-12 18:30,129,64,65,0,0,0
2022-04-12 18:45,148,81,67,0,0,0
2022-04-12 19:00,122,62,60,0,0,0
2022-04-12 19:15,142,86,56,0,0,0
2022-04-12 19:30,111,53,58,0,0,0
2022-04-12 19:45,113,64,49,0,0,0
2022-04-12 20:00,92,51,41,0,0,0
2022-04-12 20:15,96,56,40,0,0,0
2022-04-12 20:30,95,46,49,0,0,0
2022-04-12 20:45,99,44,55,0,0,0
2022-04-12 21:00,45,13,32,0,0,0
2022-04-12 21:15,74,38,36,0,0,0
2022-04-12 21:30,69,25,44,0,0,0
2022-04-12 21:45,62,18,44,0,0,0
2022-04-12 22:00,62,17,45,0,0,0
2022-04-12 22:15,54,27,27,0,0,0
2022-04-12 22:30,80,8,72,0,0,0
2022-04-12 22:45,44,12,32,0,0,0
2022-04-12 23:00,45,8,37,0,0,0
2022-04-12 23:15,40,13,27,0,0,0
2022-04-12 23:30,25,8,17,0,0,0
2022-04-12 23:45,28,9,19,0,0,0
2022-04-13 00:00,20,10,10,0,0,0
2022-04-13 00:15,15,7,8,0,0,0
2022-04-13 00:30,17,5,12,0,0,0
2022-04-13 00:45,22,7,15,0,0,0
2022-04-13 01:00,16,7,9,0,0,0
2022-04-13 01:15,6,5,1,0,0,0
2022-04-13 01:30,4,2,2,0,0,0
2022-04-13 01:45,3,2,1,0,0,0
2022-04-13 02:00,1,1,0,0,0,0
2022-04-13 02:15,2,1,1,0,0,0
2022-04-13 02:30,2,1,1,0,0,0
2022-04-13 02:45,0,0,0,0,0,0
2022-04-13 03:00,1,1,0,0,0,0
2022-04-13 03:15,1,0,1,0,0,0
2022-04-13 03:30,3,3,0,0,0,0
2022-04-13 03:45,3,0,3,0,0,0
2022-04-13 04:00,1,1,0,0,0,0
2022-04-13 04:15,1,0,1,0,0,0
2022-04-13 04:30,3,1,2,0,0,0
2022-04-13 04:45,6,1,5,0,0,0
2022-04-13 05:00,0,0,0,0,0,0
2022-04-13 05:15,9,3,6,0,0,0
2022-04-13 05:30,22,13,9,0,0,0
2022-04-13 05:45,18,9,9,0,0,0
2022-04-13 06:00,29,8,21,0,0,0
2022-04-13 06:15,31,16,15,0,0,0
2022-04-13 06:30,53,22,31,0,0,0
2022-04-13 06:45,63,40,23,0,0,0
2022-04-13 07:00,83,35,48,0,0,0
2022-04-13 07:15,83,43,40,0,0,0
2022-04-13 07:30,113,58,55,0,0,0
2022-04-13 07:45,158,73,85,0,0,0
2022-04-13 08:00,116,53,63,0,0,0
2022-04-13 08:15,111,62,49,0,0,0
2022-04-13 08:30,136,70,66,0,0,0
2022-04-13 08:45,104,42,62,0,0,0
2022-04-13 09:00,99,41,58,0,0,0
2022-04-13 09:15,89,32,57,0,0,0
2022-04-13 09:30,80,31,49,0,0,0
2022-04-13 09:45,121,45,76,0,0,0
2022-04-13 10:00,117,33,84,0,0,0
2022-04-13 10:15,102,43,59,0,0,0
2022-04-13 10:30,82,39,43,0,0,0
2022-04-13 10:45,77,36,41,0,0,0
2022-04-13 11:00,100,40,60,0,0,0
2022-04-13 11:15,81,34,47,0,0,0
2022-04-13 11:30,109,51,58,0,0,0
2022-04-13 11:45,111,43,68,0,0,0
2022-04-13 12:00,123,42,81,0,0,0
2022-04-13 12:15,124,57,67,0,0,0
2022-04-13 12:30,131,66,65,0,0,0
2022-04-13 12:45,92,45,47,0,0,0
2022-04-13 13:00,136,72,64,0,0,0
2022-04-13 13:15,96,42,54,0,0,0
2022-04-13 13:30,110,48,62,0,0,0
2022-04-13 13:45,146,73,73,0,0,0
2022-04-13 14:00,133,81,52,0,0,0
2022-04-13 14:15,118,71,47,0,0,0
2022-04-13 14:30,109,56,53,0,0,0
2022-04-13 14:45,112,52,60,0,0,0
2022-04-13 15:00,121,56,65,0,0,0
2022-04-13 15:15,101,49,52,0,0,0
2022-04-13 15:30,121,65,56,0,0,0
2022-04-13 15:45,144,81,63,0,0,0
2022-04-13 16:00,160,85,75,0,0,0
2022-04-13 16:15,150,81,69,0,0,0
2022-04-13 16:30,159,80,79,0,0,0
2022-04-13 16:45,155,86,69,0,0,0
2022-04-13 17:00,157,81,76,0,0,0
2022-04-13 17:15,190,83,107,0,0,0
2022-04-13 17:30,161,97,64,0,0,0
2022-04-13 17:45,161,95,66,0,0,0
2022-04-13 18:00,125,70,55,0,0,0
2022-04-13 18:15,137,80,57,0,0,0
2022-04-13 18:30,126,71,55,0,0,0
2022-04-13 18:45,149,80,69,0,0,0
2022-04-13 19:00,141,70,71,0,0,0
2022-04-13 19:15,130,82,48,0,0,0
2022-04-13 19:30,109,64,45,0,0,0
2022-04-13 19:45,99,57,42,0,0,0
2022-04-13 20:00,111,57,54,0,0,0
2022-04-13 20:15,69,28,41,0,0,0
2022-04-13 20:30,56,31,25,0,0,0
2022-04-13 20:45,78,43,35,0,0,0
2022-04-13 21:00,49,20,29,0,0,0
2022-04-13 21:15,63,27,36,0,0,0
2022-04-13 21:30,53,27,26,0,0,0
2022-04-13 21:45,53,22,31,0,0,0
2022-04-13 22:00,45,25,20,0,0,0
2022-04-13 22:15,55,24,31,0,0,0
2022-04-13 22:30,64,28,36,0,0,0
2022-04-13 22:45,85,33,52,0,0,0
2022-04-13 23:00,61,30,31,0,0,0
2022-04-13 23:15,41,12,29,0,0,0
2022-04-13 23:30,65,22,43,0,0,0
2022-04-13 23:45,44,36,8,0,0,0
2022-04-14 00:00,24,20,4,0,0,0
2022-04-14 00:15,27,10,17,0,0,0
2022-04-14 00:30,12,7,5,0,0,0
2022-04-14 00:45,17,6,11,0,0,0
2022-04-14 01:00,14,2,12,0,0,0
2022-04-14 01:15,15,9,6,0,0,0
2022-04-14 01:30,15,7,8,0,0,0
2022-04-14 01:45,12,3,9,0,0,0
2022-04-14 02:00,16,5,11,0,0,0
2022-04-14 02:15,9,3,6,0,0,0
2022-04-14 02:30,17,1,16,0,0,0
2022-04-14 02:45,15,1,14,0,0,0
2022-04-14 03:00,13,1,12,0,0,0
2022-04-14 03:15,21,1,20,0,0,0
2022-04-14 03:30,21,1,20,0,0,0
2022-04-14 03:45,8,0,8,0,0,0
2022-04-14 04:00,15,1,14,0,0,0
2022-04-14 04:15,5,0,5,0,0,0
2022-04-14 04:30,8,1,7,0,0,0
2022-04-14 04:45,7,2,5,0,0,0
2022-04-14 05:00,3,1,2,0,0,0
2022-04-14 05:15,15,3,12,0,0,0
2022-04-14 05:30,15,6,9,0,0,0
2022-04-14 05:45,19,11,8,0,0,0
2022-04-14 06:00,29,10,19,0,0,0
2022-04-14 06:15,31,10,21,0,0,0
2022-04-14 06:30,29,13,16,0,0,0
2022-04-14 06:45,54,26,28,0,0,0
2022-04-14 07:00,73,35,38,0,0,0
2022-04-14 07:15,65,33,32,0,0,0
2022-04-14 07:30,96,49,47,0,0,0
2022-04-14 07:45,101,47,54,0,0,0
2022-04-14 08:00,117,48,69,0,0,0
2022-04-14 08:15,104,57,47,0,0,0
2022-04-14 08:30,95,46,49,0,0,0
2022-04-14 08:45,119,56,63,0,0,0
2022-04-14 09:00,86,40,46,0,0,0
2022-04-14 09:15,85,36,49,0,0,0
2022-04-14 09:30,82,36,46,0,0,0
2022-04-14 09:45,122,38,84,0,0,0
2022-04-14 10:00,98,28,70,0,0,0
2022-04-14 10:15,70,28,42,0,0,0
2022-04-14 10:30,63,26,37,0,0,0
2022-04-14 10:45,66,21,45,0,0,0
2022-04-14 11:00,91,33,58,0,0,0
2022-04-14 11:15,92,47,45,0,0,0
2022-04-14 11:30,91,34,57,0,0,0
2022-04-14 11:45,100,43,57,0,0,0
2022-04-14 12:00,120,58,62,0,0,0
2022-04-14 12:15,126,51,75,0,0,0
2022-04-14 12:30,105,50,55,0,0,0
2022-04-14 12:45,110,58,52,0,0,0
2022-04-14 13:00,98,47,51,0,0,0
2022-04-14 13:15,111,59,52,0,0,0
2022-04-14 13:30,131,64,67,0,0,0
2022-04-14 13:45,131,64,67,0,0,0
2022-04-14 14:00,118,64,54,0,0,0
2022-04-14 14:15,129,75,54,0,0,0
2022-04-14 14:30,109,44,65,0,0,0
2022-04-14 14:45,113,63,50,0,0,0
2022-04-14 15:00,115,52,63,0,0,0
2022-04-14 15:15,110,39,71,0,0,0
2022-04-14 15:30,117,54,63,0,0,0
2022-04-14 15:45,137,75,62,0,0,0
2022-04-14 16:00,131,75,56,0,0,0
2022-04-14 16:15,137,73,64,0,0,0
2022-04-14 16:30,122,58,64,0,0,0
2022-04-14 16:45,112,57,55,0,0,0
2022-04-14 17:00,112,54,58,0,0,0
2022-04-14 17:15,152,74,78,0,0,0
2022-04-14 17:30,143,77,66,0,0,0
2022-04-14 17:45,157,81,76,0,0,0
2022-04-14 18:00,137,67,70,0,0,0
2022-04-14 18:15,134,76,58,0,0,0
2022-04-14 18:30,108,61,47,0,0,0
2022-04-14 18:45,107,72,35,0,0,0
2022-04-14 19:00,97,55,42,0,0,0
2022-04-14 19:15,117,73,44,0,0,0
2022-04-14 19:30,92,53,39,0,0,0
2022-04-14 19:45,106,45,61,0,0,0
2022-04-14 20:00,107,65,42,0,0,0
2022-04-14 20:15,78,46,32,0,0,0
2022-04-14 20:30,44,29,15,0,0,0
2022-04-14 20:45,54,29,25,0,0,0
2022-04-14 21:00,44,14,30,0,0,0
2022-04-14 21:15,43,21,22,0,0,0
2022-04-14 21:30,40,21,19,0,0,0
2022-04-14 21:45,43,20,23,0,0,0
2022-04-14 22:00,55,17,38,0,0,0
2022-04-14 22:15,52,22,30,0,0,0
2022-04-14 22:30,74,20,54,0,0,0
2022-04-14 22:45,45,8,37,0,0,0
2022-04-14 23:00,28,10,18,0,0,0
2022-04-14 23:15,34,14,20,0,0,0
2022-04-14 23:30,48,9,39,0,0,0
2022-04-14 23:45,31,12,19,0,0,0
2022-04-15 00:00,33,10,23,0,0,0
2022-04-15 00:15,33,7,26,0,0,0
2022-04-15 00:30,28,5,23,0,0,0
2022-04-15 00:45,26,13,13,0,0,0
2022-04-15 01:00,20,3,17,0,0,0
2022-04-15 01:15,20,3,17,0,0,0
2022-04-15 01:30,27,4,23,0,0,0
2022-04-15 01:45,11,5,6,0,0,0
2022-04-15 02:00,19,2,17,0,0,0
2022-04-15 02:15,10,7,3,0,0,0
2022-04-15 02:30,13,2,11,0,0,0
2022-04-15 02:45,11,3,8,0,0,0
2022-04-15 03:00,10,3,7,0,0,0
2022-04-15 03:15,6,2,4,0,0,0
2022-04-15 03:30,3,1,2,0,0,0
2022-04-15 03:45,4,3,1,0,0,0
2022-04-15 04:00,9,4,5,0,0,0
2022-04-15 04:15,5,1,4,0,0,0
2022-04-15 04:30,2,0,2,0,0,0
2022-04-15 04:45,5,1,4,0,0,0
2022-04-15 05:00,3,2,1,0,0,0
2022-04-15 05:15,1,0,1,0,0,0
2022-04-15 05:30,7,2,5,0,0,0
2022-04-15 05:45,7,3,4,0,0,0
2022-04-15 06:00,3,1,2,0,0,0
2022-04-15 06:15,5,0,5,0,0,0
2022-04-15 06:30,5,3,2,0,0,0
2022-04-15 06:45,9,4,5,0,0,0
2022-04-15 07:00,9,4,5,0,0,0
2022-04-15 07:15,13,7,6,0,0,0
2022-04-15 07:30,10,5,5,0,0,0
2022-04-15 07:45,10,1,9,0,0,0
2022-04-15 08:00,13,5,8,0,0,0
2022-04-15 08:15,13,10,3,0,0,0
2022-04-15 08:30,12,5,7,0,0,0
2022-04-15 08:45,20,9,11,0,0,0
2022-04-15 09:00,23,11,12,0,0,0
2022-04-15 09:15,17,5,12,0,0,0
2022-04-15 09:30,35,12,23,0,0,0
2022-04-15 09:45,27,12,15,0,0,0
2022-04-15 10:00,29,7,22,0,0,0
2022-04-15 10:15,25,14,11,0,0,0
2022-04-15 10:30,36,17,19,0,0,0
2022-04-15 10:45,34,17,17,0,0,0
2022-04-15 11:00,32,10,22,0,0,0
2022-04-15 11:15,49,27,22,0,0,0
2022-04-15 11:30,40,17,23,0,0,0
2022-04-15 11:45,33,17,16,0,0,0
2022-04-15 12:00,52,21,31,0,0,0
2022-04-15 12:15,39,18,21,0,0,0
2022-04-15 12:30,46,18,28,0,0,0
2022-04-15 12:45,56,25,31,0,0,0
2022-04-15 13:00,42,14,28,0,0,0
2022-04-15 13:15,58,26,32,0,0,0
2022-04-15 13:30,66,33,33,0,0,0
2022-04-15 13:45,43,26,17,0,0,0
2022-04-15 14:00,66,27,39,0,0,0
2022-04-15 14:15,63,30,33,0,0,0
2022-04-15 14:30,54,20,34,0,0,0
2022-04-15 14:45,62,29,33,0,0,0
2022-04-15 15:00,56,23,33,0,0,0
2022-04-15 15:15,46,25,21,0,0,0
2022-04-15 15:30,52,20,32,0,0,0
2022-04-15 15:45,61,33,28,0,0,0
2022-04-15 16:00,52,29,23,0,0,0
2022-04-15 16:15,40,18,22,0,0,0
2022-04-15 16:30,60,31,29,0,0,0
2022-04-15 16:45,44,16,28,0,0,0
2022-04-15 17:00,49,17,32,0,0,0
2022-04-15 17:15,61,39,22,0,0,0
2022-04-15 17:30,60,27,33,0,0,0
2022-04-15 17:45,73,33,40,0,0,0
2022-04-15 18:00,64,27,37,0,0,0
2022-04-15 18:15,46,15,31,0,0,0
2022-04-15 18:30,53,26,27,0,0,0
2022-04-15 18:45,48,21,27,0,0,0
2022-04-15 19:00,48,24,24,0,0,0
2022-04-15 19:15,59,19,40,0,0,0
2022-04-15 19:30,62,30,32,0,0,0
2022-04-15 19:45,56,21,35,0,0,0
2022-04-15 20:00,56,17,39,0,0,0
2022-04-15 20:15,46,22,24,0,0,0
2022-04-15 20:30,37,22,15,0,0,0
2022-04-15 20:45,34,17,17,0,0,0
2022-04-15 21:00,38,19,19,0,0,0
2022-04-15 21:15,25,13,12,0,0,0
2022-04-15 21:30,29,16,13,0,0,0
2022-04-15 21:45,24,6,18,0,0,0
2022-04-15 22:00,37,15,22,0,0,0
2022-04-15 22:15,37,15,22,0,0,0
2022-04-15 22:30,57,17,40,0,0,0
2022-04-15 22:45,26,8,18,0,0,0
2022-04-15 23:00,33,8,25,0,0,0
2022-04-15 23:15,32,3,29,0,0,0
2022-04-15 23:30,19,5,14,0,0,0
2022-04-15 23:45,15,9,6,0,0,0
2022-04-16 00:00,11,6,5,0,0,0
2022-04-16 00:15,13,5,8,0,0,0
2022-04-16 00:30,13,5,8,0,0,0
2022-04-16 00:45,11,5,6,0,0,0
2022-04-16 01:00,14,4,10,0,0,0
2022-04-16 01:15,23,6,17,0,0,0
2022-04-16 01:30,11,5,6,0,0,0
2022-04-16 01:45,9,1,8,0,0,0
2022-04-16 02:00,10,2,8,0,0,0
2022-04-16 02:15,9,5,4,0,0,0
2022-04-16 02:30,3,0,3,0,0,0
2022-04-16 02:45,3,1,2,0,0,0
2022-04-16 03:00,7,2,5,0,0,0
2022-04-16 03:15,6,0,6,0,0,0
2022-04-16 03:30,5,4,1,0,0,0
2022-04-16 03:45,4,0,4,0,0,0
2022-04-16 04:00,1,0,1,0,0,0
2022-04-16 04:15,2,1,1,0,0,0
2022-04-16 04:30,6,2,4,0,0,0
2022-04-16 04:45,8,2,6,0,0,0
2022-04-16 05:00,1,0,1,0,0,0
2022-04-16 05:15,9,1,8,0,0,0
2022-04-16 05:30,8,1,7,0,0,0
2022-04-16 05:45,6,0,6,0,0,0
2022-04-16 06:00,11,2,9,0,0,0
2022-04-16 06:15,6,5,1,0,0,0
2022-04-16 06:30,8,3,5,0,0,0
2022-04-16 06:45,6,3,3,0,0,0
2022-04-16 07:00,11,5,6,0,0,0
2022-04-16 07:15,13,7,6,0,0,0
2022-04-16 07:30,16,3,13,0,0,0
2022-04-16 07:45,14,6,8,0,0,0
2022-04-16 08:00,20,7,13,0,0,0
2022-04-16 08:15,10,6,4,0,0,0
2022-04-16 08:30,32,12,20,0,0,0
2022-04-16 08:45,30,14,16,0,0,0
2022-04-16 09:00,45,21,24,0,0,0
2022-04-16 09:15,54,21,33,0,0,0
2022-04-16 09:30,55,21,34,0,0,0
2022-04-16 09:45,62,24,38,0,0,0
2022-04-16 10:00,60,19,41,0,0,0
2022-04-16 10:15,69,37,32,0,0,0
2022-04-16 10:30,75,30,45,0,0,0
2022-04-16 10:45,65,26,39,0,0,0
2022-04-16 11:00,61,22,39,0,0,0
2022-04-16 11:15,73,33,40,0,0,0
2022-04-16 11:30,80,34,46,0,0,0
2022-04-16 11:45,74,29,45,0,0,0
2022-04-16 12:00,67,31,36,0,0,0
2022-04-16 12:15,79,32,47,0,0,0
2022-04-16 12:30,71,31,40,0,0,0
2022-04-16 12:45,92,40,52,0,0,0
2022-04-16 13:00,79,40,39,0,0,0
2022-04-16 13:15,83,45,38,0,0,0
2022-04-16 13:30,76,37,39,0,0,0
2022-04-16 13:45,98,52,46,0,0,0
2022-04-16 14:00,81,42,39,0,0,0
2022-04-16 14:15,79,43,36,0,0,0
2022-04-16 14:30,99,54,45,0,0,0
2022-04-16 14:45,97,66,31,0,0,0
2022-04-16 15:00,70,35,35,0,0,0
2022-04-16 15:15,69,35,34,0,0,0
2022-04-16 15:30,75,39,36,0,0,0
2022-04-16 15:45,77,32,45,0,0,0
2022-04-16 16:00,87,60,27,0,0,0
2022-04-16 16:15,88,39,49,0,0,0
2022-04-16 16:30,74,30,44,0,0,0
2022-04-16 16:45,68,34,34,0,0,0
2022-04-16 17:00,64,36,28,0,0,0
2022-04-16 17:15,85,44,41,0,0,0
2022-04-16 17:30,55,37,18,0,0,0
2022-04-16 17:45,83,30,53,0,0,0
2022-04-16 18:00,96,42,54,0,0,0
2022-04-16 18:15,56,31,25,0,0,0
2022-04-16 18:30,65,26,39,0,0,0
2022-04-16 18:45,86,43,43,0,0,0
2022-04-16 19:00,57,24,33,0,0,0
2022-04-16 19:15,62,27,35,0,0,0
2022-04-16 19:30,81,47,34,0,0,0
2022-04-16 19:45,69,32,37,0,0,0
2022-04-16 20:00,57,37,20,0,0,0
2022-04-16 20:15,62,33,29,0,0,0
2022-04-16 20:30,50,30,20,0,0,0
2022-04-16 20:45,30,13,17,0,0,0
2022-04-16 21:00,41,18,23,0,0,0
2022-04-16 21:15,29,17,12,0,0,0
2022-04-16 21:30,43,16,27,0,0,0
2022-04-16 21:45,40,19,21,0,0,0
2022-04-16 22:00,30,17,13,0,0,0
2022-04-16 22:15,46,19,27,0,0,0
2022-04-16 22:30,49,15,34,0,0,0
2022-04-16 22:45,47,18,29,0,0,0
2022-04-16 23:00,39,10,29,0,0,0
2022-04-16 23:15,40,22,18,0,0,0
2022-04-16 23:30,33,15,18,0,0,0
2022-04-16 23:45,44,15,29,0,0,0
2022-04-17 00:00,47,33,14,0,0,0
2022-04-17 00:15,45,30,15,0,0,0
2022-04-17 00:30,30,19,11,0,0,0
2022-04-17 00:45,30,22,8,0,0,0
2022-04-17 01:00,39,20,19,0,0,0
2022-04-17 01:15,23,8,15,0,0,0
2022-04-17 01:30,18,12,6,0,0,0
2022-04-17 01:45,22,11,11,0,0,0
2022-04-17 02:00,16,7,9,0,0,0
2022-04-17 02:15,7,1,6,0,0,0
2022-04-17 02:30,18,4,14,0,0,0
2022-04-17 02:45,15,4,11,0,0,0
2022-04-17 03:00,14,6,8,0,0,0
2022-04-17 03:15,10,2,8,0,0,0
2022-04-17 03:30,27,2,25,0,0,0
2022-04-17 03:45,12,0,12,0,0,0
2022-04-17 04:00,11,3,8,0,0,0
2022-04-17 04:15,15,4,11,0,0,0
2022-04-17 04:30,17,2,15,0,0,0
2022-04-17 04:45,20,2,18,0,0,0
2022-04-17 05:00,11,0,11,0,0,0
2022-04-17 05:15,16,1,15,0,0,0
2022-04-17 05:30,10,4,6,0,0,0
2022-04-17 05:45,11,1,10,0,0,0
2022-04-17 06:00,8,1,7,0,0,0
2022-04-17 06:15,12,0,12,0,0,0
2022-04-17 06:30,6,4,2,0,0,0
2022-04-17 06:45,13,2,11,0,0,0
2022-04-17 07:00,5,1,4,0,0,0
2022-04-17 07:15,10,3,7,0,0,0
2022-04-17 07:30,10,5,5,0,0,0
2022-04-17 07:45,6,3,3,0,0,0
2022-04-17 08:00,5,1,4,0,0,0
2022-04-17 08:15,9,2,7,0,0,0
2022-04-17 08:30,6,2,4,0,0,0
2022-04-17 08:45,19,9,10,0,0,0
2022-04-17 09:00,22,10,12,0,0,0
2022-04-17 09:15,21,13,8,0,0,0
2022-04-17 09:30,33,11,22,0,0,0
2022-04-17 09:45,25,13,12,0,0,0
2022-04-17 10:00,20,7,13,0,0,0
2022-04-17 10:15,27,14,13,0,0,0
2022-04-17 10:30,31,7,24,0,0,0
2022-04-17 10:45,30,16,14,0,0,0
2022-04-17 11:00,30,14,16,0,0,0
2022-04-17 11:15,42,13,29,0,0,0
2022-04-17 11:30,43,16,27,0,0,0
2022-04-17 11:45,43,10,33,0,0,0
2022-04-17 12:00,39,19,20,0,0,0
2022-04-17 12:15,24,10,14,0,0,0
2022-04-17 12:30,39,16,23,0,0,0
2022-04-17 12:45,63,39,24,0,0,0
2022-04-17 13:00,44,28,16,0,0,0
2022-04-17 13:15,57,27,30,0,0,0
2022-04-17 13:30,38,15,23,0,0,0
2022-04-17 13:45,65,26,39,0,0,0
2022-04-17 14:00,56,25,31,0,0,0
2022-04-17 14:15,66,36,30,0,0,0
2022-04-17 14:30,62,26,36,0,0,0
2022-04-17 14:45,43,16,27,0,0,0
2022-04-17 15:00,54,28,26,0,0,0
2022-04-17 15:15,44,20,24,0,0,0
2022-04-17 15:30,42,18,24,0,0,0
2022-04-17 15:45,50,25,25,0,0,0
2022-04-17 16:00,60,21,39,0,0,0
2022-04-17 16:15,47,19,28,0,0,0
2022-04-17 16:30,69,34,35,0,0,0
2022-04-17 16:45,61,19,42,0,0,0
2022-04-17 17:00,50,25,25,0,0,0
2022-04-17 17:15,65,35,30,0,0,0
2022-04-17 17:30,44,21,23,0,0,0
2022-04-17 17:45,59,36,23,0,0,0
2022-04-17 18:00,61,34,27,0,0,0
2022-04-17 18:15,47,22,25,0,0,0
2022-04-17 18:30,48,26,22,0,0,0
2022-04-17 18:45,49,24,25,0,0,0
2022-04-17 19:00,40,21,19,0,0,0
2022-04-17 19:15,48,22,26,0,0,0
2022-04-17 19:30,40,26,14,0,0,0
2022-04-17 19:45,44,15,29,0,0,0
2022-04-17 20:00,29,8,21,0,0,0
2022-04-17 20:15,52,30,22,0,0,0
2022-04-17 20:30,40,17,23,0,0,0
2022-04-17 20:45,32,13,19,0,0,0
2022-04-17 21:00,47,26,21,0,0,0
2022-04-17 21:15,40,12,28,0,0,0
2022-04-17 21:30,17,4,13,0,0,0
2022-04-17 21:45,44,18,26,0,0,0
2022-04-17 22:00,34,16,18,0,0,0
2022-04-17 22:15,27,8,19,0,0,0
2022-04-17 22:30,37,14,23,0,0,0
2022-04-17 22:45,31,12,19,0,0,0
2022-04-17 23:00,20,4,16,0,0,0
2022-04-17 23:15,30,4,26,0,0,0
2022-04-17 23:30,14,6,8,0,0,0
2022-04-17 23:45,25,9,16,0,0,0
2022-04-18 00:00,24,10,14,0,0,0
2022-04-18 00:15,12,3,9,0,0,0
2022-04-18 00:30,31,18,13,0,0,0
2022-04-18 00:45,22,7,15,0,0,0
2022-04-18 01:00,17,5,12,0,0,0
2022-04-18 01:15,15,5,10,0,0,0
2022-04-18 01:30,18,7,11,0,0,0
2022-04-18 01:45,13,5,8,0,0,0
2022-04-18 02:00,8,0,8,0,0,0
2022-04-18 02:15,7,4,3,0,0,0
2022-04-18 02:30,7,2,5,0,0,0
2022-04-18 02:45,5,3,2,0,0,0
2022-04-18 03:00,4,1,3,0,0,0
2022-04-18 03:15,10,1,9,0,0,0
2022-04-18 03:30,5,0,5,0,0,0
2022-04-18 03:45,13,0,13,0,0,0
2022-04-18 04:00,7,2,5,0,0,0
2022-04-18 04:15,1,1,0,0,0,0
2022-04-18 04:30,8,0,8,0,0,0
2022-04-18 04:45,8,1,7,0,0,0
2022-04-18 05:00,1,1,0,0,0,0
2022-04-18 05:15,7,0,7,0,0,0
2022-04-18 05:30,13,6,7,0,0,0
2022-04-18 05:45,6,5,1,0,0,0
2022-04-18 06:00,4,1,3,0,0,0
2022-04-18 06:15,1,0,1,0,0,0
2022-04-18 06:30,4,2,2,0,0,0
2022-04-18 06:45,5,1,4,0,0,0
2022-04-18 07:00,3,1,2,0,0,0
2022-04-18 07:15,8,3,5,0,0,0
2022-04-18 07:30,8,3,5,0,0,0
2022-04-18 07:45,18,9,9,0,0,0
2022-04-18 08:00,7,1,6,0,0,0
2022-04-18 08:15,4,2,2,0,0,0
2022-04-18 08:30,6,4,2,0,0,0
2022-04-18 08:45,21,8,13,0,0,0
2022-04-18 09:00,18,8,10,0,0,0
2022-04-18 09:15,19,5,14,0,0,0
2022-04-18 09:30,18,11,7,0,0,0
2022-04-18 09:45,33,13,20,0,0,0
2022-04-18 10:00,22,5,17,0,0,0
2022-04-18 10:15,31,19,12,0,0,0
2022-04-18 10:30,22,9,13,0,0,0
2022-04-18 10:45,53,22,31,0,0,0
2022-04-18 11:00,30,14,16,0,0,0
2022-04-18 11:15,46,26,20,0,0,0
2022-04-18 11:30,48,25,23,0,0,0
2022-04-18 11:45,59,25,34,0,0,0
2022-04-18 12:00,37,21,16,0,0,0
2022-04-18 12:15,67,29,38,0,0,0
2022-04-18 12:30,52,20,32,0,0,0
2022-04-18 12:45,60,21,39,0,0,0
2022-04-18 13:00,73,37,36,0,0,0
2022-04-18 13:15,57,22,35,0,0,0
2022-04-18 13:30,64,32,32,0,0,0
2022-04-18 13:45,76,37,39,0,0,0
2022-04-18 14:00,54,34,20,0,0,0
2022-04-18 14:15,55,30,25,0,0,0
2022-04-18 14:30,67,35,32,0,0,0
2022-04-18 14:45,86,40,46,0,0,0
2022-04-18 15:00,84,47,37,0,0,0
2022-04-18 15:15,88,38,50,0,0,0
2022-04-18 15:30,78,39,39,0,0,0
2022-04-18 15:45,104,42,62,0,0,0
2022-04-18 16:00,108,55,53,0,0,0
2022-04-18 16:15,89,36,53,0,0,0
2022-04-18 16:30,72,34,38,0,0,0
2022-04-18 16:45,104,44,60,0,0,0
2022-04-18 17:00,90,46,44,0,0,0
2022-04-18 17:15,93,37,56,0,0,0
2022-04-18 17:30,82,35,47,0,0,0
2022-04-18 17:45,90,43,47,0,0,0
2022-04-18 18:00,99,37,62,0,0,0
2022-04-18 18:15,92,41,51,0,0,0
2022-04-18 18:30,52,21,31,0,0,0
2022-04-18 18:45,69,32,37,0,0,0
2022-04-18 19:00,75,30,45,0,0,0
2022-04-18 19:15,74,37,37,0,0,0
2022-04-18 19:30,91,38,53,0,0,0
2022-04-18 19:45,64,23,41,0,0,0
2022-04-18 20:00,64,22,42,0,0,0
2022-04-18 20:15,89,36,53,0,0,0
2022-04-18 20:30,43,19,24,0,0,0
2022-04-18 20:45,38,15,23,0,0,0
2022-04-18 21:00,49,24,25,0,0,0
2022-04-18 21:15,64,19,45,0,0,0
2022-04-18 21:30,45,14,31,0,0,0
2022-04-18 21:45,34,13,21,0,0,0
2022-04-18 22:00,29,12,17,0,0,0
2022-04-18 22:15,36,9,27,0,0,0
2022-04-18 22:30,47,9,38,0,0,0
2022-04-18 22:45,37,8,29,0,0,0
2022-04-18 23:00,23,8,15,0,0,0
2022-04-18 23:15,12,8,4,0,0,0
2022-04-18 23:30,16,7,9,0,0,0
2022-04-18 23:45,14,4,10,0,0,0
2022-04-19 00:00,6,6,0,0,0,0
2022-04-19 00:15,3,1,2,0,0,0
2022-04-19 00:30,4,1,3,0,0,0
2022-04-19 00:45,7,2,5,0,0,0
2022-04-19 01:00,9,2,7,0,0,0
2022-04-19 01:15,2,2,0,0,0,0
2022-04-19 01:30,7,3,4,0,0,0
2022-04-19 01:45,3,0,3,0,0,0
2022-04-19 02:00,3,2,1,0,0,0
2022-04-19 02:15,2,0,2,0,0,0
2022-04-19 02:30,2,0,2,0,0,0
2022-04-19 02:45,0,0,0,0,0,0
2022-04-19 03:00,2,1,1,0,0,0
2022-04-19 03:15,3,3,0,0,0,0
2022-04-19 03:30,0,0,0,0,0,0
2022-04-19 03:45,0,0,0,0,0,0
2022-04-19 04:00,0,0,0,0,0,0
2022-04-19 04:15,1,0,1,0,0,0
2022-04-19 04:30,3,0,3,0,0,0
2022-04-19 04:45,0,0,0,0,0,0
2022-04-19 05:00,5,2,3,0,0,0
2022-04-19 05:15,2,1,1,0,0,0
2022-04-19 05:30,16,6,10,0,0,0
2022-04-19 05:45,18,10,8,0,0,0
2022-04-19 06:00,14,4,10,0,0,0
2022-04-19 06:15,32,12,20,0,0,0
2022-04-19 06:30,37,13,24,0,0,0
2022-04-19 06:45,66,35,31,0,0,0
2022-04-19 07:00,57,29,28,0,0,0
2022-04-19 07:15,82,40,42,0,0,0
2022-04-19 07:30,107,62,45,0,0,0
2022-04-19 07:45,112,50,62,0,0,0
2022-04-19 08:00,121,62,59,0,0,0
2022-04-19 08:15,114,54,60,0,0,0
2022-04-19 08:30,98,46,52,0,0,0
2022-04-19 08:45,111,51,60,0,0,0
2022-04-19 09:00,96,39,57,0,0,0
2022-04-19 09:15,76,31,45,0,0,0
2022-04-19 09:30,91,25,66,0,0,0
2022-04-19 09:45,133,45,88,0,0,0
2022-04-19 10:00,106,40,66,0,0,0
2022-04-19 10:15,60,33,27,0,0,0
2022-04-19 10:30,84,32,52,0,0,0
2022-04-19 10:45,83,35,48,0,0,0
2022-04-19 11:00,87,40,47,0,0,0
2022-04-19 11:15,77,24,53,0,0,0
2022-04-19 11:30,80,29,51,0,0,0
2022-04-19 11:45,127,50,77,0,0,0
2022-04-19 12:00,141,56,85,0,0,0
2022-04-19 12:15,113,50,63,0,0,0
2022-04-19 12:30,91,31,60,0,0,0
2022-04-19 12:45,101,58,43,0,0,0
2022-04-19 13:00,104,43,61,0,0,0
2022-04-19 13:15,87,32,55,0,0,0
2022-04-19 13:30,102,59,43,0,0,0
2022-04-19 13:45,111,49,62,0,0,0
2022-04-19 14:00,136,61,75,0,0,0
2022-04-19 14:15,113,54,59,0,0,0
2022-04-19 14:30,113,47,66,0,0,0
2022-04-19 14:45,109,45,64,0,0,0
2022-04-19 15:00,122,65,57,0,0,0
2022-04-19 15:15,120,60,60,0,0,0
2022-04-19 15:30,118,62,56,0,0,0
2022-04-19 15:45,180,81,99,0,0,0
2022-04-19 16:00,171,90,81,0,0,0
2022-04-19 16:15,140,69,71,0,0,0
2022-04-19 16:30,150,75,75,0,0,0
2022-04-19 16:45,136,79,57,0,0,0
2022-04-19 17:00,175,97,78,0,0,0
2022-04-19 17:15,167,77,90,0,0,0
2022-04-19 17:30,168,95,73,0,0,0
2022-04-19 17:45,189,104,85,0,0,0
2022-04-19 18:00,189,105,84,0,0,0
2022-04-19 18:15,154,74,80,0,0,0
2022-04-19 18:30,123,72,51,0,0,0
2022-04-19 18:45,149,82,67,0,0,0
2022-04-19 19:00,123,73,50,0,0,0
2022-04-19 19:15,116,59,57,0,0,0
2022-04-19 19:30,103,60,43,0,0,0
2022-04-19 19:45,99,59,40,0,0,0
2022-04-19 20:00,102,52,50,0,0,0
2022-04-19 20:15,110,63,47,0,0,0
2022-04-19 20:30,99,39,60,0,0,0
2022-04-19 20:45,60,30,30,0,0,0
2022-04-19 21:00,67,24,43,0,0,0
2022-04-19 21:15,64,21,43,0,0,0
2022-04-19 21:30,56,26,30,0,0,0
2022-04-19 21:45,45,14,31,0,0,0
2022-04-19 22:00,64,27,37,0,0,0
2022-04-19 22:15,67,21,46,0,0,0
2022-04-19 22:30,57,18,39,0,0,0
2022-04-19 22:45,43,21,22,0,0,0
2022-04-19 23:00,42,16,26,0,0,0
2022-04-19 23:15,56,14,42,0,0,0
2022-04-19 23:30,40,17,23,0,0,0
2022-04-19 23:45,22,12,10,0,0,0
2022-04-20 00:00,16,6,10,0,0,0
2022-04-20 00:15,10,1,9,0,0,0
2022-04-20 00:30,9,2,7,0,0,0
2022-04-20 00:45,7,2,5,0,0,0
2022-04-20 01:00,9,3,6,0,0,0
2022-04-20 01:15,3,2,1,0,0,0
2022-04-20 01:30,3,1,2,0,0,0
2022-04-20 01:45,15,4,11,0,0,0
2022-04-20 02:00,8,0,8,0,0,0
2022-04-20 02:15,10,0,10,0,0,0
2022-04-20 02:30,3,0,3,0,0,0
2022-04-20 02:45,1,0,1,0,0,0
2022-04-20 03:00,2,0,2,0,0,0
2022-04-20 03:15,0,0,0,0,0,0
2022-04-20 03:30,4,1,3,0,0,0
2022-04-20 03:45,2,0,2,0,0,0
2022-04-20 04:00,2,1,1,0,0,0
2022-04-20 04:15,5,2,3,0,0,0
2022-04-20 04:30,11,5,6,0,0,0
2022-04-20 04:45,6,2,4,0,0,0
2022-04-20 05:00,0,0,0,0,0,0
2022-04-20 05:15,14,7,7,0,0,0
2022-04-20 05:30,14,5,9,0,0,0
2022-04-20 05:45,12,7,5,0,0,0
2022-04-20 06:00,28,14,14,0,0,0
2022-04-20 06:15,37,12,25,0,0,0
2022-04-20 06:30,40,20,20,0,0,0
2022-04-20 06:45,77,36,41,0,0,0
2022-04-20 07:00,73,37,36,0,0,0
2022-04-20 07:15,108,53,55,0,0,0
2022-04-20 07:30,102,52,50,0,0,0
2022-04-20 07:45,140,74,66,0,0,0
2022-04-20 08:00,138,70,68,0,0,0
2022-04-20 08:15,106,47,59,0,0,0
2022-04-20 08:30,99,54,45,0,0,0
2022-04-20 08:45,134,61,73,0,0,0
2022-04-20 09:00,86,39,47,0,0,0
2022-04-20 09:15,90,37,53,0,0,0
2022-04-20 09:30,106,42,64,0,0,0
2022-04-20 09:45,126,33,93,0,0,0
2022-04-20 10:00,120,50,70,0,0,0
2022-04-20 10:15,103,40,63,0,0,0
2022-04-20 10:30,78,30,48,0,0,0
2022-04-20 10:45,77,30,47,0,0,0
2022-04-20 11:00,64,30,34,0,0,0
2022-04-20 11:15,81,31,50,0,0,0
2022-04-20 11:30,109,47,62,0,0,0
2022-04-20 11:45,125,55,70,0,0,0
2022-04-20 12:00,131,61,70,0,0,0
2022-04-20 12:15,117,60,57,0,0,0
2022-04-20 12:30,99,49,50,0,0,0
2022-04-20 12:45,118,62,56,0,0,0
2022-04-20 13:00,121,65,56,0,0,0
2022-04-20 13:15,135,73,62,0,0,0
2022-04-20 13:30,127,62,65,0,0,0
2022-04-20 13:45,133,63,70,0,0,0
2022-04-20 14:00,127,74,53,0,0,0
2022-04-20 14:15,136,71,65,0,0,0
2022-04-20 14:30,122,81,41,0,0,0
2022-04-20 14:45,147,74,73,0,0,0
2022-04-20 15:00,134,69,65,0,0,0
2022-04-20 15:15,129,72,57,0,0,0
2022-04-20 15:30,140,74,66,0,0,0
2022-04-20 15:45,181,96,85,0,0,0
2022-04-20 16:00,180,92,88,0,0,0
2022-04-20 16:15,163,96,67,0,0,0
2022-04-20 16:30,171,90,81,0,0,0
2022-04-20 16:45,162,83,79,0,0,0
2022-04-20 17:00,181,105,76,0,0,0
2022-04-20 17:15,179,88,91,0,0,0
2022-04-20 17:30,185,96,89,0,0,0
2022-04-20 17:45,196,120,76,0,0,0
2022-04-20 18:00,166,97,69,0,0,0
2022-04-20 18:15,163,80,83,0,0,0
2022-04-20 18:30,134,81,53,0,0,0
2022-04-20 18:45,184,109,75,0,0,0
2022-04-20 19:00,162,104,58,0,0,0
2022-04-20 19:15,143,91,52,0,0,0
2022-04-20 19:30,160,112,48,0,0,0
2022-04-20 19:45,125,76,49,0,0,0
2022-04-20 20:00,102,51,51,0,0,0
2022-04-20 20:15,97,54,43,0,0,0
2022-04-20 20:30,73,39,34,0,0,0
2022-04-20 20:45,68,36,32,0,0,0
2022-04-20 21:00,89,35,54,0,0,0
2022-04-20 21:15,65,34,31,0,0,0
2022-04-20 21:30,52,21,31,0,0,0
2022-04-20 21:45,71,31,40,0,0,0
2022-04-20 22:00,72,38,34,0,0,0
2022-04-20 22:15,81,31,50,0,0,0
2022-04-20 22:30,158,34,124,0,0,0
2022-04-20 22:45,66,26,40,0,0,0
2022-04-20 23:00,77,47,30,0,0,0
2022-04-20 23:15,57,30,27,0,0,0
2022-04-20 23:30,64,34,30,0,0,0
2022-04-20 23:45,32,16,16,0,0,0
2022-04-21 00:00,28,21,7,0,0,0
2022-04-21 00:15,27,20,7,0,0,0
2022-04-21 00:30,32,18,14,0,0,0
2022-04-21 00:45,29,15,14,0,0,0
2022-04-21 01:00,19,10,9,0,0,0
2022-04-21 01:15,19,8,11,0,0,0
2022-04-21 01:30,14,1,13,0,0,0
2022-04-21 01:45,21,8,13,0,0,0
2022-04-21 02:00,22,2,20,0,0,0
2022-04-21 02:15,17,3,14,0,0,0
2022-04-21 02:30,16,1,15,0,0,0
2022-04-21 02:45,17,3,14,0,0,0
2022-04-21 03:00,15,0,15,0,0,0
2022-04-21 03:15,19,1,18,0,0,0
2022-04-21 03:30,24,2,22,0,0,0
2022-04-21 03:45,19,0,19,0,0,0
2022-04-21 04:00,22,2,20,0,0,0
2022-04-21 04:15,11,2,9,0,0,0
2022-04-21 04:30,17,0,17,0,0,0
2022-04-21 04:45,8,2,6,0,0,0
2022-04-21 05:00,9,6,3,0,0,0
2022-04-21 05:15,21,3,18,0,0,0
2022-04-21 05:30,12,6,6,0,0,0
2022-04-21 05:45,20,9,11,0,0,0
2022-04-21 06:00,20,5,15,0,0,0
2022-04-21 06:15,33,9,24,0,0,0
2022-04-21 06:30,37,13,24,0,0,0
2022-04-21 06:45,62,42,20,0,0,0
2022-04-21 07:00,64,36,28,0,0,0
2022-04-21 07:15,91,47,44,0,0,0
2022-04-21 07:30,70,25,45,0,0,0
2022-04-21 07:45,135,72,63,0,0,0
2022-04-21 08:00,141,64,77,0,0,0
2022-04-21 08:15,99,43,56,0,0,0
2022-04-21 08:30,100,52,48,0,0,0
2022-04-21 08:45,122,66,56,0,0,0
2022-04-21 09:00,76,36,40,0,0,0
2022-04-21 09:15,72,26,46,0,0,0
2022-04-21 09:30,68,19,49,0,0,0
2022-04-21 09:45,143,55,88,0,0,0
2022-04-21 10:00,97,32,65,0,0,0
2022-04-21 10:15,80,40,40,0,0,0
2022-04-21 10:30,74,27,47,0,0,0
2022-04-21 10:45,96,35,61,0,0,0
2022-04-21 11:00,79,22,57,0,0,0
2022-04-21 11:15,87,38,49,0,0,0
2022-04-21 11:30,92,40,52,0,0,0
2022-04-21 11:45,146,76,70,0,0,0
2022-04-21 12:00,124,57,67,0,0,0
2022-04-21 12:15,109,50,59,0,0,0
2022-04-21 12:30,112,46,66,0,0,0
2022-04-21 12:45,121,58,63,0,0,0
2022-04-21 13:00,126,59,67,0,0,0
2022-04-21 13:15,99,46,53,0,0,0
2022-04-21 13:30,103,60,43,0,0,0
2022-04-21 13:45,156,80,76,0,0,0
2022-04-21 14:00,141,65,76,0,0,0
2022-04-21 14:15,134,67,67,0,0,0
2022-04-21 14:30,139,64,75,0,0,0
2022-04-21 14:45,138,75,63,0,0,0
2022-04-21 15:00,112,57,55,0,0,0
2022-04-21 15:15,117,68,49,0,0,0
2022-04-21 15:30,148,74,74,0,0,0
2022-04-21 15:45,188,102,86,0,0,0
2022-04-21 16:00,177,92,85,0,0,0
2022-04-21 16:15,168,80,88,0,0,0
2022-04-21 16:30,156,82,74,0,0,0
2022-04-21 16:45,178,75,103,0,0,0
2022-04-21 17:00,179,94,85,0,0,0
2022-04-21 17:15,198,106,92,0,0,0
2022-04-21 17:30,142,77,65,0,0,0
2022-04-21 17:45,200,120,80,0,0,0
2022-04-21 18:00,180,99,81,0,0,0
2022-04-21 18:15,141,80,61,0,0,0
2022-04-21 18:30,148,85,63,0,0,0
2022-04-21 18:45,144,90,54,0,0,0
2022-04-21 19:00,130,74,56,0,0,0
2022-04-21 19:15,157,103,54,0,0,0
2022-04-21 19:30,100,53,47,0,0,0
2022-04-21 19:45,109,57,52,0,0,0
2022-04-21 20:00,123,65,58,0,0,0
2022-04-21 20:15,82,48,34,0,0,0
2022-04-21 20:30,78,33,45,0,0,0
2022-04-21 20:45,50,16,34,0,0,0
2022-04-21 21:00,63,14,49,0,0,0
2022-04-21 21:15,56,27,29,0,0,0
2022-04-21 21:30,44,20,24,0,0,0
2022-04-21 21:45,49,16,33,0,0,0
2022-04-21 22:00,68,20,48,0,0,0
2022-04-21 22:15,59,24,35,0,0,0
2022-04-21 22:30,86,15,71,0,0,0
2022-04-21 22:45,97,13,84,0,0,0
2022-04-21 23:00,48,9,39,0,0,0
2022-04-21 23:15,35,8,27,0,0,0
2022-04-21 23:30,42,13,29,0,0,0
2022-04-21 23:45,20,8,12,0,0,0
2022-04-22 00:00,12,5,7,0,0,0
2022-04-22 00:15,14,4,10,0,0,0
2022-04-22 00:30,10,2,8,0,0,0
2022-04-22 00:45,17,8,9,0,0,0
2022-04-22 01:00,8,3,5,0,0,0
2022-04-22 01:15,15,1,14,0,0,0
2022-04-22 01:30,7,2,5,0,0,0
2022-04-22 01:45,5,1,4,0,0,0
2022-04-22 02:00,4,1,3,0,0,0
2022-04-22 02:15,4,1,3,0,0,0
2022-04-22 02:30,3,2,1,0,0,0
2022-04-22 02:45,3,2,1,0,0,0
2022-04-22 03:00,4,3,1,0,0,0
2022-04-22 03:15,3,1,2,0,0,0
2022-04-22 03:30,2,1,1,0,0,0
2022-04-22 03:45,1,0,1,0,0,0
2022-04-22 04:00,4,2,2,0,0,0
2022-04-22 04:15,3,1,2,0,0,0
2022-04-22 04:30,2,1,1,0,0,0
2022-04-22 04:45,8,2,6,0,0,0
2022-04-22 05:00,2,1,1,0,0,0
2022-04-22 05:15,5,1,4,0,0,0
2022-04-22 05:30,14,10,4,0,0,0
2022-04-22 05:45,23,9,14,0,0,0
2022-04-22 06:00,28,13,15,0,0,0
2022-04-22 06:15,38,12,26,0,0,0
2022-04-22 06:30,37,15,22,0,0,0
2022-04-22 06:45,51,34,17,0,0,0
2022-04-22 07:00,65,38,27,0,0,0
2022-04-22 07:15,77,40,37,0,0,0
2022-04-22 07:30,80,32,48,0,0,0
2022-04-22 07:45,100,44,56,0,0,0
2022-04-22 08:00,118,62,56,0,0,0
2022-04-22 08:15,113,56,57,0,0,0
2022-04-22 08:30,83,37,46,0,0,0
2022-04-22 08:45,101,44,57,0,0,0
2022-04-22 09:00,77,35,42,0,0,0
2022-04-22 09:15,67,29,38,0,0,0
2022-04-22 09:30,67,21,46,0,0,0
2022-04-22 09:45,110,34,76,0,0,0
2022-04-22 10:00,94,29,65,0,0,0
2022-04-22 10:15,69,32,37,0,0,0
2022-04-22 10:30,71,32,39,0,0,0
2022-04-22 10:45,90,45,45,0,0,0
2022-04-22 11:00,109,39,70,0,0,0
2022-04-22 11:15,80,41,39,0,0,0
2022-04-22 11:30,86,33,53,0,0,0
2022-04-22 11:45,91,45,46,0,0,0
2022-04-22 12:00,122,53,69,0,0,0
2022-04-22 12:15,101,41,60,0,0,0
2022-04-22 12:30,111,47,64,0,0,0
2022-04-22 12:45,114,54,60,0,0,0
2022-04-22 13:00,111,59,52,0,0,0
2022-04-22 13:15,115,53,62,0,0,0
2022-04-22 13:30,140,68,72,0,0,0
2022-04-22 13:45,145,72,73,0,0,0
2022-04-22 14:00,115,53,62,0,0,0
2022-04-22 14:15,146,66,80,0,0,0
2022-04-22 14:30,129,75,54,0,0,0
2022-04-22 14:45,172,114,58,0,0,0
2022-04-22 15:00,123,71,52,0,0,0
2022-04-22 15:15,103,47,56,0,0,0
2022-04-22 15:30,123,64,59,0,0,0
2022-04-22 15:45,167,87,80,0,0,0
2022-04-22 16:00,132,81,51,0,0,0
2022-04-22 16:15,104,60,44,0,0,0
2022-04-22 16:30,123,72,51,0,0,0
2022-04-22 16:45,159,83,76,0,0,0
2022-04-22 17:00,121,56,65,0,0,0
2022-04-22 17:15,117,62,55,0,0,0
2022-04-22 17:30,133,82,51,0,0,0
2022-04-22 17:45,133,56,77,0,0,0
2022-04-22 18:00,136,81,55,0,0,0
2022-04-22 18:15,112,59,53,0,0,0
2022-04-22 18:30,94,42,52,0,0,0
2022-04-22 18:45,118,72,46,0,0,0
2022-04-22 19:00,126,76,50,0,0,0
2022-04-22 19:15,120,70,50,0,0,0
2022-04-22 19:30,130,79,51,0,0,0
2022-04-22 19:45,94,42,52,0,0,0
2022-04-22 20:00,92,54,38,0,0,0
2022-04-22 20:15,86,44,42,0,0,0
2022-04-22 20:30,82,40,42,0,0,0
2022-04-22 20:45,75,32,43,0,0,0
2022-04-22 21:00,79,35,44,0,0,0
2022-04-22 21:15,59,22,37,0,0,0
2022-04-22 21:30,59,35,24,0,0,0
2022-04-22 21:45,50,26,24,0,0,0
2022-04-22 22:00,59,20,39,0,0,0
2022-04-22 22:15,82,30,52,0,0,0
2022-04-22 22:30,79,15,64,0,0,0
2022-04-22 22:45,66,32,34,0,0,0
2022-04-22 23:00,78,36,42,0,0,0
2022-04-22 23:15,43,14,29,0,0,0
2022-04-22 23:30,63,25,38,0,0,0
2022-04-22 23:45,60,27,33,0,0,0
2022-04-23 00:00,45,23,22,0,0,0
2022-04-23 00:15,54,28,26,0,0,0
2022-04-23 00:30,54,35,19,0,0,0
2022-04-23 00:45,35,15,20,0,0,0
2022-04-23 01:00,22,12,10,0,0,0
2022-04-23 01:15,55,17,38,0,0,0
2022-04-23 01:30,43,17,26,0,0,0
2022-04-23 01:45,34,15,19,0,0,0
2022-04-23 02:00,25,14,11,0,0,0
2022-04-23 02:15,26,10,16,0,0,0
2022-04-23 02:30,23,7,16,0,0,0
2022-04-23 02:45,19,5,14,0,0,0
2022-04-23 03:00,32,8,24,0,0,0
2022-04-23 03:15,31,10,21,0,0,0
2022-04-23 03:30,16,4,12,0,0,0
2022-04-23 03:45,15,8,7,0,0,0
2022-04-23 04:00,21,1,20,0,0,0
2022-04-23 04:15,32,3,29,0,0,0
2022-04-23 04:30,13,2,11,0,0,0
2022-04-23 04:45,16,1,15,0,0,0
2022-04-23 05:00,7,3,4,0,0,0
2022-04-23 05:15,12,1,11,0,0,0
2022-04-23 05:30,21,4,17,0,0,0
2022-04-23 05:45,12,1,11,0,0,0
2022-04-23 06:00,14,1,13,0,0,0
2022-04-23 06:15,18,2,16,0,0,0
2022-04-23 06:30,11,2,9,0,0,0
2022-04-23 06:45,12,4,8,0,0,0
2022-04-23 07:00,10,3,7,0,0,0
2022-04-23 07:15,13,6,7,0,0,0
2022-04-23 07:30,30,9,21,0,0,0
2022-04-23 07:45,27,14,13,0,0,0
2022-04-23 08:00,19,6,13,0,0,0
2022-04-23 08:15,28,15,13,0,0,0
2022-04-23 08:30,29,12,17,0,0,0
2022-04-23 08:45,43,18,25,0,0,0
2022-04-23 09:00,35,13,22,0,0,0
2022-04-23 09:15,39,21,18,0,0,0
2022-04-23 09:30,65,24,41,0,0,0
2022-04-23 09:45,91,47,44,0,0,0
2022-04-23 10:00,62,24,38,0,0,0
2022-04-23 10:15,93,33,60,0,0,0
2022-04-23 10:30,55,14,41,0,0,0
2022-04-23 10:45,68,34,34,0,0,0
2022-04-23 11:00,74,24,50,0,0,0
2022-04-23 11:15,72,22,50,0,0,0
2022-04-23 11:30,80,22,58,0,0,0
2022-04-23 11:45,74,27,47,0,0,0
2022-04-23 12:00,84,26,58,0,0,0
2022-04-23 12:15,90,38,52,0,0,0
2022-04-23 12:30,83,26,57,0,0,0
2022-04-23 12:45,82,47,35,0,0,0
2022-04-23 13:00,104,47,57,0,0,0
2022-04-23 13:15,98,52,46,0,0,0
2022-04-23 13:30,88,33,55,0,0,0
2022-04-23 13:45,104,64,40,0,0,0
2022-04-23 14:00,88,50,38,0,0,0
2022-04-23 14:15,81,41,40,0,0,0
2022-04-23 14:30,96,48,48,0,0,0
2022-04-23 14:45,100,40,60,0,0,0
2022-04-23 15:00,114,47,67,0,0,0
2022-04-23 15:15,86,48,38,0,0,0
2022-04-23 15:30,83,39,44,0,0,0
2022-04-23 15:45,106,51,55,0,0,0
2022-04-23 16:00,104,49,55,0,0,0
2022-04-23 16:15,109,65,44,0,0,0
2022-04-23 16:30,96,54,42,0,0,0
2022-04-23 16:45,101,45,56,0,0,0
2022-04-23 17:00,104,64,40,0,0,0
2022-04-23 17:15,116,78,38,0,0,0
2022-04-23 17:30,98,58,40,0,0,0
2022-04-23 17:45,103,55,48,0,0,0
2022-04-23 18:00,99,48,51,0,0,0
2022-04-23 18:15,93,58,35,0,0,0
2022-04-23 18:30,102,52,50,0,0,0
2022-04-23 18:45,141,84,57,0,0,0
2022-04-23 19:00,78,39,39,0,0,0
2022-04-23 19:15,105,54,51,0,0,0
2022-04-23 19:30,102,65,37,0,0,0
2022-04-23 19:45,80,34,46,0,0,0
2022-04-23 20:00,97,52,45,0,0,0
2022-04-23 20:15,106,38,68,0,0,0
2022-04-23 20:30,94,48,46,0,0,0
2022-04-23 20:45,59,25,34,0,0,0
2022-04-23 21:00,92,38,54,0,0,0
2022-04-23 21:15,72,33,39,0,0,0
2022-04-23 21:30,86,34,52,0,0,0
2022-04-23 21:45,73,34,39,0,0,0
2022-04-23 22:00,51,24,27,0,0,0
2022-04-23 22:15,94,34,60,0,0,0
2022-04-23 22:30,74,23,51,0,0,0
2022-04-23 22:45,54,22,32,0,0,0
2022-04-23 23:00,47,14,33,0,0,0
2022-04-23 23:15,52,20,32,0,0,0
2022-04-23 23:30,59,23,36,0,0,0
2022-04-23 23:45,94,47,47,0,0,0
2022-04-24 00:00,55,29,26,0,0,0
2022-04-24 00:15,43,16,27,0,0,0
2022-04-24 00:30,47,17,30,0,0,0
2022-04-24 00:45,36,18,18,0,0,0
2022-04-24 01:00,52,26,26,0,0,0
2022-04-24 01:15,43,18,25,0,0,0
2022-04-24 01:30,52,21,31,0,0,0
2022-04-24 01:45,29,10,19,0,0,0
2022-04-24 02:00,19,6,13,0,0,0
2022-04-24 02:15,19,5,14,0,0,0
2022-04-24 02:30,37,15,22,0,0,0
2022-04-24 02:45,30,5,25,0,0,0
2022-04-24 03:00,39,8,31,0,0,0
2022-04-24 03:15,23,4,19,0,0,0
2022-04-24 03:30,20,4,16,0,0,0
2022-04-24 03:45,26,2,24,0,0,0
2022-04-24 04:00,17,5,12,0,0,0
2022-04-24 04:15,21,5,16,0,0,0
2022-04-24 04:30,9,0,9,0,0,0
2022-04-24 04:45,9,1,8,0,0,0
2022-04-24 05:00,14,2,12,0,0,0
2022-04-24 05:15,15,1,14,0,0,0
2022-04-24 05:30,24,2,22,0,0,0
2022-04-24 05:45,15,5,10,0,0,0
2022-04-24 06:00,12,2,10,0,0,0
2022-04-24 06:15,14,1,13,0,0,0
2022-04-24 06:30,4,1,3,0,0,0
2022-04-24 06:45,4,4,0,0,0,0
2022-04-24 07:00,4,2,2,0,0,0
2022-04-24 07:15,12,2,10,0,0,0
2022-04-24 07:30,15,7,8,0,0,0
2022-04-24 07:45,11,3,8,0,0,0
2022-04-24 08:00,13,3,10,0,0,0
2022-04-24 08:15,11,4,7,0,0,0
2022-04-24 08:30,16,6,10,0,0,0
2022-04-24 08:45,28,15,13,0,0,0
2022-04-24 09:00,16,8,8,0,0,0
2022-04-24 09:15,19,8,11,0,0,0
2022-04-24 09:30,36,16,20,0,0,0
2022-04-24 09:45,42,14,28,0,0,0
2022-04-24 10:00,44,21,23,0,0,0
2022-04-24 10:15,44,28,16,0,0,0
2022-04-24 10:30,37,18,19,0,0,0
2022-04-24 10:45,48,23,25,0,0,0
2022-04-24 11:00,50,27,23,0,0,0
2022-04-24 11:15,37,19,18,0,0,0
2022-04-24 11:30,55,28,27,0,0,0
2022-04-24 11:45,85,45,40,0,0,0
2022-04-24 12:00,57,33,24,0,0,0
2022-04-24 12:15,78,50,28,0,0,0
2022-04-24 12:30,67,32,35,0,0,0
2022-04-24 12:45,99,59,40,0,0,0
2022-04-24 13:00,76,36,40,0,0,0
2022-04-24 13:15,67,32,35,0,0,0
2022-04-24 13:30,83,39,44,0,0,0
2022-04-24 13:45,111,48,63,0,0,0
2022-04-24 14:00,98,46,52,0,0,0
2022-04-24 14:15,108,51,57,0,0,0
2022-04-24 14:30,100,54,46,0,0,0
2022-04-24 14:45,108,50,58,0,0,0
2022-04-24 15:00,115,49,66,0,0,0
2022-04-24 15:15,114,57,57,0,0,0
2022-04-24 15:30,102,35,67,0,0,0
2022-04-24 15:45,101,43,58,0,0,0
2022-04-24 16:00,100,43,57,0,0,0
2022-04-24 16:15,99,29,70,0,0,0
2022-04-24 16:30,79,30,49,0,0,0
2022-04-24 16:45,105,45,60,0,0,0
2022-04-24 17:00,83,43,40,0,0,0
2022-04-24 17:15,89,48,41,0,0,0
2022-04-24 17:30,99,56,43,0,0,0
2022-04-24 17:45,111,40,71,0,0,0
2022-04-24 18:00,95,49,46,0,0,0
2022-04-24 18:15,83,32,51,0,0,0
2022-04-24 18:30,72,30,42,0,0,0
2022-04-24 18:45,93,45,48,0,0,0
2022-04-24 19:00,79,38,41,0,0,0
2022-04-24 19:15,80,38,42,0,0,0
2022-04-24 19:30,72,34,38,0,0,0
2022-04-24 19:45,65,36,29,0,0,0
2022-04-24 20:00,81,38,43,0,0,0
2022-04-24 20:15,52,23,29,0,0,0
2022-04-24 20:30,60,31,29,0,0,0
2022-04-24 20:45,46,15,31,0,0,0
2022-04-24 21:00,29,12,17,0,0,0
2022-04-24 21:15,36,17,19,0,0,0
2022-04-24 21:30,35,17,18,0,0,0
2022-04-24 21:45,29,15,14,0,0,0
2022-04-24 22:00,46,14,32,0,0,0
2022-04-24 22:15,35,8,27,0,0,0
2022-04-24 22:30,42,8,34,0,0,0
2022-04-24 22:45,17,10,7,0,0,0
2022-04-24 23:00,21,8,13,0,0,0
2022-04-24 23:15,15,4,11,0,0,0
2022-04-24 23:30,14,4,10,0,0,0
2022-04-24 23:45,9,5,4,0,0,0
2022-04-25 00:00,7,2,5,0,0,0
2022-04-25 00:15,1,0,1,0,0,0
2022-04-25 00:30,6,1,5,0,0,0
2022-04-25 00:45,5,1,4,0,0,0
2022-04-25 01:00,4,2,2,0,0,0
2022-04-25 01:15,2,2,0,0,0,0
2022-04-25 01:30,2,0,2,0,0,0
2022-04-25 01:45,1,1,0,0,0,0
2022-04-25 02:00,0,0,0,0,0,0
2022-04-25 02:15,0,0,0,0,0,0
2022-04-25 02:30,0,0,0,0,0,0
2022-04-25 02:45,1,0,1,0,0,0
2022-04-25 03:00,2,2,0,0,0,0
2022-04-25 03:15,2,2,0,0,0,0
2022-04-25 03:30,4,0,4,0,0,0
2022-04-25 03:45,3,1,2,0,0,0
2022-04-25 04:00,2,1,1,0,0,0
2022-04-25 04:15,0,0,0,0,0,0
2022-04-25 04:30,6,4,2,0,0,0
2022-04-25 04:45,7,1,6,0,0,0
2022-04-25 05:00,5,4,1,0,0,0
2022-04-25 05:15,13,4,9,0,0,0
2022-04-25 05:30,13,9,4,0,0,0
2022-04-25 05:45,17,8,9,0,0,0
2022-04-25 06:00,17,5,12,0,0,0
2022-04-25 06:15,39,18,21,0,0,0
2022-04-25 06:30,46,23,23,0,0,0
2022-04-25 06:45,75,40,35,0,0,0
2022-04-25 07:00,77,37,40,0,0,0
2022-04-25 07:15,109,46,63,0,0,0
2022-04-25 07:30,159,59,100,0,0,0
2022-04-25 07:45,146,72,74,0,0,0
2022-04-25 08:00,128,64,64,0,0,0
2022-04-25 08:15,141,73,68,0,0,0
2022-04-25 08:30,114,50,64,0,0,0
2022-04-25 08:45,125,63,62,0,0,0
2022-04-25 09:00,96,39,57,0,0,0
2022-04-25 09:15,87,40,47,0,0,0
2022-04-25 09:30,89,41,48,0,0,0
2022-04-25 09:45,104,38,66,0,0,0
2022-04-25 10:00,116,33,83,0,0,0
2022-04-25 10:15,78,36,42,0,0,0
2022-04-25 10:30,78,38,40,0,0,0
2022-04-25 10:45,74,30,44,0,0,0
2022-04-25 11:00,90,33,57,0,0,0
2022-04-25 11:15,79,39,40,0,0,0
2022-04-25 11:30,88,28,60,0,0,0
2022-04-25 11:45,106,42,64,0,0,0
2022-04-25 12:00,124,42,82,0,0,0
2022-04-25 12:15,111,50,61,0,0,0
2022-04-25 12:30,97,51,46,0,0,0
2022-04-25 12:45,96,51,45,0,0,0
2022-04-25 13:00,117,44,73,0,0,0
2022-04-25 13:15,99,48,51,0,0,0
2022-04-25 13:30,108,51,57,0,0,0
2022-04-25 13:45,143,70,73,0,0,0
2022-04-25 14:00,133,62,71,0,0,0
2022-04-25 14:15,107,50,57,0,0,0
2022-04-25 14:30,105,46,59,0,0,0
2022-04-25 14:45,126,54,72,0,0,0
2022-04-25 15:00,102,50,52,0,0,0
2022-04-25 15:15,102,53,49,0,0,0
2022-04-25 15:30,136,62,74,0,0,0
2022-04-25 15:45,152,65,87,0,0,0
2022-04-25 16:00,137,60,77,0,0,0
2022-04-25 16:15,125,58,67,0,0,0
2022-04-25 16:30,116,44,72,0,0,0
2022-04-25 16:45,137,62,75,0,0,0
2022-04-25 17:00,139,64,75,0,0,0
2022-04-25 17:15,149,71,78,0,0,0
2022-04-25 17:30,155,71,84,0,0,0
2022-04-25 17:45,172,94,78,0,0,0
2022-04-25 18:00,147,63,84,0,0,0
2022-04-25 18:15,143,76,67,0,0,0
2022-04-25 18:30,113,55,58,0,0,0
2022-04-25 18:45,140,64,76,0,0,0
2022-04-25 19:00,91,47,44,0,0,0
2022-04-25 19:15,119,65,54,0,0,0
2022-04-25 19:30,112,66,46,0,0,0
2022-04-25 19:45,122,68,54,0,0,0
2022-04-25 20:00,100,36,64,0,0,0
2022-04-25 20:15,79,39,40,0,0,0
2022-04-25 20:30,74,35,39,0,0,0
2022-04-25 20:45,65,32,33,0,0,0
2022-04-25 21:00,65,32,33,0,0,0
2022-04-25 21:15,56,21,35,0,0,0
2022-04-25 21:30,41,9,32,0,0,0
2022-04-25 21:45,34,18,16,0,0,0
2022-04-25 22:00,43,13,30,0,0,0
2022-04-25 22:15,50,19,31,0,0,0
2022-04-25 22:30,73,13,60,0,0,0
2022-04-25 22:45,37,10,27,0,0,0
2022-04-25 23:00,27,9,18,0,0,0
2022-04-25 23:15,20,8,12,0,0,0
2022-04-25 23:30,24,7,17,0,0,0
2022-04-25 23:45,7,2,5,0,0,0
2022-04-26 00:00,19,10,9,0,0,0
2022-04-26 00:15,14,5,9,0,0,0
2022-04-26 00:30,5,4,1,0,0,0
2022-04-26 00:45,5,1,4,0,0,0
2022-04-26 01:00,8,4,4,0,0,0
2022-04-26 01:15,0,0,0,0,0,0
2022-04-26 01:30,7,6,1,0,0,0
2022-04-26 01:45,3,1,2,0,0,0
2022-04-26 02:00,3,0,3,0,0,0
2022-04-26 02:15,2,2,0,0,0,0
2022-04-26 02:30,1,0,1,0,0,0
2022-04-26 02:45,0,0,0,0,0,0
2022-04-26 03:00,2,1,1,0,0,0
2022-04-26 03:15,0,0,0,0,0,0
2022-04-26 03:30,0,0,0,0,0,0
2022-04-26 03:45,1,1,0,0,0,0
2022-04-26 04:00,3,3,0,0,0,0
2022-04-26 04:15,4,1,3,0,0,0
2022-04-26 04:30,3,2,1,0,0,0
2022-04-26 04:45,2,0,2,0,0,0
2022-04-26 05:00,8,1,7,0,0,0
2022-04-26 05:15,8,2,6,0,0,0
2022-04-26 05:30,18,9,9,0,0,0
2022-04-26 05:45,28,13,15,0,0,0
2022-04-26 06:00,25,7,18,0,0,0
2022-04-26 06:15,37,14,23,0,0,0
2022-04-26 06:30,56,23,33,0,0,0
2022-04-26 06:45,58,38,20,0,0,0
2022-04-26 07:00,84,43,41,0,0,0
2022-04-26 07:15,115,50,65,0,0,0
2022-04-26 07:30,155,63,92,0,0,0
2022-04-26 07:45,185,98,87,0,0,0
2022-04-26 08:00,190,75,115,0,0,0
2022-04-26 08:15,140,60,80,0,0,0
2022-04-26 08:30,149,67,82,0,0,0
2022-04-26 08:45,128,57,71,0,0,0
2022-04-26 09:00,90,42,48,0,0,0
2022-04-26 09:15,79,32,47,0,0,0
2022-04-26 09:30,79,37,42,0,0,0
2022-04-26 09:45,125,37,88,0,0,0
2022-04-26 10:00,141,34,107,0,0,0
2022-04-26 10:15,80,46,34,0,0,0
2022-04-26 10:30,83,38,45,0,0,0
2022-04-26 10:45,98,45,53,0,0,0
2022-04-26 11:00,81,33,48,0,0,0
2022-04-26 11:15,84,35,49,0,0,0
2022-04-26 11:30,78,28,50,0,0,0
2022-04-26 11:45,165,56,109,0,0,0
2022-04-26 12:00,123,55,68,0,0,0
2022-04-26 12:15,123,55,68,0,0,0
2022-04-26 12:30,96,47,49,0,0,0
2022-04-26 12:45,90,32,58,0,0,0
2022-04-26 13:00,142,72,70,0,0,0
2022-04-26 13:15,116,66,50,0,0,0
2022-04-26 13:30,131,57,74,0,0,0
2022-04-26 13:45,133,69,64,0,0,0
2022-04-26 14:00,156,84,72,0,0,0
2022-04-26 14:15,113,64,49,0,0,0
2022-04-26 14:30,111,61,50,0,0,0
2022-04-26 14:45,144,75,69,0,0,0
2022-04-26 15:00,95,53,42,0,0,0
2022-04-26 15:15,122,57,65,0,0,0
2022-04-26 15:30,141,71,70,0,0,0
2022-04-26 15:45,139,77,62,0,0,0
2022-04-26 16:00,177,100,77,0,0,0
2022-04-26 16:15,165,90,75,0,0,0
2022-04-26 16:30,133,60,73,0,0,0
2022-04-26 16:45,154,82,72,0,0,0
2022-04-26 17:00,171,72,99,0,0,0
2022-04-26 17:15,164,82,82,0,0,0
2022-04-26 17:30,188,109,79,0,0,0
2022-04-26 17:45,212,127,85,0,0,0
2022-04-26 18:00,179,95,84,0,0,0
2022-04-26 18:15,161,94,67,0,0,0
2022-04-26 18:30,156,84,72,0,0,0
2022-04-26 18:45,179,113,66,0,0,0
2022-04-26 19:00,132,71,61,0,0,0
2022-04-26 19:15,142,89,53,0,0,0
2022-04-26 19:30,128,76,52,0,0,0
2022-04-26 19:45,131,73,58,0,0,0
2022-04-26 20:00,124,72,52,0,0,0
2022-04-26 20:15,99,38,61,0,0,0
2022-04-26 20:30,76,33,43,0,0,0
2022-04-26 20:45,72,42,30,0,0,0
2022-04-26 21:00,72,36,36,0,0,0
2022-04-26 21:15,67,31,36,0,0,0
2022-04-26 21:30,68,25,43,0,0,0
2022-04-26 21:45,59,19,40,0,0,0
2022-04-26 22:00,72,24,48,0,0,0
2022-04-26 22:15,54,23,31,0,0,0
2022-04-26 22:30,76,15,61,0,0,0
2022-04-26 22:45,47,14,33,0,0,0
2022-04-26 23:00,119,14,105,0,0,0
2022-04-26 23:15,43,15,28,0,0,0
2022-04-26 23:30,41,5,36,0,0,0
2022-04-26 23:45,24,7,17,0,0,0
2022-04-27 00:00,25,6,19,0,0,0
2022-04-27 00:15,14,7,7,0,0,0
2022-04-27 00:30,10,2,8,0,0,0
2022-04-27 00:45,8,1,7,0,0,0
2022-04-27 01:00,5,4,1,0,0,0
2022-04-27 01:15,4,4,0,0,0,0
2022-04-27 01:30,2,1,1,0,0,0
2022-04-27 01:45,3,2,1,0,0,0
2022-04-27 02:00,3,0,3,0,0,0
2022-04-27 02:15,2,1,1,0,0,0
2022-04-27 02:30,1,1,0,0,0,0
2022-04-27 02:45,1,1,0,0,0,0
2022-04-27 03:00,0,0,0,0,0,0
2022-04-27 03:15,1,1,0,0,0,0
2022-04-27 03:30,2,1,1,0,0,0
2022-04-27 03:45,1,0,1,0,0,0
2022-04-27 04:00,4,2,2,0,0,0
2022-04-27 04:15,2,1,1,0,0,0
2022-04-27 04:30,1,0,1,0,0,0
2022-04-27 04:45,0,0,0,0,0,0
2022-04-27 05:00,3,1,2,0,0,0
2022-04-27 05:15,20,4,16,0,0,0
2022-04-27 05:30,25,12,13,0,0,0
2022-04-27 05:45,29,13,16,0,0,0
2022-04-27 06:00,20,5,15,0,0,0
2022-04-27 06:15,47,13,34,0,0,0
2022-04-27 06:30,52,24,28,0,0,0
2022-04-27 06:45,70,40,30,0,0,0
2022-04-27 07:00,86,44,42,0,0,0
2022-04-27 07:15,113,44,69,0,0,0
2022-04-27 07:30,191,75,116,0,0,0
2022-04-27 07:45,167,85,82,0,0,0
2022-04-27 08:00,191,85,106,0,0,0
2022-04-27 08:15,159,90,69,0,0,0
2022-04-27 08:30,159,81,78,0,0,0
2022-04-27 08:45,162,79,83,0,0,0
2022-04-27 09:00,121,33,88,0,0,0
2022-04-27 09:15,122,38,84,0,0,0
2022-04-27 09:30,93,42,51,0,0,0
2022-04-27 09:45,148,47,101,0,0,0
2022-04-27 10:00,126,48,78,0,0,0
2022-04-27 10:15,97,39,58,0,0,0
2022-04-27 10:30,94,39,55,0,0,0
2022-04-27 10:45,90,23,67,0,0,0
2022-04-27 11:00,110,45,65,0,0,0
2022-04-27 11:15,106,42,64,0,0,0
2022-04-27 11:30,109,49,60,0,0,0
2022-04-27 11:45,164,70,94,0,0,0
2022-04-27 12:00,143,55,88,0,0,0
2022-04-27 12:15,118,57,61,0,0,0
2022-04-27 12:30,116,62,54,0,0,0
2022-04-27 12:45,133,60,73,0,0,0
2022-04-27 13:00,117,50,67,0,0,0
2022-04-27 13:15,129,61,68,0,0,0
2022-04-27 13:30,140,65,75,0,0,0
2022-04-27 13:45,149,83,66,0,0,0
2022-04-27 14:00,134,65,69,0,0,0
2022-04-27 14:15,103,45,58,0,0,0
2022-04-27 14:30,128,53,75,0,0,0
2022-04-27 14:45,117,66,51,0,0,0
2022-04-27 15:00,116,47,69,0,0,0
2022-04-27 15:15,117,61,56,0,0,0
2022-04-27 15:30,121,58,63,0,0,0
2022-04-27 15:45,174,74,100,0,0,0
2022-04-27 16:00,190,95,95,0,0,0
2022-04-27 16:15,174,96,78,0,0,0
2022-04-27 16:30,148,75,73,0,0,0
2022-04-27 16:45,186,105,81,0,0,0
2022-04-27 17:00,179,78,101,0,0,0
2022-04-27 17:15,182,98,84,0,0,0
2022-04-27 17:30,186,85,101,0,0,0
2022-04-27 17:45,198,113,85,0,0,0
2022-04-27 18:00,179,108,71,0,0,0
2022-04-27 18:15,207,101,106,0,0,0
2022-04-27 18:30,164,84,80,0,0,0
2022-04-27 18:45,184,105,79,0,0,0
2022-04-27 19:00,153,88,65,0,0,0
2022-04-27 19:15,166,116,50,0,0,0
2022-04-27 19:30,158,93,65,0,0,0
2022-04-27 19:45,140,90,50,0,0,0
2022-04-27 20:00,94,53,41,0,0,0
2022-04-27 20:15,115,55,60,0,0,0
2022-04-27 20:30,95,40,55,0,0,0
2022-04-27 20:45,103,50,53,0,0,0
2022-04-27 21:00,68,36,32,0,0,0
2022-04-27 21:15,87,36,51,0,0,0
2022-04-27 21:30,66,33,33,0,0,0
2022-04-27 21:45,79,30,49,0,0,0
2022-04-27 22:00,76,43,33,0,0,0
2022-04-27 22:15,96,38,58,0,0,0
2022-04-27 22:30,106,31,75,0,0,0
2022-04-27 22:45,110,33,77,0,0,0
2022-04-27 23:00,116,35,81,0,0,0
2022-04-27 23:15,62,32,30,0,0,0
2022-04-27 23:30,66,35,31,0,0,0
2022-04-27 23:45,59,39,20,0,0,0
2022-04-28 00:00,45,26,19,0,0,0
2022-04-28 00:15,84,59,25,0,0,0
2022-04-28 00:30,19,12,7,0,0,0
2022-04-28 00:45,26,7,19,0,0,0
2022-04-28 01:00,10,2,8,0,0,0
2022-04-28 01:15,16,7,9,0,0,0
2022-04-28 01:30,20,8,12,0,0,0
2022-04-28 01:45,17,4,13,0,0,0
2022-04-28 02:00,21,2,19,0,0,0
2022-04-28 02:15,9,3,6,0,0,0
2022-04-28 02:30,20,0,20,0,0,0
2022-04-28 02:45,32,3,29,0,0,0
2022-04-28 03:00,15,0,15,0,0,0
2022-04-28 03:15,36,2,34,0,0,0
2022-04-28 03:30,44,3,41,0,0,0
2022-04-28 03:45,20,3,17,0,0,0
2022-04-28 04:00,27,2,25,0,0,0
2022-04-28 04:15,27,2,25,0,0,0
2022-04-28 04:30,17,2,15,0,0,0
2022-04-28 04:45,12,6,6,0,0,0
2022-04-28 05:00,6,2,4,0,0,0
2022-04-28 05:15,12,3,9,0,0,0
2022-04-28 05:30,18,11,7,0,0,0
2022-04-28 05:45,21,9,12,0,0,0
2022-04-28 06:00,20,7,13,0,0,0
2022-04-28 06:15,43,15,28,0,0,0
2022-04-28 06:30,45,16,29,0,0,0
2022-04-28 06:45,77,39,38,0,0,0
2022-04-28 07:00,84,45,39,0,0,0
2022-04-28 07:15,107,58,49,0,0,0
2022-04-28 07:30,174,86,88,0,0,0
2022-04-28 07:45,153,78,75,0,0,0
2022-04-28 08:00,179,80,99,0,0,0
2022-04-28 08:15,158,74,84,0,0,0
2022-04-28 08:30,138,81,57,0,0,0
2022-04-28 08:45,162,80,82,0,0,0
2022-04-28 09:00,104,42,62,0,0,0
2022-04-28 09:15,101,40,61,0,0,0
2022-04-28 09:30,81,44,37,0,0,0
2022-04-28 09:45,125,44,81,0,0,0
2022-04-28 10:00,119,39,80,0,0,0
2022-04-28 10:15,89,34,55,0,0,0
2022-04-28 10:30,97,37,60,0,0,0
2022-04-28 10:45,106,57,49,0,0,0
2022-04-28 11:00,71,29,42,0,0,0
2022-04-28 11:15,90,47,43,0,0,0
2022-04-28 11:30,85,28,57,0,0,0
2022-04-28 11:45,131,52,79,0,0,0
2022-04-28 12:00,138,49,89,0,0,0
2022-04-28 12:15,133,62,71,0,0,0
2022-04-28 12:30,119,42,77,0,0,0
2022-04-28 12:45,125,55,70,0,0,0
2022-04-28 13:00,127,62,65,0,0,0
2022-04-28 13:15,131,65,66,0,0,0
2022-04-28 13:30,136,70,66,0,0,0
2022-04-28 13:45,153,65,88,0,0,0
2022-04-28 14:00,133,74,59,0,0,0
2022-04-28 14:15,128,64,64,0,0,0
2022-04-28 14:30,115,51,64,0,0,0
2022-04-28 14:45,143,65,78,0,0,0
2022-04-28 15:00,127,70,57,0,0,0
2022-04-28 15:15,137,79,58,0,0,0
2022-04-28 15:30,149,82,67,0,0,0
2022-04-28 15:45,171,79,92,0,0,0
2022-04-28 16:00,162,92,70,0,0,0
2022-04-28 16:15,179,82,97,0,0,0
2022-04-28 16:30,169,78,91,0,0,0
2022-04-28 16:45,185,97,88,0,0,0
2022-04-28 17:00,187,84,103,0,0,0
2022-04-28 17:15,191,88,103,0,0,0
2022-04-28 17:30,193,98,95,0,0,0
2022-04-28 17:45,211,125,86,0,0,0
2022-04-28 18:00,183,103,80,0,0,0
2022-04-28 18:15,180,92,88,0,0,0
2022-04-28 18:30,147,70,77,0,0,0
2022-04-28 18:45,183,101,82,0,0,0
2022-04-28 19:00,177,98,79,0,0,0
2022-04-28 19:15,128,64,64,0,0,0
2022-04-28 19:30,136,81,55,0,0,0
2022-04-28 19:45,144,59,85,0,0,0
2022-04-28 20:00,134,85,49,0,0,0
2022-04-28 20:15,127,70,57,0,0,0
2022-04-28 20:30,79,45,34,0,0,0
2022-04-28 20:45,92,40,52,0,0,0
2022-04-28 21:00,58,32,26,0,0,0
2022-04-28 21:15,76,34,42,0,0,0
2022-04-28 21:30,80,36,44,0,0,0
2022-04-28 21:45,85,39,46,0,0,0
2022-04-28 22:00,64,24,40,0,0,0
2022-04-28 22:15,61,16,45,0,0,0
2022-04-28 22:30,72,22,50,0,0,0
2022-04-28 22:45,51,23,28,0,0,0
2022-04-28 23:00,47,14,33,0,0,0
2022-04-28 23:15,52,21,31,0,0,0
2022-04-28 23:30,58,12,46,0,0,0
2022-04-28 23:45,29,8,21,0,0,0
2022-04-29 00:00,23,6,17,0,0,0
2022-04-29 00:15,12,2,10,0,0,0
2022-04-29 00:30,19,7,12,0,0,0
2022-04-29 00:45,7,4,3,0,0,0
2022-04-29 01:00,21,3,18,0,0,0
2022-04-29 01:15,18,7,11,0,0,0
2022-04-29 01:30,4,0,4,0,0,0
2022-04-29 01:45,9,1,8,0,0,0
2022-04-29 02:00,6,1,5,0,0,0
2022-04-29 02:15,2,0,2,0,0,0
2022-04-29 02:30,2,2,0,0,0,0
2022-04-29 02:45,3,0,3,0,0,0
2022-04-29 03:00,2,0,2,0,0,0
2022-04-29 03:15,1,1,0,0,0,0
2022-04-29 03:30,0,0,0,0,0,0
2022-04-29 03:45,3,1,2,0,0,0
2022-04-29 04:00,1,1,0,0,0,0
2022-04-29 04:15,3,2,1,0,0,0
2022-04-29 04:30,3,0,3,0,0,0
2022-04-29 04:45,2,0,2,0,0,0
2022-04-29 05:00,3,2,1,0,0,0
2022-04-29 05:15,12,4,8,0,0,0
2022-04-29 05:30,16,9,7,0,0,0
2022-04-29 05:45,15,7,8,0,0,0
2022-04-29 06:00,26,9,17,0,0,0
2022-04-29 06:15,36,13,23,0,0,0
2022-04-29 06:30,46,16,30,0,0,0
2022-04-29 06:45,58,34,24,0,0,0
2022-04-29 07:00,72,41,31,0,0,0
2022-04-29 07:15,103,43,60,0,0,0
2022-04-29 07:30,164,72,92,0,0,0
2022-04-29 07:45,142,59,83,0,0,0
2022-04-29 08:00,139,65,74,0,0,0
2022-04-29 08:15,124,52,72,0,0,0
2022-04-29 08:30,112,50,62,0,0,0
2022-04-29 08:45,157,74,83,0,0,0
2022-04-29 09:00,106,48,58,0,0,0
2022-04-29 09:15,68,34,34,0,0,0
2022-04-29 09:30,88,43,45,0,0,0
2022-04-29 09:45,108,42,66,0,0,0
2022-04-29 10:00,112,29,83,0,0,0
2022-04-29 10:15,104,48,56,0,0,0
2022-04-29 10:30,82,42,40,0,0,0
2022-04-29 10:45,82,33,49,0,0,0
2022-04-29 11:00,95,39,56,0,0,0
2022-04-29 11:15,83,39,44,0,0,0
2022-04-29 11:30,84,43,41,0,0,0
2022-04-29 11:45,103,45,58,0,0,0
2022-04-29 12:00,135,71,64,0,0,0
2022-04-29 12:15,102,39,63,0,0,0
2022-04-29 12:30,124,49,75,0,0,0
2022-04-29 12:45,126,53,73,0,0,0
2022-04-29 13:00,152,68,84,0,0,0
2022-04-29 13:15,129,61,68,0,0,0
2022-04-29 13:30,130,46,84,0,0,0
2022-04-29 13:45,147,74,73,0,0,0
2022-04-29 14:00,140,64,76,0,0,0
2022-04-29 14:15,144,80,64,0,0,0
2022-04-29 14:30,114,57,57,0,0,0
2022-04-29 14:45,128,66,62,0,0,0
2022-04-29 15:00,145,66,79,0,0,0
2022-04-29 15:15,135,60,75,0,0,0
2022-04-29 15:30,151,74,77,0,0,0
2022-04-29 15:45,133,81,52,0,0,0
2022-04-29 16:00,147,80,67,0,0,0
2022-04-29 16:15,164,73,91,0,0,0
2022-04-29 16:30,154,86,68,0,0,0
2022-04-29 16:45,178,102,76,0,0,0
2022-04-29 17:00,133,55,78,0,0,0
2022-04-29 17:15,147,85,62,0,0,0
2022-04-29 17:30,175,94,81,0,0,0
2022-04-29 17:45,157,90,67,0,0,0
2022-04-29 18:00,135,74,61,0,0,0
2022-04-29 18:15,181,106,75,0,0,0
2022-04-29 18:30,145,80,65,0,0,0
2022-04-29 18:45,156,92,64,0,0,0
2022-04-29 19:00,126,65,61,0,0,0
2022-04-29 19:15,113,63,50,0,0,0
2022-04-29 19:30,98,55,43,0,0,0
2022-04-29 19:45,110,67,43,0,0,0
2022-04-29 20:00,95,47,48,0,0,0
2022-04-29 20:15,82,43,39,0,0,0
2022-04-29 20:30,70,37,33,0,0,0
2022-04-29 20:45,79,35,44,0,0,0
2022-04-29 21:00,72,37,35,0,0,0
2022-04-29 21:15,58,26,32,0,0,0
2022-04-29 21:30,65,25,40,0,0,0
2022-04-29 21:45,71,40,31,0,0,0
2022-04-29 22:00,104,26,78,0,0,0
2022-04-29 22:15,141,40,101,0,0,0
2022-04-29 22:30,179,34,145,0,0,0
2022-04-29 22:45,113,42,71,0,0,0
2022-04-29 23:00,69,14,55,0,0,0
2022-04-29 23:15,73,26,47,0,0,0
2022-04-29 23:30,72,22,50,0,0,0
2022-04-29 23:45,70,34,36,0,0,0
